,Specific Location,Amenities,Bedroom,Bathroom,Toilet,Description,Location,New,Duplex,Lux,Estate,locationbed,estate_price,terraced_price,new_price,value,location_rank,rank,Price
0,"  6, abimbola owodunni close, seaside estate, off badore road, ajah, lekki, lagos. badore ajah lagos",7,4,3,4,"Ground floor flat in a block of six flats of 3 bedroom each, there is water and power available services include security and cleaning of common area. Itâ€™s a plug and play apartment. ... Serviced. New. Big Compound. Pop Ceiling. All Room Ensuit. Parking Space. Water Treatment. ...",ajah,0,0,0,1,ajah4,1200000.0,1500000.0,1300000.0,1,29,5,1200000
1,  badore ajah lagos,9,5,4,5,"4 Bedroom Terraced Duplex at Unity Estate, Badore, Ajah For rent at N1.25m Caution at N50k SC at N75k ... Serviced. Dry. New. Big Compound. All Room Ensuit. Parking Space. 24 Hours Security. ...",ajah,1,1,0,1,ajah5,3000000.0,3000000.0,3000000.0,3,43,8,3000000
2,  lekki palm city ajah lagos,11,6,5,6,"FOR RENT: Brand New and Tastefully finished 4 bedroom Fully Detached House with Boys Quarter, Close to Ajah Jubilee Bridge, Ajah, Lagos. This beautiful home is strategically located in a serene, organized and very secured estate ... New. Ocean View. Big Compound. All Room Ensuit. Parking Space. Pop Ceiling. Drainage System. Cctv Cameras. Security Doors. Boys Quater. Security. ...",ajah,1,1,0,1,ajah6,4000000.0,4000000.0,4000000.0,3,50,9,4000000
3,  - thomas estate ajah lagos,9,5,4,5,"Nicely Built Four Bedroom Fully Detached Duplex with Bq for Sale Location: Thomas Estate, Ajah. Price: 50M Features: - Brand New - All Rooms En-suite - Play Area - 24 Hours Security - Fitted Kitchen - Interlocked Floor -Central sound system Kindly contact Nike on [redacted] ... New. All Room Ensuit. Parking Space. Pop Ceiling. ...",ajah,1,1,1,1,ajah5,3000000.0,3000000.0,3000000.0,4,43,8,5000000
4,  ajah lagos,9,5,4,5,"Lovely 4 Bedroom Semi-Detached House in Palm City, Ajah Features: All rooms en-suite, fully fitted kitchen, Ample parking space, Serene environment. Rent: 2.8 million Contact Chidi on +234 808 216 3583 ... All Room Ensuit. Parking Space. Pop Ceiling. ...",ajah,1,1,0,1,ajah5,3000000.0,3000000.0,3000000.0,3,43,8,3000000
5,  allied garden estate badore ajah lagos,5,3,2,3,Service Charge - 100k per annum ... Serviced. ...,ajah,0,0,0,1,ajah3,900000.0,1000000.0,1000000.0,1,24,4,900000
6,  silver point estate badore ajah lagos,5,3,2,3,2 bedroom Self Contain Flat / Apartment for rent Silver Point Estate Badore Ajah Lagos ... ...,ajah,0,0,0,1,ajah3,900000.0,1000000.0,1000000.0,1,24,4,900000
7,"  immediately after shoprite, sangotedo, lekki, lagos crown estate ajah lagos",9,5,4,5,"4 bedroom Semi Detached Duplex House for rent Immediately After Shoprite, Sangotedo, Lekki, Lagos Crown Estate Ajah Lagos ... Renovated. Street Lights. Pop Ceiling. Security. All Room Ensuit. Boys Quater. ...",ajah,1,1,0,1,ajah5,3000000.0,3000000.0,3000000.0,3,43,8,3000000
8,  by general paint olokonla ajah lagos,7,4,3,4,A single corporate tenant preferred ... Serviced. New. Big Compound. Pop Ceiling. All Room Ensuit. Water Treatment. Boys Quater. ...,ajah,1,1,1,1,ajah4,1200000.0,1500000.0,1300000.0,4,29,5,2500000
9,  virgo estate badore ajah lagos,5,3,2,3,"Caution fee - 75,000 ... ...",ajah,0,0,0,1,ajah3,900000.0,1000000.0,1000000.0,1,24,4,900000
10,  unity estate badore ajah lagos,8,4,4,4,"Brand New 3 bedroom flat with excellent facilities: Very lovely estate Close to the road Interlock compound Very big parlor All room en-suit with heater in master rooms, with wardrobe in all rooms Big kitchen and cabinet and back exit ... New. Drainage System. Security Doors. Pop Ceiling. Mosques Nearby. Big Compound. Parking Space. 24 Hours Electricity. ...",ajah,0,0,0,1,ajah4,1200000.0,1500000.0,1300000.0,1,29,5,1200000
11,  marshyhill eatate ado ajah lagos,7,4,3,4,"Brand new 3bedroom flat in Marshyhill eatate, Ado road, Ajah Rent 1.1m (Including Service charge) Legal 10% Agency 10% Caution 100k ... Serviced. New. Drainage System. Security Doors. Pop Ceiling. Street Lights. Big Compound. Cctv Cameras. All Room Ensuit. Supermarket Nearby. Parking Space. 24 Hours Security. Water Treatment. Security. Mosques Nearby. Church Nearby. Restaurants Nearby. ...",ajah,0,0,0,1,ajah4,1200000.0,1500000.0,1300000.0,1,29,5,1200000
12,  happy land estate olokonla ajah lagos,9,5,4,5,Brand new 4bedroom duplex with ample parking space ... Serviced. New. Pop Ceiling. Street Lights. Big Compound. All Room Ensuit. Parking Space. 24 Hours Electricity. ...,ajah,1,1,0,1,ajah5,3000000.0,3000000.0,3000000.0,3,43,8,3000000
13,  marshyhill estate ado ajah lagos,7,4,3,4,"Brand new 3bedroom flats in Marshyhill estate, Akins bus stop, Ajah Only 2 tenants in the compound Rent 1.2m ... New. Drainage System. Security Doors. Pop Ceiling. Street Lights. Big Compound. All Room Ensuit. Supermarket Nearby. Parking Space. Water Treatment. Security. Mosques Nearby. Church Nearby. Restaurants Nearby. ...",ajah,0,0,0,1,ajah4,1200000.0,1500000.0,1300000.0,1,29,5,1200000
14,  inside estate badore ajah lagos,2,1,1,1,Lovely self-contained (shared apartment) Good location Close to the road Very Specious compound Big room Big bathroom Big kitchen Good light Good water ... Drainage System. Security Doors. Security. Pop Ceiling. Big Compound. All Room Ensuit. Parking Space. Fast Internet. 24 Hours Electricity. ...,ajah,0,0,0,1,ajah1,400000.0,500000.0,450000.0,1,6,1,400000
15,  badore ajah lagos,2,1,1,1,"A single room self-contained sheared apartment in a flat with toilet inside the room only kitchen to be sheared by occupants, has constant light and water supply located at unity estate badore ajah ... New. Drainage System. Security Doors. Pop Ceiling. Street Lights. Big Compound. All Room Ensuit. Supermarket Nearby. Parking Space. Fast Internet. 24 Hours Electricity. 24 Hours Security. Water Treatment. Security. ...",ajah,0,0,0,1,ajah1,400000.0,500000.0,450000.0,1,6,1,400000
16,  - ado ajah lagos,2,1,1,1,A Newly built 7 star tastefully finished self-contained sheared apartment with specious luxury rooms upstairs. All rooms ensuit only kitchen to be sheared by occupations . has constant light and clean water supply . close ... Dry. New. Drainage System. Security Doors. Pop Ceiling. Street Lights. Big Compound. Cctv Cameras. All Room Ensuit. Supermarket Nearby. Parking Space. Fast Internet. 24 Hours Electricity. 24 Hours Security. Water Treatment. Free Wifi. Security. ...,ajah,0,0,0,1,ajah1,400000.0,500000.0,450000.0,1,6,1,400000
17,  badore ajah lagos,3,2,1,2,A single room self-contained apartment with toilet and kitchen located inside the room and with constant light and clean water located in marshy hill estate (akins) badore ajah ... Cheap. Dry. Renovated. Water Treatment. Security Doors. Security. Pop Ceiling. Street Lights. Big Compound. All Room Ensuit. Fast Internet. 24 Hours Electricity. 24 Hours Security. ...,ajah,1,1,0,1,ajah2,800000.0,800000.0,800000.0,3,21,4,800000
18,  grenadine estate sangotedo ajah lagos,7,4,3,4,"3bedroom flats in grenadine estate, along monastery road, by shoprite, sangotedo Rent 1.4m ... New. Drainage System. Security Doors. Pop Ceiling. Street Lights. Big Compound. All Room Ensuit. Supermarket Nearby. Parking Space. 24 Hours Security. Water Treatment. Children Play Ground. Security. Mosques Nearby. Church Nearby. Restaurants Nearby. ...",ajah,1,0,0,1,ajah4,1200000.0,1500000.0,1300000.0,2,29,5,1400000
19,"  grenadine estate, by shoprite sangotedo ajah lagos",7,4,3,4,"3bedroom terrace duplex with bq in grenadine estate, along monastery road, by shoprite, sangotedo rent 1.7m ... New. Drainage System. Security Doors. Pop Ceiling. Street Lights. Big Compound. All Room Ensuit. Supermarket Nearby. Parking Space. 24 Hours Security. Boys Quater. Water Treatment. Children Play Ground. Security. Mosques Nearby. Church Nearby. Jacuzzi. Restaurants Nearby. ...",ajah,1,1,1,1,ajah4,1200000.0,1500000.0,1300000.0,4,29,5,1700000
20,  ado ajah lagos,7,4,3,4,Neat 3-Bedroom flat (upstairs) with Kitchen Store For Rent @ Ajah - Ado Road Rent: 1.4m Caution: 150k Agency 10% Legal 10% ... Water Treatment. Pop Ceiling. Big Compound. All Room Ensuit. 24 Hours Security. ...,ajah,1,0,0,1,ajah4,1200000.0,1500000.0,1300000.0,2,29,5,1400000
21,"  abijo gra, lekki, lagos abijo ajah lagos",14,6,8,6,* This a fantastic house * Its a 7 bedroom detached duplex * It has very spacious rooms * Has 2 sitting rooms * Has all the rooms ensuite * Has beautiful wardrobes fitted in all the rooms * Has a ... Serviced. Boys Quater. Big Compound. ...,ajah,1,1,0,1,ajah6,4000000.0,4000000.0,4000000.0,3,50,9,4000000
22, happy land estate olokonla ajah lagos,7,4,3,4,3 bedroom Terraced Duplex House for rent Happy land estate Olokonla Ajah Lagos ... ...,ajah,1,1,1,1,ajah4,1200000.0,1500000.0,1300000.0,4,29,5,2000000
23,  by blenco supermarket sangotedo ajah lagos,2,1,1,1,"A Brand New 1Bedroom Mini flat for rent and upstairs with pop & wardrobe by Blenco Ajah - Lagos Rent: N550,000 APRO GLOBAL REAL ESTATES Web:info@aproglobalestate. com.ng. Tel: 01-7620139 Mobile: 080-51-595-336,080-29-481-639 070-63-822-217, 070-82-974-088 ... Security. Big Compound. Supermarket Nearby. Restaurants Nearby. ...",ajah,1,1,1,1,ajah1,400000.0,500000.0,450000.0,4,6,1,550000
24,  mrs ajah lagos,8,4,4,4,Lovely3 Bedroom duplex with Excellent facilities Close too Ajah Bridge Interlock road Workable to d express road Big compound and interlock 2duplex in d compound Pop finishing Big palour and dining space Big kitchen with store & lovely cabinet Big rooms with ... Drainage System. Security. Pop Ceiling. All Room Ensuit. Jacuzzi. Parking Space. Fast Internet. 24 Hours Security. ...,ajah,0,0,0,1,ajah4,1200000.0,1500000.0,1300000.0,1,29,5,1200000
25,"  salvation estate, off addo/langbasa road, ajah lagos",4,3,1,3," 2 Bedroom Luxury apartment. Fitted kitchen with ACs. 2brm = 1m per annum Refundable deposit for 2brm =200k. Flat has 4 splits ACs, 2 fitted wardrobes, fitted kitchen, electric fence, security. Etc ... Dry. Drainage System. Water Treatment. Security Doors. Security. Pop Ceiling. Big Compound. All Room Ensuit. Parking Space. 24 Hours Security. ...",ajah,1,1,0,1,ajah3,900000.0,1000000.0,1000000.0,3,24,4,1000000
26,  royal gardens ajiwe ajah lagos,11,6,5,6,"TO LET / LEASE A Tastefully finished 5br duplex with 2rm bq at the Royal Garden Estate, Ajah. Rent : N3.5m pa 1yr Estate Service Charge : N420k pa Refundable Caution Deposit : 10% Agency Fee : 10% Legal ... Serviced. Dry. Furnished. Boys Quater. Security Doors. Security. Pop Ceiling. Big Compound. All Room Ensuit. Parking Space. 24 Hours Electricity. 24 Hours Security. ...",ajah,1,1,0,1,ajah6,4000000.0,4000000.0,4000000.0,3,50,9,4000000
27,  badore ajah lagos,8,4,4,4,"Newly Built tastefully Finished 3 bedroom apartment with constant light and clean water supply all rooms ensuit, on interlocking paved stone at unity estate badore ... New. Drainage System. Security Doors. Pop Ceiling. Street Lights. Big Compound. Cctv Cameras. All Room Ensuit. Supermarket Nearby. Parking Space. Fast Internet. 24 Hours Electricity. 24 Hours Security. Water Treatment. Free Wifi. Children Play Ground. Security. Restaurants Nearby. ...",ajah,0,0,0,1,ajah4,1200000.0,1500000.0,1300000.0,1,29,5,1200000
28,  - badore ajah lagos,2,1,1,1,"A brand new tastefully finished specious self-contained sheared apartment with latest state of the art finished close to the estate gate, all rooms ensuit (with there personal bathroom and toilet) have constant light and ... Cheap. Dry. New. Drainage System. Security Doors. Pop Ceiling. Street Lights. Big Compound. Cctv Cameras. All Room Ensuit. Supermarket Nearby. Parking Space. Fast Internet. 24 Hours Electricity. 24 Hours Security. Water Treatment. Free Wifi. Security. Restaurants Nearby. ...",ajah,0,0,0,1,ajah1,400000.0,500000.0,450000.0,1,6,1,400000
29,"  royal garden estate, ajiwe ajah lagos",11,6,5,6,Fully serviced 5 bedroom detached duplex with swimming pool & 24hrs power 6m/ annum 5.5m/ 2 years ... Serviced. New. Drainage System. Security Doors. Pop Ceiling. Street Lights. Office Supplies. Big Compound. All Room Ensuit. Parking Space. 24 Hours Electricity. 24 Hours Security. Boys Quater. Water Treatment. Security. Swimming Pool. Jacuzzi. ...,ajah,1,1,1,1,ajah6,4000000.0,4000000.0,4000000.0,4,50,9,5000000
30,  ado ajah lagos,9,5,4,5,Newly Built 4-Bedroom Duplex For Rent @ Ajah - Ado Road Rent: *NGN 3.m* Caution: NGN 150k Agency: 10% Legal: 10% ... New. Drainage System. Water Treatment. Pop Ceiling. All Room Ensuit. Parking Space. ...,ajah,1,1,0,1,ajah5,3000000.0,3000000.0,3000000.0,3,43,8,3000000
31,  ado ajah lagos,10,6,4,6,FEATURES: - All Bedrooms En suite with Water Heaters - Fully Fitted Kitchen with Cabinets - Marble Tiles - Wardrobes - P.O.P ceiling - Dining - Serene Environment -Ample Parking Space. ... New. Drainage System. Water Treatment. Security Doors. Security. Pop Ceiling. Street Lights. Big Compound. All Room Ensuit. Jacuzzi. Parking Space. ...,ajah,1,1,0,1,ajah6,4000000.0,4000000.0,4000000.0,3,50,9,4000000
32,  awoyaya ajah lagos,2,1,1,1,Newly Built MiniFlat for rent @ Ajah - Awoyaya Rent: *NGN 350k* Agency: 10% Legal: 10% ... New. Security. Big Compound. All Room Ensuit. ...,ajah,0,0,0,1,ajah1,400000.0,500000.0,450000.0,1,6,1,400000
33,  infinity estate ado ajah lagos,8,4,4,4,"Decent 3 bedroom flat with excellent facilities: Very lovely estate with interlock road to the house Close to the road Interlock compound Very big parlor All room en-suit with heater in all rooms, with wardrobe Big kitchen and cabinet and back ... Security Doors. All Room Ensuit. Parking Space. 24 Hours Electricity. 24 Hours Security. ...",ajah,0,0,0,1,ajah4,1200000.0,1500000.0,1300000.0,1,29,5,1200000
34,"  mobil estate, ilaje off northwest filling station ilaje ajah lagos",9,5,4,5,"4 bedroom Detached Duplex House for rent Mobil estate, ilaje off northwest filling station Ilaje Ajah Lagos ... ...",ajah,1,1,0,1,ajah5,3000000.0,3000000.0,3000000.0,3,43,8,3000000
35,  - thomas estate ajah lagos,6,3,3,3,"3 bedroom en-suite flat for rent at Thomas Estate, Ajah Rent 1.5m Agency 10% Legal 10% Caution 10% ... Big Compound. All Room Ensuit. Parking Space. 24 Hours Electricity. 24 Hours Security. ...",ajah,1,1,1,1,ajah3,900000.0,1000000.0,1000000.0,4,24,4,1500000
36,  cooperative estate badore ajah lagos,7,4,3,4,"Four units of 3 bedroom flat all rooms ensuite with one bedroom boys quaters Rent: N1,000,000 inclusive of service charge Two units of 3 bedroom all ensuite with one bedroom boys quaters in a gated ... ...",ajah,0,0,0,1,ajah4,1200000.0,1500000.0,1300000.0,1,29,5,1200000
37,  mrs ajah lagos,4,2,2,2,"Decent 2bedroom flat 3 in the compound, Very close to Ajah bridge Mrs filling station Wakable to d road and very wakable to ajah bridge Decent compound and neat Secure compound Good place to stay 2rooms and a palour Lobby space and with privacy 600k ... Cheap. Drainage System. Security. Big Compound. Supermarket Nearby. Parking Space. Fast Internet. 24 Hours Electricity. 24 Hours Security. ...",ajah,1,1,0,1,ajah2,800000.0,800000.0,800000.0,3,21,4,800000
38,  mobile road ilaje ajah lagos,5,3,2,3,"Brand new fully serviced 2bedroom apartments, with 24hrs light in Mobile road, Ajah. Rent Upstairs 1.2 Downstairs 1m Agency 10% Legal 10% Caution 100k Service charge 500k ... Serviced. New. Drainage System. Security Doors. Pop Ceiling. Big Compound. All Room Ensuit. Supermarket Nearby. Parking Space. 24 Hours Electricity. 24 Hours Security. Water Treatment. Security. Mosques Nearby. Church Nearby. Restaurants Nearby. ...",ajah,1,1,1,1,ajah3,900000.0,1000000.0,1000000.0,4,24,4,1200000
39,  silver point estate badore ajah lagos,5,3,2,3,Tastefully built 2bedroom flat in a secure gated estate ... Cheap. New. Big Compound. All Room Ensuit. ...,ajah,1,1,1,1,ajah3,900000.0,1000000.0,1000000.0,4,24,4,2300000
40,  abijo ajah lagos,2,1,1,1,Brandnew Selfcon Appartment (upstairs) for rent @ Ajah - Abijo Rent: *NGN 220k Caution: 20k Agency: 10% Legal: 10% ... New. All Room Ensuit. ...,ajah,0,0,0,1,ajah1,400000.0,500000.0,450000.0,1,6,1,400000
41,  alpha bus stop sangotedo ajah lagos,3,2,1,2,1-Bedroom Flat For Rent @ Ajah - Sangotedo Rent: *NGN 400k* Caution: NGN 50k Legal: 10% Agency: 10% ... All Room Ensuit. ...,ajah,1,1,0,1,ajah2,800000.0,800000.0,800000.0,3,21,4,800000
42,  inside estate ado ajah lagos,6,3,3,3,Brand new Fantastic 2bedroom flat with excellent facilities All rooms ensuit with visitors toilet Big parlor with dinner space Pop finishing Big rooms with wardrobes Big bathroom with water heater Lovely kitchen with beautiful cabinet and back baconin Good light with personal ... Cheap. New. Drainage System. Security Doors. Security. Pop Ceiling. Big Compound. All Room Ensuit. Supermarket Nearby. Parking Space. Fast Internet. 24 Hours Electricity. 24 Hours Security. ...,ajah,0,0,0,1,ajah3,900000.0,1000000.0,1000000.0,1,24,4,900000
43,  inside estate badore ajah lagos,2,1,1,1,Decent 2bederoom flat for rent Specious compound Close to the road Big palour Big rooms Kitchen with cabinet Enough packing space Wakable the road ... Cheap. Renovated. Security Doors. Security. Big Compound. All Room Ensuit. Parking Space. 24 Hours Electricity. 24 Hours Security. ...,ajah,0,0,0,1,ajah1,400000.0,500000.0,450000.0,1,6,1,400000
44,  ado ajah lagos,4,2,2,2,Newly built tastefully finished room and parlour mini flat apartment with constant light and clean water supply located at Harmony estate owode ... Cheap. Dry. New. Drainage System. Water Treatment. Security Doors. Security. Pop Ceiling. Street Lights. Big Compound. All Room Ensuit. Supermarket Nearby. Fast Internet. 24 Hours Electricity. 24 Hours Security. ...,ajah,1,1,0,1,ajah2,800000.0,800000.0,800000.0,3,21,4,800000
45,  badore ajah lagos,9,5,4,5,4 bedroom Terraced Duplex House for rent Badore Ajah Lagos ... New. Church Nearby. Pop Ceiling. Restaurants Nearby. Supermarket Nearby. Drainage System. All Room Ensuit. Security. Parking Space. ...,ajah,1,1,0,1,ajah5,3000000.0,3000000.0,3000000.0,3,43,8,3000000
46,  shoprite monastery road sangotedo ajah lagos,9,5,4,5,"A detached duplex in a very secured estate for rent. The property is situated around shoprite sangotedo and road is tarred from the express to the estate. The house has all room ensuite, with spacious and luxury ... New. Swimming Pool. Security Doors. All Room Ensuit. Pop Ceiling. ...",ajah,1,1,0,1,ajah5,3000000.0,3000000.0,3000000.0,3,43,8,3000000
47,  good news estate sangotedo ajah lagos,7,4,3,4,"Exceptionally clean, lovely and comfortable 3 Bedroom flats (downstairs) in a secured Goodnews estate at Sangotedo, Ajah, Lagos. The features are: Solar system (green house) for 24-hours electricity supply from the sun Air conditioners in all rooms, ... Street Lights. Security. Security Doors. All Room Ensuit. 24 Hours Security. Pop Ceiling. ...",ajah,1,0,0,1,ajah4,1200000.0,1500000.0,1300000.0,2,29,5,1300000
48,  diamond estate sangotedo ajah lagos,9,5,4,5,4 Bedroom Semidetached Duplex in Serviced Estate Rent: N2.5m per annum Service charge: N230k per annum Services; - Security - Water treatment - Waste Disposal - Sewage Mgt ... New. Big Compound. Parking Space. Street Lights. Supermarket Nearby. 24 Hours Security. Security Doors. Drainage System. All Room Ensuit. Security. Water Treatment. ...,ajah,1,1,0,1,ajah5,3000000.0,3000000.0,3000000.0,3,43,8,3000000
49,  oke ira kekere ajah lagos,7,4,3,4,"Affordable 6 units of 3 bedroom flats available for lease at oke ira kekere, off addo road,Ajah. Property is located at oke - ira kekere off addo road, ajah. 8/10 car park space. -good neighbourhood within a gated community ... ...",ajah,0,0,0,1,ajah4,1200000.0,1500000.0,1300000.0,1,29,5,1200000
50, harmony estate ado ajah lagos,7,4,3,4,Very clean 2bedroom apartment Rent: 700k SC: 100k Features: Uniform security Parking space POP finish Clean water Interlocked and gated compound All rooms ensuite Visitors toilet ... Cheap. Dry. Big Compound. Parking Space. Pop Ceiling. 24 Hours Security. Drainage System. All Room Ensuit. Water Treatment. ...,ajah,0,0,0,1,ajah4,1200000.0,1500000.0,1300000.0,1,29,5,1200000
51,  by green spring school awoyaya awoyaya ajah lagos,4,2,2,2,Very nice and spacious 3bedrm Apartment Newly painted with tiles and wardrobes Upstair rent: 600k Agency: 60k Agreement: 60k Caution fee: 50k Downstair rent: 500k Agency: 50k Agreement: 50k Caution fee:50k LOCATION: by Green spring school Awoyaya Ajah ... Renovated. Parking Space. Pop Ceiling. Security. ...,ajah,1,1,0,1,ajah2,800000.0,800000.0,800000.0,3,21,4,800000
52,  beside atican beach okun ajah ajah lagos,7,4,3,4,To let fully furnished 3bedroom bungalow all rooms ensuite alone in a compound LOCATION;beside Atican beach okun ajah rent 1.3m caution fee 200k agency and legal fee 10% ... Furnished. Jacuzzi. Security. All Room Ensuit. Parking Space. Pop Ceiling. Big Compound. ...,ajah,0,0,0,1,ajah4,1200000.0,1500000.0,1300000.0,1,29,5,1200000
53,  abraham adesanya estate ajah lagos,6,3,3,3," 3 BRM Apartment, 2 Rooms ensuite, all tiled,Complete Kitchen Cabinet with Mable, fully painted in & out,Wardrobes in all Rooms with Pre-paid Meters LOCATION:Frank Kokori Road, Abraham Adesanya Estate. Ajah.Lagos. Rent #1m Legal 10%, Agency ... Jacuzzi. Security. Parking Space. Pop Ceiling. ...",ajah,1,1,0,1,ajah3,900000.0,1000000.0,1000000.0,3,24,4,1000000
54,  marshy hill estate akins ado ajah lagos,2,1,1,1,"Brand New 1Bedroom Mini flat upstairs with pop & wardrobe LOCATION: marshy hill Estate Ajah Price:N550k Service Charge N50k, Caution N30k, Agency:10% (55k) Legal :10% (55k) ... New. Serviced. Restaurants Nearby. Pop Ceiling. Parking Space. All Room Ensuit. ...",ajah,1,1,1,1,ajah1,400000.0,500000.0,450000.0,4,6,1,550000
55,  general paint alasia ajah ajah lagos,9,5,4,5,Newly Built 21units of 4bedroom Semi Detached Duplex House for rent Ajah Lagos LOCATION: general paint Alasia ajah Price: 2.2m per annum ... Serviced. New. Jacuzzi. Security. All Room Ensuit. Big Compound. Excision. Parking Space. 24 Hours Electricity. Swimming Pool. Pop Ceiling. 24 Hours Security. ...,ajah,1,1,0,1,ajah5,3000000.0,3000000.0,3000000.0,3,43,8,3000000
56,  thomas estate ajah thomas estate ajah lagos,5,3,2,3,"Rent: 9000k Agency fees: 100,000 Legal fees: 100,000 Refundable caution : 100,000 Service charge which includes Security, cleaning for one year. 96,000 Total:1,296,000.00 ( One million, three hundred and ninety ... Serviced. New. Security. All Room Ensuit. Parking Space. Pop Ceiling. ...",ajah,0,0,0,1,ajah3,900000.0,1000000.0,1000000.0,1,24,4,900000
57,  marina estate behind unity estate badore ajah badore ajah lagos,3,2,1,2,Newy Built spacious Mini-Flat (room and parlour self contained with tiles wardrobes kitchen cabinets and spacious compound) Rent: Upstairs - 600k Downstairs - 550k LOCATION : marina Estate behind Unity Estate badore Ajah Ajah Lagos ... New. Security. Parking Space. Pop Ceiling. ...,ajah,1,1,0,1,ajah2,800000.0,800000.0,800000.0,3,21,4,800000
58,  marshy hill estate ado ajah lagos,2,1,1,1," We have FOR RENT IN AKINS, MARSHY HILL ESTATE, ALONG ADO ROAD, AJAH, LEKKI An executive room self-contained _(that is as big as if it was a room and parlour) Price: ?350,000 upstairs & a similar one ... Renovated. Security. Parking Space. ...",ajah,0,0,0,1,ajah1,400000.0,500000.0,450000.0,1,6,1,400000
59,  jubril estate olokonla just by lagos business school ajah olokonla ajah lagos,7,4,3,4,"3bedroom executive and luxury flat, upstairs, very clean with spacious rooms, dining area, spacious and fitted kitchen, fitted wardrobe, all round POP finishing, security doors, prepaid meter Location: jubril estate by Lagos business school ajah Price: ... Security. All Room Ensuit. Parking Space. Pop Ceiling. ...",ajah,0,0,0,1,ajah4,1200000.0,1500000.0,1300000.0,1,29,5,1200000
60,  good news estate sangotedo ajah lagos,7,4,3,4,Luxurious 3 bedroom flat in a cerene neighbourhood with modern facilities.... AC in all the rooms including kitchen with provision for solar power ... Serviced. New. Cheap. Security. All Room Ensuit. Big Compound. Supermarket Nearby. Security Doors. Parking Space. 24 Hours Electricity. Pop Ceiling. 24 Hours Security. Drainage System. Water Treatment. ...,ajah,0,0,0,1,ajah4,1200000.0,1500000.0,1300000.0,1,29,5,1200000
61,  - abraham adesanya estate ajah lagos,2,1,1,1,Very nice and spacious miniflats ensuite with fitted kitchen cabinets toilet and bathroom LOCATION; Abraham adesanya Estate Ajah Price: 450k per annum ... Security. Parking Space. ...,ajah,1,0,0,1,ajah1,400000.0,500000.0,450000.0,2,6,1,450000
62,  ilaje opposite vgc ilaje ajah lagos,7,4,3,4,"A decent and newly built 3 bedroom terrace f all room tiled with POP, fitted kitchen, is available LOCATION: SouthDrift Estate, Ilaje, opposite VGC @ N1.6m per annum ... New. Jacuzzi. Security. All Room Ensuit. Parking Space. Pop Ceiling. ...",ajah,1,1,1,1,ajah4,1200000.0,1500000.0,1300000.0,4,29,5,1600000
63,  good news estate sangotedo sangotedo ajah lagos,7,4,3,4,Very nice and spacious 3bedroom flats all rooms ensuite LOCATION:Good news estate Sangotedo Ajah Lekki Price 800k. Per annum ... Security. All Room Ensuit. Parking Space. Pop Ceiling. ...,ajah,0,0,0,1,ajah4,1200000.0,1500000.0,1300000.0,1,29,5,1200000
64,  in an estate. badore ajah lagos,5,3,2,3,"Twelve units of brand new two bedroom flats within an estate in Badore. All rooms are ensuite with guest toilet. Rent: N900k Agency Fee: N90k Legal Fee: N90k Caution Deposit: N50k Service Charge: N100k Total: N1,230,000 JT/SP ... Serviced. New. Security. All Room Ensuit. Big Compound. Supermarket Nearby. Restaurants Nearby. Security Doors. Parking Space. Pop Ceiling. 24 Hours Security. Church Nearby. ...",ajah,0,0,0,1,ajah3,900000.0,1000000.0,1000000.0,1,24,4,900000
65,  marshy hill estate ado ajah lagos,7,4,3,4," 3 BEDROOM FLATS A newly built and well finished building of 5 units of 3 Bedrooom flats, all rooms ensuite with visitors wc, spacious parking lot, interlocked road, big kitchen with store and good security ... New. Security. All Room Ensuit. Big Compound. Parking Space. Pop Ceiling. ...",ajah,0,0,0,1,ajah4,1200000.0,1500000.0,1300000.0,1,29,5,1200000
66,  by abraham adesanya estate lekki gardens estate ajah lagos,7,4,3,4, Very nice superb 3 bedroom terrace duplex all rooms ensuite LOCATION:Lekki Gardens phase 2 by Abraham adesanya Price :1.6m Not new ... Jacuzzi. Security. All Room Ensuit. Big Compound. Parking Space. Pop Ceiling. ...,ajah,1,1,1,1,ajah4,1200000.0,1500000.0,1300000.0,4,29,5,1600000
67,  ... abraham adesanya estate ajah lagos,4,2,2,2,"TO LET. A newly renovated 2 bedroom bungalow in a large compound on June 12, Abraham Adesanya estate, Ajah, Lagos. Rent. N900. ... Renovated. Security. Parking Space. Printing Service. ...",ajah,1,1,1,1,ajah2,800000.0,800000.0,800000.0,4,21,4,900000
68,  peaceville estate badore ajah lagos,9,5,4,5,NEW 4BEDROOM TERRACE DUPLEX WITH SECURITY PRICE: 1.5M PER ANNUM AGENCY: 150K LEGAL: 150K CAUTION/REFUNDABLE DEPOSITS: 200K TOTAL PACKAGE: 2MILLION LOCATION: PEACEVILLE ESTATE BADORE AJAH ... New. Jacuzzi. Security. All Room Ensuit. Big Compound. Pop Ceiling. ...,ajah,1,1,0,1,ajah5,3000000.0,3000000.0,3000000.0,3,43,8,3000000
69," harmony estate, langbasa ajah lagos",7,4,3,4,"Newly renovated three bedroom flat, upstairs. - Sitting room with guest toilet and entrance door - Master Bedroom ensuite with wardrobes - Madam's bedroom ensuite with wardrobe - Children's room with wardrobe. Bath/toilet not ensuite but exclusive to the ... New. Security. All Room Ensuit. Supermarket Nearby. Restaurants Nearby. Security Doors. Parking Space. Pop Ceiling. ...",ajah,0,0,0,1,ajah4,1200000.0,1500000.0,1300000.0,1,29,5,1200000
70," harmony estate, langbasa. ajah lagos",5,3,2,3,"Newly built two bedroom flat, upstairs. - Sitting room with guest toilet and entrance door - Master Bedroom ensuite with wardrobe. - Second bedroom ensuite with wardrobe. - Three toilets altogether in the apartment. - Kitchen has cabinets and an ... New. Security. All Room Ensuit. Supermarket Nearby. Restaurants Nearby. Security Doors. Parking Space. Pop Ceiling. 24 Hours Security. ...",ajah,0,0,0,1,ajah3,900000.0,1000000.0,1000000.0,1,24,4,900000
71,  crown estate sangotedo sangotedo ajah lagos,13,7,6,7,"*TO LET* Executive 6-bedroom semi-detached duplex in Crown Estate, Sangotedo. Rent: N1.8m per annum. 10% Agency, 10% Agreement, N100,000 caution deposit. ... Security. Jacuzzi. All Room Ensuit. Big Compound. Boys Quater. Printing Service. Parking Space. ...",ajah,1,1,0,1,ajah7,5000000.0,5000000.0,5000000.0,3,52,9,5000000
72,  back of blenco supermarket sangotedo ajah lagos,5,3,2,3,Newly built two bedroom apartment LOCATION: back of blenco supermarket sangotedo ajah Upstairs 1.2m Downstairs 1m Agency and legal 10% each Service charge 600k Catioun 100k ... New. Pop Ceiling. Security. All Room Ensuit. Parking Space. Big Compound. ...,ajah,1,1,1,1,ajah3,900000.0,1000000.0,1000000.0,4,24,4,1200000
73,  rockstone estate after cooperative villa estate badore badore ajah lagos,5,3,2,3,Location: Rockstone Estate badore Ajah just after cooperative villa Estate (black gate) Bungalow 2 units of 2bedroom in one compound 2 meter 2 pumping machines Rent 800k Caution 80k Agreement 80k Agency 80k ... Pop Ceiling. Big Compound. Parking Space. All Room Ensuit. ...,ajah,0,0,0,1,ajah3,900000.0,1000000.0,1000000.0,1,24,4,900000
74,  cooperative villa badore badore ajah lagos,5,3,2,3,"Nice and Standard 2-bedroom apartment available in a Serene and Secured estate in Cooperative villa badore Ajah Lagos. Features: room with cooking space, Serene and cozy environment; fence and gated compound; good road network; ... Cheap. Water Treatment. Pop Ceiling. Parking Space. Supermarket Nearby. 24 Hours Security. Security. Big Compound. ...",ajah,0,0,0,1,ajah3,900000.0,1000000.0,1000000.0,1,24,4,900000
75, ajah lagos,7,4,3,4,"For more information, pricing and private viewings, please contact: ? Adeyemi: 09093272572 ?Freke: 09062511345 ?Daniel: 09093272547 Or send us a DM on Instagram @cwrelagos Twitter: @cwrelagos Facebook: @cwrelagos Email : hello@cwlagos.com Website: www.cwlagos.com ... ...",ajah,0,0,0,1,ajah4,1200000.0,1500000.0,1300000.0,1,29,5,1200000
76, badore ajah lagos,7,4,3,4,"3 Bedroom Flat with BQ at Unity Estate, Badore, Ajah For rent at N1m ... ...",ajah,0,0,0,1,ajah4,1200000.0,1500000.0,1300000.0,1,29,5,1200000
77, co-operation villa badore ajah lagos,5,3,2,3,Service charge - 120k ... Serviced. ...,ajah,0,0,0,1,ajah3,900000.0,1000000.0,1000000.0,1,24,4,900000
78, rockville estate badore ajah lagos,7,4,3,4,3 bedroom Self Contain Flat / Apartment for rent Rockville Estate Badore Ajah Lagos ... ...,ajah,0,0,0,1,ajah4,1200000.0,1500000.0,1300000.0,1,29,5,1200000
79, rockville estate badore ajah lagos,7,4,3,4,3 bedroom Self Contain Flat / Apartment for rent Rockville Estate Badore Ajah Lagos ... Serviced. ...,ajah,0,0,0,1,ajah4,1200000.0,1500000.0,1300000.0,1,29,5,1200000
80, unity estate ado ajah lagos,7,4,3,4,"3 Bedroom flat upstairs - 900,000 3 Bedroom downstairs - 850,000 ... ...",ajah,0,0,0,1,ajah4,1200000.0,1500000.0,1300000.0,1,29,5,1200000
81, virgo estate badore ajah lagos,7,4,3,4,3 bedroom Self Contain Flat / Apartment for rent Virgo Estate Badore Ajah Lagos Service charge - 150k per annum ... Serviced. ...,ajah,0,0,0,1,ajah4,1200000.0,1500000.0,1300000.0,1,29,5,1200000
82, pennisula estate sangotedo ajah lagos,7,4,3,4,3 bedroom Self Contain Flat / Apartment for rent Pennisula Estate Sangotedo Ajah Lagos ... ...,ajah,0,0,0,1,ajah4,1200000.0,1500000.0,1300000.0,1,29,5,1200000
83, goodnews estate sangotedo ajah lagos,7,4,3,4,"Exceptionally clean, lovely and comfortable 3 Bedroom flats (downstairs) in a secured Goodnews estate at Sangotedo, Ajah, Lagos. The features are: -Solar system (green house) for 24-hours electricity supply from the sun -Air conditioners in all rooms, ... Serviced. Big Compound. Pop Ceiling. All Room Ensuit. Parking Space. 24 Hours Electricity. Water Treatment. 24 Hours Security. ...",ajah,1,0,0,1,ajah4,1200000.0,1500000.0,1300000.0,2,29,5,1300000
84, greenville estate badore ajah lagos,7,4,3,4,3 bedroom Self Contain Flat / Apartment for rent Greenville Estate Badore Ajah Lagos ... ...,ajah,0,0,0,1,ajah4,1200000.0,1500000.0,1300000.0,1,29,5,1200000
85, even estate ado ajah lagos,5,3,2,3,Service charge - 6000 per month ... Serviced. ...,ajah,0,0,0,1,ajah3,900000.0,1000000.0,1000000.0,1,24,4,900000
86, royal palm estate badore ajah lagos,2,1,1,1,"Service charge - 60,000 per annum ... Serviced. ...",ajah,1,1,1,1,ajah1,400000.0,500000.0,450000.0,4,6,1,500000
87, ajah lagos,9,5,4,5,"4/5 bedroom terrace duplex after Lekki Gardens 2, Ajah. For rent at N1.8m Features: Spacious Sitting Room on Ground Floor with Guest Convenience. Cubicle for Book shelf or Flower Pots. Dining Area and kitchen on ground floor Kitchen Pantry/Store Allowance ... Cheap. Dry. New. Big Compound. Children Play Ground. Security. All Room Ensuit. Parking Space. Water Treatment. Security Doors. 24 Hours Security. ...",ajah,1,1,0,1,ajah5,3000000.0,3000000.0,3000000.0,3,43,8,3000000
88, greenville estate badore ajah lagos,9,5,4,5,4 bedroom Semi Detached Duplex House for rent Greenville Estate Badore Ajah Lagos ... New. ...,ajah,1,1,0,1,ajah5,3000000.0,3000000.0,3000000.0,3,43,8,3000000
89, badore ajah lagos,8,4,4,4,Spacious 3-Bedroom Flat for Rent @ Ajah - Badore Rent: NGN 750k Caution: NGN 50k Agency: 10% Legal: 10% ... Big Compound. All Room Ensuit. ...,ajah,0,0,0,1,ajah4,1200000.0,1500000.0,1300000.0,1,29,5,1200000
90, badore ajah lagos,6,3,3,3,A specious 2 bedroom apartment all rooms ensuit with constant light and water supply located at Anu Crescent estate badore ajah ... Cheap. Dry. New. Drainage System. Security Doors. Pop Ceiling. Street Lights. Big Compound. All Room Ensuit. Supermarket Nearby. Parking Space. Fast Internet. 24 Hours Electricity. 24 Hours Security. Water Treatment. Children Play Ground. Security. ...,ajah,0,0,0,1,ajah3,900000.0,1000000.0,1000000.0,1,24,4,900000
91, ado ajah lagos,5,3,2,3,2-Bedroom Flat For Rent @ Ajah - Addo Road Rent: NGN 950k / Annum (Negotiable) Caution: NGN 100 k Agency: 10% Legal: 10% ... ...,ajah,0,0,0,1,ajah3,900000.0,1000000.0,1000000.0,1,24,4,950000
92," lekki garden phase 2,opposite abraham adesanya abraham adesanya estate ajah lagos",7,4,3,4,"3 bedroom Terraced Duplex House for rent Lekki garden phase 2,opposite Abraham adesanya Abraham adesanya estate Ajah Lagos ... ...",ajah,1,1,1,1,ajah4,1200000.0,1500000.0,1300000.0,4,29,5,1500000
93, badore ajah lagos,6,3,3,3,A specious 2 bedroom apartment all rooms ensuit with constant light and clean water supply at unity estate badore ajah ... Dry. New. Security Doors. Pop Ceiling. Street Lights. Big Compound. All Room Ensuit. Supermarket Nearby. Parking Space. Fast Internet. 24 Hours Electricity. 24 Hours Security. Water Treatment. Children Play Ground. Security. ...,ajah,0,0,0,1,ajah3,900000.0,1000000.0,1000000.0,1,24,4,900000
94, ... badore ajah lagos,6,3,3,3,A specious 2 Bedroom apartment all rooms ensuit with state of the art finished located inside serene estate at badore ajah with constant light and clean water supply situated on a good road. ... Dry. New. Water Treatment. Security Doors. Security. Pop Ceiling. Street Lights. Big Compound. All Room Ensuit. Supermarket Nearby. Fast Internet. 24 Hours Electricity. 24 Hours Security. ...,ajah,0,0,0,1,ajah3,900000.0,1000000.0,1000000.0,1,24,4,900000
95, silverpoint estate badore ajah lagos,5,3,2,3,"Brand new beautifully built luxurious 2bedroom flat with ample parking space at silver point estate badore ajah, Lagos. Rent #900k Agency #90k Legal #45k Caution #50k Service charge ... Dry. New. Drainage System. Water Treatment. Security Doors. Security. Pop Ceiling. Street Lights. Big Compound. All Room Ensuit. Parking Space. 24 Hours Security. ...",ajah,0,0,0,1,ajah3,900000.0,1000000.0,1000000.0,1,24,4,900000
96, hitech estate sangotedo ajah lagos,7,4,3,4,"*3Bedroom Flat with BQ For Rent* 5unit of 3bedroom flat with all room ensiut including BQ. Available for rent at Hitech Estate, Beside LBS, Ajah. Rent N1.3m Service charge #200k *Amenties to enjoy includes* # Superbly ... Cheap. Renovated. Drainage System. Boys Quater. Water Treatment. Security Doors. Security. Pop Ceiling. Street Lights. Big Compound. All Room Ensuit. Parking Space. ...",ajah,1,0,0,1,ajah4,1200000.0,1500000.0,1300000.0,2,29,5,1300000
97, ado ajah lagos,9,5,4,5,FEATURES: - All Bedrooms En suite with Water Heaters - Fully Fitted Kitchen with Cabinets - Marble Tiles - Wardrobes - P.O.P ceiling - Dining - Serene Environment - Ample Parking Space. ... New. Boys Quater. Water Treatment. Security Doors. Security. Pop Ceiling. Street Lights. Big Compound. Cctv Cameras. All Room Ensuit. Parking Space. ...,ajah,1,1,0,1,ajah5,3000000.0,3000000.0,3000000.0,3,43,8,3000000
98, mobile ajah lagos,9,5,4,5,"Newly built 4bedroom duplex with a bq for rent and for sale. Location:ajah/mobile road rent: 2m caution: 10% agent: 10% legal: 10% sales price .45m a call to us will definitely end your search for a house for further enquires, specific request ... Dry. New. Drainage System. Boys Quater. Children Play Ground. Pop Ceiling. Street Lights. Big Compound. All Room Ensuit. Church Nearby. 24 Hours Electricity. 24 Hours Security. ...",ajah,1,1,0,1,ajah5,3000000.0,3000000.0,3000000.0,3,43,8,3000000
99, green vill estate badore ajah lagos,6,3,3,3,Decent 3 bedroom flat for rent Very close to the road inside a nice estate with good security pave road fence compound neat big parlor big rooms bathroom kitchen with cabinet prepaid meter to each flat good water and good light big parking space ... Renovated. Security Doors. Security. Big Compound. Parking Space. 24 Hours Electricity. 24 Hours Security. ...,ajah,0,0,0,1,ajah3,900000.0,1000000.0,1000000.0,1,24,4,900000
100, sangotedo ajah lagos,2,1,1,1,"Nice 1 bedroom shared apartment Shared apartment Rent 230k Total package Location sangotedo A call to us will end your search immediately FOR FURTHER ENQUIRES, SPECIFIC REQUEST AND ARRANGEMENTS FOR PHYSICAL INSPECTIONS, KINDLY SEND US A SCREENSHOT OR THE LINK TO ... Cheap. Dry. ...",ajah,0,0,0,1,ajah1,400000.0,500000.0,450000.0,1,6,1,400000
101, badore ajah lagos,4,2,2,2,A specious room and parlour mini flat apartment all rooms ensuit with constant light and water supply located at seaside estate badore ajah ... Cheap. New. Drainage System. Security Doors. Pop Ceiling. Street Lights. Big Compound. All Room Ensuit. Supermarket Nearby. Parking Space. Fast Internet. 24 Hours Electricity. 24 Hours Security. Water Treatment. Children Play Ground. Security. ...,ajah,1,1,0,1,ajah2,800000.0,800000.0,800000.0,3,21,4,800000
102, badore ajah lagos,2,1,1,1,Newly built specious self-contained sheared apartment with constant water and light supply at palm will estate badore ajah. Only kitchen to be sheared by 3 flatmates ... Dry. New. Drainage System. Security Doors. Pop Ceiling. Street Lights. Big Compound. Cctv Cameras. All Room Ensuit. Supermarket Nearby. Parking Space. Fast Internet. 24 Hours Electricity. 24 Hours Security. Water Treatment. Free Wifi. Security. ...,ajah,0,0,0,1,ajah1,400000.0,500000.0,450000.0,1,6,1,400000
103, - sangotedo ajah lagos,7,4,3,4,"Luxurious 4units of 3bedroom Terrace duplex in a secured estate Rent-1. 5 Caution-100k Agent/legal 10% each Location-LBS/ Sangotedo A call to us will end your search immediately FOR FURTHER ENQUIRES, SPECIFIC REQUEST AND ARRANGEMENTS FOR PHYSICAL INSPECTIONS, KINDLY SEND US ... Dry. Drainage System. Children Play Ground. Big Compound. All Room Ensuit. Church Nearby. ...",ajah,1,1,1,1,ajah4,1200000.0,1500000.0,1300000.0,4,29,5,1500000
104, badore ajah lagos,6,3,3,3,Specious 3 bedroom apartment with state of the art finished on interlock road all rooms ensuit with constant light and water supply located at palmwill estate badore ajah. ... Cheap. Dry. New. Drainage System. Security Doors. Pop Ceiling. Street Lights. Big Compound. All Room Ensuit. Supermarket Nearby. Parking Space. Fast Internet. 24 Hours Electricity. 24 Hours Security. Water Treatment. Children Play Ground. Security. ...,ajah,1,1,1,1,ajah3,900000.0,1000000.0,1000000.0,4,24,4,1100000
105, greenville badore ajah lagos,3,2,1,2,"Brand new beautifully built 1bedroom flat at Greenville estate badore, Ajah. Rent : #450k ... New. Drainage System. Water Treatment. Security Doors. Security. Pop Ceiling. Big Compound. All Room Ensuit. Parking Space. 24 Hours Security. ...",ajah,1,1,0,1,ajah2,800000.0,800000.0,800000.0,3,21,4,800000
106, ogombo ajah lagos,2,1,1,1,Newly built mini flat Rent 550k Agency 10% Legal 10% Caution fee 10% Service charge 75k Location Abraham Adesanya /ogombo ... New. Big Compound. All Room Ensuit. Parking Space. 24 Hours Electricity. 24 Hours Security. ...,ajah,1,1,1,1,ajah1,400000.0,500000.0,450000.0,4,6,1,550000
107," off mobil road, ilaje ajah lagos",7,4,3,4,"*** 3 Bedroom Flat available For Rent *** 5 units available *** big rooms & living room *** Dining section available *** newly built and concrete compound *** Location: Alaguntan, off Mobil Road, Ajah. Lagos. ... Serviced. New. All Room Ensuit. Parking Space. ...",ajah,0,0,0,1,ajah4,1200000.0,1500000.0,1300000.0,1,29,5,1200000
108, badore ajah lagos,2,1,1,1,MiniFlat for rent @ Ajah - Badore Rent: *NGN 400k* Caution: NGN 50k PHCN for Pumping Machine: 12k / Annum Agency: 10% Legal: 10% ... ...,ajah,0,0,0,1,ajah1,400000.0,500000.0,450000.0,1,6,1,400000
109, awoyaya ajah lagos,9,5,4,5,FEATURES: - All Bedrooms En suite with Water Heaters - Fully Fitted Kitchen with Cabinets - Marble Tiles - Wardrobes - P.O.P ceiling - Dining - Serene Environment - Ample Parking Space. ... Serviced. New. Boys Quater. Water Treatment. Security Doors. Security. Pop Ceiling. Street Lights. Big Compound. All Room Ensuit. Parking Space. 24 Hours Security. ...,ajah,1,1,0,1,ajah5,3000000.0,3000000.0,3000000.0,3,43,8,3000000
110," fatai kaffo street,happy land estate olokonla ajah lagos",7,4,3,4,"Nicely renovated 3bedroom flat with all room en suite and a visitor toilet,with enough parking space in the compound in a serene neighborhood with good security ... Cheap. Dry. Renovated. Street Lights. Big Compound. All Room Ensuit. 24 Hours Security. ...",ajah,0,0,0,1,ajah4,1200000.0,1500000.0,1300000.0,1,29,5,1200000
111, mobil estate (emerald estate) ilaje ajah lagos,9,5,4,5,4 bedroom Detached Duplex House for rent Mobil estate (Emerald Estate) Ilaje Ajah Lagos ... ...,ajah,1,1,0,1,ajah5,3000000.0,3000000.0,3000000.0,3,43,8,3000000
112, - sangotedo ajah lagos,6,3,3,3,"TO LET! Godâ€™s Touch Apartments! (1). 3 Bedroom @floodgate Street, [Lagos Business School], Lekki-Ajah Rent 1.2m ... Big Compound. All Room Ensuit. Parking Space. 24 Hours Electricity. 24 Hours Security. ...",ajah,1,1,1,1,ajah3,900000.0,1000000.0,1000000.0,4,24,4,1200000
113, badore ajah lagos,6,3,3,3,Tastefully finished newly built 2 bedroom apartment with constant light and clean water located in unity estate badore ajah ... Cheap. Dry. New. Security Doors. Pop Ceiling. Street Lights. Big Compound. All Room Ensuit. Supermarket Nearby. Fast Internet. 24 Hours Electricity. 24 Hours Security. Water Treatment. Free Wifi. Children Play Ground. Security. ...,ajah,0,0,0,1,ajah3,900000.0,1000000.0,1000000.0,1,24,4,900000
114, badore ajah lagos,6,3,3,3,"A newly built specious 2 bedroom apartment all rooms ensuit, with constant light and clean water supply located in badore ajah. ... Cheap. Dry. New. Drainage System. Security Doors. Pop Ceiling. Street Lights. Big Compound. Cctv Cameras. All Room Ensuit. Parking Space. Fast Internet. 24 Hours Electricity. 24 Hours Security. Water Treatment. Survey. Children Play Ground. Security. ...",ajah,0,0,0,1,ajah3,900000.0,1000000.0,1000000.0,1,24,4,900000
115, badore ajah lagos,6,3,3,3,Tastefully finished 2 bedroom apartment all rooms ensuit with constant light and clean water supply located at unity estate badore ajah ... Cheap. Dry. New. Water Treatment. Security Doors. Security. Pop Ceiling. Street Lights. Big Compound. All Room Ensuit. Parking Space. Fast Internet. 24 Hours Electricity. 24 Hours Security. ...,ajah,0,0,0,1,ajah3,900000.0,1000000.0,1000000.0,1,24,4,900000
116," lucky osujie, lekki palm city estate ado ajah lagos",9,5,4,5,"New and tastefully finished 5units of 4 bedrooms detached houses with a room boy's quarter at lucky osujie street, Lekki palm city estate opp. Olumegbon palace off Ado road, Ajah, Lagos. Rent N2.3m and ... Dry. New. Drainage System. Water Treatment. Security Doors. Security. Pop Ceiling. Street Lights. Big Compound. Cctv Cameras. All Room Ensuit. Parking Space. 24 Hours Security. ...",ajah,1,1,0,1,ajah5,3000000.0,3000000.0,3000000.0,3,43,8,3000000
117, - ado ajah lagos,6,3,3,3,A specious newly built 2 bedroom apartment all rooms ensuit with constant light and clean water supply situated on a good road in Harmony estate owode ajah ... Dry. New. Security Doors. Pop Ceiling. Street Lights. Big Compound. All Room Ensuit. Supermarket Nearby. Parking Space. Fast Internet. 24 Hours Electricity. 24 Hours Security. Water Treatment. Free Wifi. Children Play Ground. Security. ...,ajah,0,0,0,1,ajah3,900000.0,1000000.0,1000000.0,1,24,4,900000
118, badore ajah lagos,4,2,2,2,A newly built room and parlour mini flat with constant light and clean water located in palmwill estate badore ajah ... Cheap. Dry. New. Water Treatment. Security Doors. Security. Pop Ceiling. Street Lights. Big Compound. All Room Ensuit. Supermarket Nearby. Fast Internet. 24 Hours Electricity. 24 Hours Security. ...,ajah,1,1,0,1,ajah2,800000.0,800000.0,800000.0,3,21,4,800000
119, emerald estate off mobil road ilaje ajah lagos,11,6,5,6,"Luxury 5bedroom detached house with a room boys quarter off mobil road, emerald estate Ajah. Rent #2,500,000 ... Dry. Drainage System. Security Doors. Pop Ceiling. Street Lights. Big Compound. Cctv Cameras. All Room Ensuit. Parking Space. 24 Hours Security. Boys Quater. Water Treatment. Children Play Ground. Security. ...",ajah,1,1,0,1,ajah6,4000000.0,4000000.0,4000000.0,3,50,9,4000000
120, badore ajah lagos,6,3,3,3,Specious 2 bedroom apartment all rooms ensuit with constant light and water supply located at palmwill estate badore ajah ... Cheap. New. Drainage System. Security Doors. Pop Ceiling. Street Lights. Big Compound. All Room Ensuit. Supermarket Nearby. Parking Space. Fast Internet. 24 Hours Electricity. 24 Hours Security. Water Treatment. Security. ...,ajah,0,0,0,1,ajah3,900000.0,1000000.0,1000000.0,1,24,4,900000
121, ado ajah lagos,2,1,1,1,Newly built single room Self-contained apartment with kitchen and toilet and constant water and light supply at marshy hill estate ... Cheap. Dry. New. Water Treatment. Security Doors. Security. Pop Ceiling. Street Lights. Big Compound. All Room Ensuit. Supermarket Nearby. Parking Space. Fast Internet. 24 Hours Electricity. 24 Hours Security. ...,ajah,0,0,0,1,ajah1,400000.0,500000.0,450000.0,1,6,1,400000
122, awoyaya ajah lagos,8,4,4,4,"Lovely 3br flat all en suit,3 no's vacant at Awoyaya by ologunfe bus stop immediately after choscharis...Taiwo ariwoya street second junction after entering ologunfe bus stop,ajah.(#750t*1yr negotiable) ... ...",ajah,0,0,0,1,ajah4,1200000.0,1500000.0,1300000.0,1,29,5,1200000
123, awoyaya ajah lagos,4,2,2,2,Newly built spacious 2bedroom flat with dinning for rent Rent-570 Agent/legal-110k Total package-680k Location-Awoyaya ... New. Big Compound. All Room Ensuit. Parking Space. 24 Hours Electricity. 24 Hours Security. ...,ajah,1,1,0,1,ajah2,800000.0,800000.0,800000.0,3,21,4,800000
124," salvation estate off addo/langbasa road, ajah lagos",3,2,1,2,"1 Bedroom Luxury apartment with Fitted kitchen with ACs. 1brm=800k per annum. Service charge=150k. Refundable deposit for 1bedroom is 150k splits ACs, fitted wardrobe, fitted kitchen, electric fence, security. Etc ... Dry. Drainage System. Water Treatment. Security Doors. Security. Pop Ceiling. Big Compound. All Room Ensuit. Parking Space. 24 Hours Security. ...",ajah,1,1,0,1,ajah2,800000.0,800000.0,800000.0,3,21,4,800000
125, ... badore ajah lagos,2,1,1,1,A spacious sheared selfcontain apartment tastefully finished all rooms ensuit with constant light and water supply located at unity estate badore. Only kitchen to be sheared by occupants ... Cheap. Dry. New. Drainage System. Security Doors. Pop Ceiling. Street Lights. Big Compound. Cctv Cameras. All Room Ensuit. Supermarket Nearby. Parking Space. Fast Internet. 24 Hours Electricity. 24 Hours Security. Water Treatment. Security. ...,ajah,0,0,0,1,ajah1,400000.0,500000.0,450000.0,1,6,1,400000
126, badore ajah lagos,5,3,2,3,Newly Built 2 Bedroom Flat for rent @ Ajah - Badore Rent: *NGN 900k* (upstairs) Service charge: 100k (excluding power) Caution: 100k Agency: 10% Legal: 10% ... New. Drainage System. Water Treatment. Security. Pop Ceiling. Big Compound. All Room Ensuit. Parking Space. ...,ajah,0,0,0,1,ajah3,900000.0,1000000.0,1000000.0,1,24,4,900000
127, badore ajah lagos,6,3,3,3,"A tastefully finished 2 bedroom apartment all rooms ensuit with constant light, clean water and good road located inside seaside estate badore ajah ... Cheap. Dry. New. Drainage System. Security Doors. Pop Ceiling. Street Lights. Big Compound. All Room Ensuit. Supermarket Nearby. Parking Space. Fast Internet. 24 Hours Electricity. 24 Hours Security. Children Play Ground. Security. ...",ajah,0,0,0,1,ajah3,900000.0,1000000.0,1000000.0,1,24,4,900000
128, alasela ogombo ajah lagos,4,2,2,2,Newly built two bedroom apartments Rent 550k Agency 60k Legal 60k Caution fee 30k Service charge 50k Location Abraham adesanye /ogombo ... New. Big Compound. All Room Ensuit. Parking Space. 24 Hours Electricity. 24 Hours Security. ...,ajah,1,1,0,1,ajah2,800000.0,800000.0,800000.0,3,21,4,800000
129, ado ajah lagos,5,3,2,3,Well maintained 2 Bedroom Flat For Rent @ Ajah - Ado Road Rental fee: NGN 1 million Service Charge: NGN 200k Caution: NGN 100k Agency: 10% Legal: 5% ... Serviced. Water Treatment. Security. ...,ajah,1,1,0,1,ajah3,900000.0,1000000.0,1000000.0,3,24,4,1000000
130, ado ajah lagos,4,2,2,2,A tastefully finished specious room and parlour mini flat at Marshy Hill estate ado (skins) with state of the art finished with constant light and clean water supply on an interlocking good road. Good security ... Dry. New. Drainage System. Security Doors. Pop Ceiling. Street Lights. Big Compound. Cctv Cameras. All Room Ensuit. Supermarket Nearby. Parking Space. Fast Internet. 24 Hours Electricity. 24 Hours Security. Water Treatment. Free Wifi. Security. ...,ajah,1,1,0,1,ajah2,800000.0,800000.0,800000.0,3,21,4,800000
131, badore ajah lagos,3,2,1,2,A Specious room and parlour mini flat with constant light and water supply at Greenville estate badore ... Cheap. Dry. New. Drainage System. Security Doors. Pop Ceiling. Street Lights. Big Compound. All Room Ensuit. Supermarket Nearby. Parking Space. Fast Internet. 24 Hours Electricity. 24 Hours Security. Water Treatment. Children Play Ground. Security. ...,ajah,1,1,0,1,ajah2,800000.0,800000.0,800000.0,3,21,4,800000
132, badore ajah lagos,4,2,2,2,Tastefully finished room and parlour mini flat apartment with constant light and clean water located at seaside estate badore ajah ... Cheap. New. Drainage System. Security Doors. Pop Ceiling. Street Lights. Big Compound. All Room Ensuit. Supermarket Nearby. Parking Space. Fast Internet. 24 Hours Electricity. 24 Hours Security. Water Treatment. Children Play Ground. Security. ...,ajah,1,1,0,1,ajah2,800000.0,800000.0,800000.0,3,21,4,800000
133, badore ajah lagos,2,1,1,1,A tastefully finished sheared apartment self-contained with constant light and clean water located within palmwill estate (akins) ... Cheap. Dry. New. Drainage System. Security Doors. Pop Ceiling. Street Lights. Big Compound. Cctv Cameras. All Room Ensuit. Parking Space. Fast Internet. 24 Hours Electricity. 24 Hours Security. Water Treatment. Free Wifi. Security. ...,ajah,0,0,0,1,ajah1,400000.0,500000.0,450000.0,1,6,1,400000
134, badore ajah lagos,6,3,3,3,A newly built 2 Bedroom Apartment all rooms ensuit with constant light and water supply and 24hr security surveillance.. ... Cheap. New. Water Treatment. Security Doors. Security. Pop Ceiling. Street Lights. Big Compound. All Room Ensuit. Supermarket Nearby. Parking Space. Fast Internet. 24 Hours Electricity. 24 Hours Security. ...,ajah,0,0,0,1,ajah3,900000.0,1000000.0,1000000.0,1,24,4,900000
135, greenville estate badore ajah lagos,7,4,3,4,"Beautiful and spacious 3bedroom Flat with 4toilet, 3bath at odunmayew street, greetings estate badge, Ajah. Rent #700,000 ... Renovated. Drainage System. Water Treatment. Security Doors. Security. Pop Ceiling. Big Compound. All Room Ensuit. Parking Space. ...",ajah,0,0,0,1,ajah4,1200000.0,1500000.0,1300000.0,1,29,5,1200000
136, badore ajah lagos,6,3,3,3,A specious 2 bedroom apartment all rooms ensuit with constant light and water supply located at rock stone estate badore ajah ... Cheap. New. Drainage System. Security Doors. Pop Ceiling. Street Lights. Big Compound. All Room Ensuit. Supermarket Nearby. Parking Space. Fast Internet. 24 Hours Electricity. 24 Hours Security. Water Treatment. Security. ...,ajah,0,0,0,1,ajah3,900000.0,1000000.0,1000000.0,1,24,4,900000
137, badore ajah lagos,6,3,3,3,Tastefully finished 2 Bedroom apartment all rooms ensuit with constant light and water supply at Royal palmwill estate badore ajah ... Cheap. Dry. New. Drainage System. Security Doors. Pop Ceiling. Street Lights. Big Compound. All Room Ensuit. Supermarket Nearby. Parking Space. Fast Internet. 24 Hours Electricity. 24 Hours Security. Water Treatment. Children Play Ground. Security. Restaurants Nearby. ...,ajah,0,0,0,1,ajah3,900000.0,1000000.0,1000000.0,1,24,4,900000
138, badore ajah lagos,4,2,2,2,A Specious room and parlour mini flat apartment with constant light and water supply located at palmwill estate badore ... Dry. New. Drainage System. Security Doors. Pop Ceiling. Street Lights. Big Compound. All Room Ensuit. Supermarket Nearby. Parking Space. Fast Internet. 24 Hours Electricity. 24 Hours Security. Water Treatment. Security. ...,ajah,1,1,0,1,ajah2,800000.0,800000.0,800000.0,3,21,4,800000
139, ... badore ajah lagos,9,5,4,5,A specious 3 bedroom duplex apartment all rooms ensuit with constant light and water supply located at vina estate badore ajah ... Cheap. Dry. New. Drainage System. Security Doors. Pop Ceiling. Street Lights. Big Compound. All Room Ensuit. Supermarket Nearby. Parking Space. Fast Internet. 24 Hours Electricity. 24 Hours Security. Water Treatment. Children Play Ground. Security. ...,ajah,1,1,0,1,ajah5,3000000.0,3000000.0,3000000.0,3,43,8,3000000
140, greenville estate badore ajah lagos,5,3,2,3,Beautifully built brand new 2bedroom flat with enough parking space with executive finishing. Rent #850k ... New. Water Treatment. Security Doors. Security. Pop Ceiling. Big Compound. All Room Ensuit. Parking Space. 24 Hours Security. ...,ajah,0,0,0,1,ajah3,900000.0,1000000.0,1000000.0,1,24,4,900000
141, mobile ajah lagos,9,5,4,5,"Newly built 4bedroom duplex for rent location:ajah/mobile road rent:1.7 caution:100k legal:5% agent:10% a call to us will definitely end your search for a house for further enquires, specific request and arrangements for physical inspections, kindly send us a screenshot or the link ... Dry. New. Drainage System. Water Treatment. Children Play Ground. Printing Service. Big Compound. All Room Ensuit. Church Nearby. Parking Space. 24 Hours Electricity. 24 Hours Security. Restaurants Nearby. ...",ajah,1,1,0,1,ajah5,3000000.0,3000000.0,3000000.0,3,43,8,3000000
142, ado ajah lagos,9,5,4,5,Newly Built 4 Bedroom Detached Duplex + BQ For Lease @ Ajah - AdoÂ  Rental Fee: *NGN 2.7m* Caution Fee: NGN 200k Agency: 10% Legal: 10% ... New. Boys Quater. Water Treatment. Security. Pop Ceiling. Big Compound. All Room Ensuit. 24 Hours Security. ...,ajah,1,1,0,1,ajah5,3000000.0,3000000.0,3000000.0,3,43,8,3000000
143, lekki scheme 2 ajah lagos,9,5,4,5,Brand New 4 Bedroom Semi Detached Duplex + 2 Bedroom BQ. Rent: NGN 2.5 m Agency: 10% Legal: 5% ... New. Drainage System. Boys Quater. Water Treatment. Pop Ceiling. Big Compound. All Room Ensuit. ...,ajah,1,1,0,1,ajah5,3000000.0,3000000.0,3000000.0,3,43,8,3000000
144, lekki scheme 2 ajah lagos,9,5,4,5,Spacious 4 Bedroom Detached Duplex + Bq + 2 Sitting Rooms + Study Room For rent @ Ajah - Lekki Scheme 2 Rental fee: NGN 3m (negotiable) Agency: 10% Legal: 10% ... Boys Quater. Pop Ceiling. Big Compound. All Room Ensuit. ...,ajah,1,1,0,1,ajah5,3000000.0,3000000.0,3000000.0,3,43,8,3000000
145, lekki scheme 2 ajah lagos,7,4,3,4,Well Maintained 3 Bedroom Flat + BQ for rent @ Ajah - Lekki Scheme 2 Rental fee: NGN 1.5m Caution Fee: NGN 400k Service Charge: NGN 200k Agency: 10% Legal: 10% ... Boys Quater. Water Treatment. Security. Pop Ceiling. Big Compound. All Room Ensuit. Parking Space. ...,ajah,1,1,1,1,ajah4,1200000.0,1500000.0,1300000.0,4,29,5,1500000
146, - badore ajah lagos,4,2,2,2,A specious newly built room and parlour mini flat at palmwill estate (remlek) badore with constant light and clean water supply situated on a good road ... Dry. New. Drainage System. Water Treatment. Security Doors. Security. Pop Ceiling. Street Lights. Big Compound. All Room Ensuit. Fast Internet. 24 Hours Electricity. 24 Hours Security. ...,ajah,1,1,0,1,ajah2,800000.0,800000.0,800000.0,3,21,4,800000
147, badore ajah lagos,6,3,3,3,Tastefully finished 2 bedroom apartment with constant light and water supply at Greenville estate badore ajah ... Dry. New. Water Treatment. Security Doors. Security. Pop Ceiling. Street Lights. Big Compound. All Room Ensuit. Supermarket Nearby. Fast Internet. 24 Hours Electricity. 24 Hours Security. ...,ajah,0,0,0,1,ajah3,900000.0,1000000.0,1000000.0,1,24,4,900000
148, ado ajah lagos,4,2,2,2,Specious room and parlour mini flat apartment with constant light and clean water supply located at marshy hill estate ado ajah ... Cheap. Dry. New. Drainage System. Security Doors. Pop Ceiling. Street Lights. Big Compound. All Room Ensuit. Supermarket Nearby. Parking Space. Fast Internet. 24 Hours Electricity. 24 Hours Security. Water Treatment. Security. ...,ajah,1,1,0,1,ajah2,800000.0,800000.0,800000.0,3,21,4,800000
149, - badore ajah lagos,2,1,1,1,"A tastefully finished single room self contain sheared apartment with latest state of the art finished, all rooms ensuit and shearing only kitchen with constant light and water supply located Greenville estate badore ajah ... Cheap. Dry. Furnished. New. Drainage System. Security Doors. Pop Ceiling. Street Lights. Big Compound. All Room Ensuit. Supermarket Nearby. Parking Space. Fast Internet. 24 Hours Electricity. 24 Hours Security. Water Treatment. Security. ...",ajah,0,0,0,1,ajah1,400000.0,500000.0,450000.0,1,6,1,400000
150, ado ajah lagos,4,2,2,2,Room and parlour mini flat apartment with constant light and clean water supply located at amen view estate ado ... Cheap. Dry. New. Drainage System. Security Doors. Pop Ceiling. Street Lights. Big Compound. All Room Ensuit. Supermarket Nearby. Parking Space. Fast Internet. 24 Hours Electricity. 24 Hours Security. Water Treatment. Children Play Ground. Security. ...,ajah,1,1,0,1,ajah2,800000.0,800000.0,800000.0,3,21,4,800000
151, badore ajah lagos,2,1,1,1,A specious single room self-contained apartment at Greenville estate badore with kitchen and toilets inside. With constant and water supply ... Dry. New. Security Doors. Pop Ceiling. Street Lights. Big Compound. All Room Ensuit. Supermarket Nearby. Parking Space. Fast Internet. 24 Hours Electricity. 24 Hours Security. Water Treatment. Free Wifi. Security. ...,ajah,0,0,0,1,ajah1,400000.0,500000.0,450000.0,1,6,1,400000
152, lamgbasa ado ajah lagos,5,3,2,3,Newly Built 2 Bedroom Flat For Rent @ Ajah - Addo - Lamgbasa Rent: *NGN 1 million* Service Charge: NGN 100k Caution: NGN 100k Agency: 10% Legal: 10% ... New. Drainage System. Water Treatment. Security. Pop Ceiling. All Room Ensuit. ...,ajah,1,1,0,1,ajah3,900000.0,1000000.0,1000000.0,3,24,4,1000000
153, abraham adesanya estate ajah lagos,6,3,3,3,3bedroom service Apartment with swimming pool to let Rent:1.5 Caution 150k S/C 400k Agent/legal 10% each. Location: Abraham Adesunya/ Ajah ... Swimming Pool. Big Compound. All Room Ensuit. Parking Space. 24 Hours Electricity. 24 Hours Security. ...,ajah,1,1,1,1,ajah3,900000.0,1000000.0,1000000.0,4,24,4,1500000
154, alaguntan ajah lagos,7,4,3,4,-- 16 No's Newly built 3 bedroom luxury flat -- All rooms are ensuite + water heater in the toilets -- Spacious rooms & living room -- Dining space available -- Spacious Kitchen with nice cabinet -- nice fittings -- Each ... Serviced. Dry. New. Gym. Water Treatment. Security. Pop Ceiling. Big Compound. All Room Ensuit. Supermarket Nearby. Parking Space. 24 Hours Security. ...,ajah,1,1,1,1,ajah4,1200000.0,1500000.0,1300000.0,4,29,5,2000000
155, ajah lagos,9,5,4,5,"Sweetly built and affordable 4 bedroom detached house for rent in a secured estate. Location:Ajah/Ado road Rent: 2m, Two years 3m Legal:5% Agent:10% A call to us will definitely end your search for a house FOR FURTHER ENQUIRES, SPECIFIC REQUEST AND ... Cheap. Dry. Drainage System. Water Treatment. Children Play Ground. Security. Pop Ceiling. Street Lights. Supermarket Nearby. Church Nearby. Parking Space. Restaurants Nearby. ...",ajah,1,1,0,1,ajah5,3000000.0,3000000.0,3000000.0,3,43,8,3000000
156, .. sangotedo ajah lagos,7,4,3,4,"Exceptionally clean, lovely and comfortable 3 Bedroom flats (downstairs) in a secured Goodnews estate at Sangotedo, Ajah, Lagos. Rent ..1.2m Caution fee..150k Legal fee..10% Agency...10% Service charge..60k The features are: Solar system (green house) for 24-hours electricity supply from the sun Air ... Serviced. Dry. Children Play Ground. Big Compound. All Room Ensuit. Church Nearby. ...",ajah,0,0,0,1,ajah4,1200000.0,1500000.0,1300000.0,1,29,5,1200000
157, badore ajah lagos,2,1,1,1,"A self-contained sheared apartment, room ensuit sheared only kitchen, have constant light and clean water supply located in unity estate badore ajah ... Cheap. Dry. New. Security Doors. Pop Ceiling. Street Lights. Big Compound. Cctv Cameras. All Room Ensuit. Supermarket Nearby. Parking Space. Fast Internet. 24 Hours Electricity. 24 Hours Security. Water Treatment. Free Wifi. Security. ...",ajah,0,0,0,1,ajah1,400000.0,500000.0,450000.0,1,6,1,400000
158, badore ajah lagos,6,3,3,3,2 bedroom apartment at unity estate badore with constant light and clean water supply. ... Dry. New. Water Treatment. Security Doors. Security. Pop Ceiling. Street Lights. Big Compound. All Room Ensuit. Supermarket Nearby. Parking Space. Fast Internet. 24 Hours Electricity. 24 Hours Security. ...,ajah,0,0,0,1,ajah3,900000.0,1000000.0,1000000.0,1,24,4,900000
159, ... badore ajah lagos,8,4,4,4,A tastefully finished 3 Bedroom apartment all rooms ensuit with constant light and clean water supply located in seaside estate badore close to the road. Constant security ... Cheap. Dry. New. Drainage System. Security Doors. Pop Ceiling. Street Lights. Big Compound. Cctv Cameras. All Room Ensuit. Parking Space. Fast Internet. 24 Hours Electricity. 24 Hours Security. Water Treatment. Free Wifi. Children Play Ground. Security. ...,ajah,0,0,0,1,ajah4,1200000.0,1500000.0,1300000.0,1,29,5,1200000
160, by lekki gardens phase 2 abraham adesanya estate ajah lagos,7,4,3,4,"This is a brand new development of only Eight units of contemporary 3 bedroom maisonette apartments. It comprises: fully fitted kitchens, high quality security doors, high grade floor tiles, borehole and water treatment facility, dedicated ... Serviced. New. Water Treatment. Big Compound. All Room Ensuit. Supermarket Nearby. 24 Hours Security. ...",ajah,1,1,1,1,ajah4,1200000.0,1500000.0,1300000.0,4,29,5,2000000
161, ado ajah lagos,11,6,5,6,"FEATURES: - All Bedrooms En suite with Water Heaters - Fully Fitted Kitchen with Cabinets - Marble Tiles - Wardrobes - P.O.P ceiling - Dining - Serene Environment -Swimming pool, Ample Parking Space. ... New. Boys Quater. Water Treatment. Security Doors. Security. Pop Ceiling. Street Lights. Swimming Pool. Big Compound. Cctv Cameras. All Room Ensuit. Parking Space. ...",ajah,1,1,0,1,ajah6,4000000.0,4000000.0,4000000.0,3,50,9,4000000
162, badore ajah lagos,6,3,3,3,"Newly built, 2 bedroom apartment tastefully finished with constant light and clean water located at palm will estate badore ajah ... Cheap. Dry. Swampy. New. Drainage System. Security Doors. Pop Ceiling. Street Lights. Big Compound. Cctv Cameras. All Room Ensuit. Supermarket Nearby. Parking Space. Fast Internet. 24 Hours Electricity. 24 Hours Security. Water Treatment. Security. ...",ajah,0,0,0,1,ajah3,900000.0,1000000.0,1000000.0,1,24,4,900000
163, badore ajah lagos,4,2,2,2,"Newly built tastefully finished and Specious room and parlour mini flat Duplex with state of art finished with constant light, water supply and good road located at unity estate badore ajah ... Furnished. New. Drainage System. Security Doors. Pop Ceiling. Street Lights. Big Compound. Cctv Cameras. All Room Ensuit. Supermarket Nearby. Parking Space. Fast Internet. 24 Hours Electricity. 24 Hours Security. Water Treatment. Free Wifi. Security. ...",ajah,1,1,0,1,ajah2,800000.0,800000.0,800000.0,3,21,4,800000
164, gold in estate badore ajah lagos,6,3,3,3,Fantastic 3 bedroom Bungalow with Excellent Facilities Inside a lovely Estate Close to Estate Gate Decent compound and neat 2people in a compound Visitors waiting room Big palour Big room with big wardrobes Bathrooms with bathtub and water heater Pop finishing Dinning ... Renovated. Drainage System. Security Doors. Security. Pop Ceiling. Big Compound. Jacuzzi. Parking Space. Fast Internet. 24 Hours Electricity. 24 Hours Security. ...,ajah,0,0,0,1,ajah3,900000.0,1000000.0,1000000.0,1,24,4,900000
165, badore ajah lagos,6,3,3,3,Specious 2 Bedroom apartment with constant light and water supply located at anu Crescent estate badore ajah ... New. Water Treatment. Security Doors. Security. Pop Ceiling. Street Lights. Big Compound. All Room Ensuit. Supermarket Nearby. Parking Space. Fast Internet. 24 Hours Electricity. 24 Hours Security. ...,ajah,0,0,0,1,ajah3,900000.0,1000000.0,1000000.0,1,24,4,900000
166, thomas estate ajah lagos,6,3,3,3,Tastefully finished 2 bedroom apartment at Thomas estate with constant light and clean water supply. Building located very closed to the gate... ... Cheap. Dry. New. Drainage System. Security Doors. Child Care. Pop Ceiling. Street Lights. Big Compound. Cctv Cameras. All Room Ensuit. Supermarket Nearby. Parking Space. Fast Internet. 24 Hours Electricity. 24 Hours Security. Water Treatment. Free Wifi. Front Desk Service. Children Play Ground. Security. ...,ajah,1,1,0,1,ajah3,900000.0,1000000.0,1000000.0,3,24,4,1000000
167," idowu estate, oke ira ado ajah lagos",5,3,2,3,"3 bedroom Flat / Apartment for rent Idowu estate, oke ira Ado Ajah Lagos ... ...",ajah,0,0,0,1,ajah3,900000.0,1000000.0,1000000.0,1,24,4,900000
168, - sangotedo ajah lagos,5,3,2,3,Newly Built 2 bedroom Flat for rent @ Ajah - Sangotedo Rental Fee: NGN 1.3 m Caution fee: NGN 100 k Agency Fee: 10%Â  Legal Fee: 10%Â  Location: Ajah - Sangotedo Rental Fee: NGN 1.3 m ... New. Drainage System. Water Treatment. Security. Pop Ceiling. Street Lights. Big Compound. All Room Ensuit. Parking Space. ...,ajah,1,1,1,1,ajah3,900000.0,1000000.0,1000000.0,4,24,4,1300000
169, lbs ajah lagos,7,4,3,4,"Magnificent 3 bedrooms flat Rent ..1.2m Sangotedo LBS A call to us will end your search immediately FOR FURTHER ENQUIRES, SPECIFIC REQUEST AND ARRANGEMENTS FOR PHYSICAL INSPECTIONS, KINDLY SEND US A SCREENSHOT OR THE LINK TO THIS APARTMENT INSPECTIONS ... Dry. Drainage System. Children Play Ground. Street Lights. Big Compound. Supermarket Nearby. Church Nearby. ...",ajah,0,0,0,1,ajah4,1200000.0,1500000.0,1300000.0,1,29,5,1200000
170, badore ajah lagos,6,3,3,3,Tastefully finished newly built 2 Bedroom apartment at seaside estate badore ajah with constant light and clean water supply. ... Cheap. Dry. New. Drainage System. Security Doors. Pop Ceiling. Street Lights. Big Compound. All Room Ensuit. Parking Space. Fast Internet. 24 Hours Electricity. 24 Hours Security. Water Treatment. Children Play Ground. Security. ...,ajah,0,0,0,1,ajah3,900000.0,1000000.0,1000000.0,1,24,4,900000
171, badore ajah lagos,2,1,1,1,"A newly built 5 star self-contained sheared apartment tastefully finished with latest state of the art finished with constant light and water supply, located at Royal Palm will estate at badore ajah ... Cheap. Dry. New. Drainage System. Security Doors. Pop Ceiling. Street Lights. Big Compound. All Room Ensuit. Supermarket Nearby. Parking Space. Fast Internet. 24 Hours Electricity. 24 Hours Security. Water Treatment. Free Wifi. Security. ...",ajah,0,0,0,1,ajah1,400000.0,500000.0,450000.0,1,6,1,400000
172, facing locuse army on ado road ado ajah lagos,6,3,3,3,"Strategically located 3bedroom ground floor facing main ado road, suitable for office and residential Rent #600,000 ... Cheap. Dry. Renovated. Drainage System. Security. Big Compound. Parking Space. ...",ajah,0,0,0,1,ajah3,900000.0,1000000.0,1000000.0,1,24,4,900000
173, abraham adesanya estate ajah lagos,7,4,3,4,"Fabulous 3bedrooms flat with a bq for rent Rent:1.5m Caution 150k Agent/legal 10% each Location Abraham Adesanya A call to us will end your search immediately FOR FURTHER ENQUIRES, SPECIFIC REQUEST AND ARRANGEMENTS FOR PHYSICAL INSPECTIONS, KINDLY SEND US A SCREENSHOT ... Dry. Big Compound. ...",ajah,1,1,1,1,ajah4,1200000.0,1500000.0,1300000.0,4,29,5,1500000
174, .. abraham adesanya estate ajah lagos,7,4,3,4,"Luxurious 3bedroom service Apartment with swimming pool to let Rent:1.5 Caution 150k S/C 400k Agent/legal 10% each. Location: Abraham Adesunya/ Ajah A call to us will end your search immediately FOR FURTHER ENQUIRES, SPECIFIC REQUEST AND ARRANGEMENTS FOR PHYSICAL INSPECTIONS, KINDLY SEND ... Serviced. Dry. Drainage System. Pop Ceiling. Street Lights. Big Compound. All Room Ensuit. Supermarket Nearby. Parking Space. 24 Hours Security. Water Treatment. Children Play Ground. Security. Swimming Pool. Church Nearby. Restaurants Nearby. ...",ajah,1,1,1,1,ajah4,1200000.0,1500000.0,1300000.0,4,29,5,1500000
175, - sangotedo ajah lagos,5,3,2,3,"Brand new 2bedroom apartment Rent. 1.3m Agency. 10% Legal. 10% Caution. 5% Location. Aptec road Sangotedo. A call to us will end your search immediately FOR FURTHER ENQUIRES, SPECIFIC REQUEST AND ARRANGEMENTS FOR PHYSICAL INSPECTIONS, KINDLY SEND US A SCREENSHOT OR THE ... Dry. Drainage System. Children Play Ground. Big Compound. All Room Ensuit. Church Nearby. ...",ajah,1,1,1,1,ajah3,900000.0,1000000.0,1000000.0,4,24,4,1300000
176, - sangotedo ajah lagos,7,4,3,4,"Fantastic 3bedroom flat (all rooms ensuit) Upstairs Rent. 850k Agency. 10% Legal. 10% Caution. Nill Sangotedo/ Aptec Total. 1.020k A call to us will end your search immediately FOR FURTHER ENQUIRES, SPECIFIC REQUEST AND ARRANGEMENTS FOR PHYSICAL INSPECTIONS, KINDLY SEND US A ... Dry. Drainage System. Children Play Ground. Big Compound. Church Nearby. ...",ajah,0,0,0,1,ajah4,1200000.0,1500000.0,1300000.0,1,29,5,1200000
177, sangotedo ajah lagos,9,5,4,5,"Sweet to live 4 bedroom flat Location: Sangotedo Rent:1.6 Caution:100k Legal:5% Agency:5% Are you looking for affordable Luxury. A call to us will get you the luxury you deserve FOR FURTHER ENQUIRES, SPECIFIC REQUEST AND ARRANGEMENTS FOR PHYSICAL INSPECTIONS, KINDLY SEND US ... Dry. Drainage System. Children Play Ground. Big Compound. All Room Ensuit. Church Nearby. 24 Hours Security. ...",ajah,1,1,0,1,ajah5,3000000.0,3000000.0,3000000.0,3,43,8,3000000
178, sangotedo ajah lagos,9,5,4,5,"Luxurious 4bedrooms fully detached duplex with a room BQ. Location- sangotedo, lekki. Land -325sqm Title-C of O Asking price 40millon , but can be negotiated. A call to us will definitely end your search for a house FOR FURTHER ENQUIRES, ... Boys Quater. Big Compound. All Room Ensuit. 24 Hours Electricity. 24 Hours Security. ...",ajah,1,1,1,1,ajah5,3000000.0,3000000.0,3000000.0,4,43,8,5000000
179, sangotedo ajah lagos,15,8,7,8,"Mind blowing and cheap Seven bedroom duplex with two kitchen Rent 3m Caution fee 200k Agency 10 % Legal 10 % Location sangotedo /Lagos business school Call us now and this is all yours FOR FURTHER ENQUIRES, SPECIFIC REQUEST AND ARRANGEMENTS FOR ... Cheap. Dry. Renovated. Drainage System. Pop Ceiling. Street Lights. Big Compound. All Room Ensuit. Supermarket Nearby. Parking Space. 24 Hours Electricity. 24 Hours Security. Water Treatment. Children Play Ground. Church Nearby. Restaurants Nearby. ...",ajah,1,1,0,1,ajah8,5500000.0,5500000.0,5500000.0,3,54,10,5500000
180, badore ajah lagos,4,2,2,2,A specious room and parlour mini flat apartment with constant light and water supply located at palmwill estate badore ajah ... Cheap. Swampy. New. Drainage System. Security Doors. Pop Ceiling. Street Lights. Big Compound. All Room Ensuit. Supermarket Nearby. Fast Internet. 24 Hours Electricity. 24 Hours Security. Water Treatment. Children Play Ground. Security. ...,ajah,1,1,0,1,ajah2,800000.0,800000.0,800000.0,3,21,4,800000
181, badore ajah lagos,8,4,4,4,A newly built duplex apartment all rooms ensuit with constant light and water supply located at seaside estate badore ajah ... New. Drainage System. Security Doors. Child Care. Pop Ceiling. Street Lights. Big Compound. All Room Ensuit. Supermarket Nearby. Parking Space. Fast Internet. 24 Hours Electricity. 24 Hours Security. Water Treatment. Children Play Ground. Security. Restaurants Nearby. ...,ajah,1,1,1,1,ajah4,1200000.0,1500000.0,1300000.0,4,29,5,1500000
182, badore ajah lagos,8,4,4,4,Newly built 3 bedroom duplex apartment all rooms ensuit with constant light and water supply located at seaside estate badore ajah. ... Cheap. New. Drainage System. Security Doors. Pop Ceiling. Street Lights. Big Compound. All Room Ensuit. Supermarket Nearby. Parking Space. Fast Internet. 24 Hours Electricity. 24 Hours Security. Water Treatment. Children Play Ground. Security. Restaurants Nearby. ...,ajah,0,0,0,1,ajah4,1200000.0,1500000.0,1300000.0,1,29,5,1200000
183, lbs sangotedo ajah lagos,15,8,7,8,Seven bedroom duplex with two kitchen Rent 3m Caution fee 200k Agency 10 % Legal 10 % Location sangotedo /Lagos business school ... New. All Room Ensuit. Parking Space. 24 Hours Electricity. ...,ajah,1,1,0,1,ajah8,5500000.0,5500000.0,5500000.0,3,54,10,5500000
184," mobil road, ilaje ajah lagos",9,5,4,5,** 4 Bedroom semi detached duplex with a room self contain BQ ** has spacious Living room and family lounge ** Spacious rooms and all room en suite ** dedicated borehole & treatment plant ** nice kitchen and ... Renovated. Boys Quater. Water Treatment. Security. Big Compound. All Room Ensuit. 24 Hours Security. ...,ajah,1,1,0,1,ajah5,3000000.0,3000000.0,3000000.0,3,43,8,3000000
185," opposite eco bank, pavilion estate ado road ajah ado ajah lagos",9,5,4,5,"4 bedroom Detached Duplex House for rent Opposite Eco Bank, pavilion estate ado road ajah Ado Ajah Lagos ... New. Ocean View. Security. Pop Ceiling. Street Lights. Big Compound. Cctv Cameras. All Room Ensuit. Church Nearby. ...",ajah,1,1,0,1,ajah5,3000000.0,3000000.0,3000000.0,3,43,8,3000000
186, badore ajah lagos,8,4,4,4,Luxury 3 bedroom apartment tastefully finished with constant light and clean water located in Greenville estate badore ajah ... Cheap. Swampy. Furnished. Security Doors. Pop Ceiling. Street Lights. Big Compound. All Room Ensuit. Supermarket Nearby. Parking Space. Fast Internet. 24 Hours Electricity. 24 Hours Security. Water Treatment. Children Play Ground. Security. ...,ajah,0,0,0,1,ajah4,1200000.0,1500000.0,1300000.0,1,29,5,1200000
187, badore ajah lagos,6,3,3,3,Tastefully finished 2 bedroom luxury apartment with constant light and water supply at Anu crescent estate badore ajah ... Dry. New. Security Doors. Pop Ceiling. Street Lights. Big Compound. All Room Ensuit. Supermarket Nearby. Parking Space. Fast Internet. 24 Hours Electricity. 24 Hours Security. Water Treatment. Free Wifi. Security. ...,ajah,0,0,0,1,ajah3,900000.0,1000000.0,1000000.0,1,24,4,900000
188, badore ajah lagos,6,3,3,3,A newly built specious 2 bedroom apartment at cooperative road badore all rooms ensuit with constant water and light supply ... Cheap. Dry. New. Drainage System. Security Doors. Pop Ceiling. Street Lights. Big Compound. All Room Ensuit. Supermarket Nearby. Parking Space. Fast Internet. 24 Hours Electricity. 24 Hours Security. Water Treatment. Security. ...,ajah,0,0,0,1,ajah3,900000.0,1000000.0,1000000.0,1,24,4,900000
189, ... badore ajah lagos,6,3,3,3,A Specious 2 Bedroom apartment all rooms ensuit with constant light and clean water supply located in an serene environment at first unity estate badore close to the road. ... Cheap. Dry. New. Drainage System. Security Doors. Pop Ceiling. Street Lights. Big Compound. All Room Ensuit. Supermarket Nearby. Parking Space. Fast Internet. 24 Hours Electricity. 24 Hours Security. Water Treatment. Free Wifi. Security. ...,ajah,0,0,0,1,ajah3,900000.0,1000000.0,1000000.0,1,24,4,900000
190, badore ajah lagos,5,3,2,3,Spacious 2-Bedroom Flat For Rent @ Ajah - Badore Rent: *NGN 700k / Annum* Agency: 10% Legal: 10% ... Big Compound. All Room Ensuit. ...,ajah,0,0,0,1,ajah3,900000.0,1000000.0,1000000.0,1,24,4,900000
191, thomas estate thomas estate ajah lagos,7,4,3,4,Newly built luxurious 3bedroom detached bungalow at thomas estate ajah Rent #2m Caution #150k Agency 10% Legal 5% ... Dry. New. Drainage System. Water Treatment. Security Doors. Security. Pop Ceiling. Street Lights. Big Compound. All Room Ensuit. Parking Space. 24 Hours Security. ...,ajah,1,1,1,1,ajah4,1200000.0,1500000.0,1300000.0,4,29,5,2000000
192, sangotedo ajah lagos,5,3,2,3,"2bedroom service apartment for rent in a secured estate Rent- up 1.2m down 1m S/c-600k Caution-100k Agent/legal 10%each Location-sangotedo A call to us will end your search immediately FOR FURTHER ENQUIRES, SPECIFIC REQUEST AND ARRANGEMENTS FOR PHYSICAL INSPECTIONS, KINDLY SEND US A ... Serviced. Dry. Drainage System. Children Play Ground. Big Compound. All Room Ensuit. Church Nearby. 24 Hours Electricity. 24 Hours Security. ...",ajah,1,1,1,1,ajah3,900000.0,1000000.0,1000000.0,4,24,4,1200000
193, ... thomas estate ajah lagos,4,2,2,2,"Clean 2 bedroom flat for rent at Ajah Rent 800k Caution 50k Legal 80k Agency 80k Total N1,010,000 Waste disposal, security salary, etc are equally contributed by the tenants in the building. 6 tenants in the compound ... All Room Ensuit. Parking Space. 24 Hours Electricity. ...",ajah,1,1,0,1,ajah2,800000.0,800000.0,800000.0,3,21,4,800000
194, badore ajah lagos,2,1,1,1,A tastefully finished specious self-contained sheared apartment all room ensuit only kitchen to be sheared by occupants. It have constant light and water supply located in first unity estate badore ajah Lagos ... Cheap. Dry. New. Drainage System. Security Doors. Pop Ceiling. Street Lights. Big Compound. Cctv Cameras. All Room Ensuit. Supermarket Nearby. Parking Space. Fast Internet. 24 Hours Electricity. 24 Hours Security. Water Treatment. Free Wifi. Security. Restaurants Nearby. ...,ajah,0,0,0,1,ajah1,400000.0,500000.0,450000.0,1,6,1,400000
195, badore ajah lagos,2,1,1,1,Newly built speciousself-contained apartment with constant light and water located at Greenville estate badore ajah ... Cheap. Dry. New. Drainage System. Security Doors. Pop Ceiling. Street Lights. Big Compound. All Room Ensuit. Supermarket Nearby. Parking Space. Fast Internet. 24 Hours Electricity. 24 Hours Security. Water Treatment. Security. ...,ajah,0,0,0,1,ajah1,400000.0,500000.0,450000.0,1,6,1,400000
196, kajola after lakwe lakowe ajah lagos,2,1,1,1,"The miniflat is located @elesekan in bogije after lakwe,for inspection pls call 0809)89633335/08168285322 ... Furnished. ...",ajah,0,0,0,1,ajah1,400000.0,500000.0,450000.0,1,6,1,400000
197, gbetu road awoyaya off lekki epe expressway ajah lagos,12,6,6,6,"?? ?? ?? ?? ?? ?? ?? ?? ?? ?? *DIRECT BRIEF* TO LET 5 bedroom American Standard duplex So Is Good For HOTEL, SERVICE APARTMENT SUCH AS NATIONAL YOUTH CORPS LODGE & ... Renovated. Children Play Ground. All Room Ensuit. Church Nearby. Big Compound. ...",ajah,1,1,0,1,ajah6,4000000.0,4000000.0,4000000.0,3,50,9,4000000
198, west wood street. badore ajah lagos,2,1,1,1,1 bedroom mini flat Shared Apartment Flat / Apartment for rent West wood street. Badore Ajah Lagos ... Renovated. ...,ajah,0,0,0,1,ajah1,400000.0,500000.0,450000.0,1,6,1,400000
199, badore ajah lagos,3,2,1,2,Newly Built Miniflat with POP finishing ... New. Children Play Ground. Security. Restaurants Nearby. Security Doors. Pop Ceiling. Printing Service. ...,ajah,1,1,0,1,ajah2,800000.0,800000.0,800000.0,3,21,4,800000
200, ado ajah lagos,5,3,2,3,Newly Built 2bedroom flat with POP finishing ... Serviced. New. Supermarket Nearby. Security. Restaurants Nearby. Security Doors. Big Compound. All Room Ensuit. ...,ajah,0,0,0,1,ajah3,900000.0,1000000.0,1000000.0,1,24,4,900000
201, mobil road ilaje ajah lagos,9,5,4,5,For inspection pls call [redacted]/[redacted] ... Cheap. Renovated. Parking Space. Security Doors. All Room Ensuit. 24 Hours Security. Fast Internet. Pop Ceiling. Big Compound. ...,ajah,1,1,0,1,ajah5,3000000.0,3000000.0,3000000.0,3,43,8,3000000
202," harmony estate, ajah badagry badagry lagos",4,2,2,2,"2 bedroom Shared Apartment Flat / Apartment for rent Harmony Estate, Ajah Badagry Badagry Lagos ... Renovated. New. Supermarket Nearby. Big Compound. ...",ajah,1,1,0,1,ajah2,800000.0,800000.0,800000.0,3,21,4,800000
203, victory park thomas estate ajah lagos,11,6,5,6,5 bedroom Detached Duplex House for rent Victory park Thomas estate Ajah Lagos ... New. Parking Space. Water Treatment. Pop Ceiling. ...,ajah,1,1,0,1,ajah6,4000000.0,4000000.0,4000000.0,3,50,9,4000000
204, by lagos business school olokonla ajah lagos,3,2,1,2,Specious and beautiful 1bedroom mini flats apartment Features: 2 toilet Bathroom Kitchen Specious living room 2 balconies 1bedroom Rent 600k per year Serviced charge 4K per monthly payment Light: Self prepaid meter Water:500 Naira per monthly ... New. ...,ajah,1,1,0,1,ajah2,800000.0,800000.0,800000.0,3,21,4,800000
205, alaguntan ilaje ajah lagos,11,6,5,6,For inspection pls call 08089633335/08168285322 ... New. Jacuzzi. Water Treatment. All Room Ensuit. Fast Internet. Pop Ceiling. Boys Quater. Big Compound. ...,ajah,1,1,0,1,ajah6,4000000.0,4000000.0,4000000.0,3,50,9,4000000
206, safecourt estate badore ajah lagos,7,4,3,4,TO LET A 3BD WITH BQ AT SAFECOURT ESTATE IKATE LEKKI NEXT TO SPAR.... FEATURES INCLUDE ALL ROOMS ENSUITE FITTED KITCHEN GUEST TOILET BALCONY LARGE LIVING AREA SPACE LARGE KITCHEN & BEDROOMS SWIMMING POOL GYM FACILITY MANAGEMENT OFFICE AMPLE PARKING SPACE WATER TREATMENT PLANT 24/7 SECURITY 24/7 POWER DEDICATED ELEVATOR ESTATE ... Serviced. Children Play Ground. Parking Space. Elevator. Swimming Pool. Supermarket Nearby. Security. Security Doors. All Room Ensuit. 24 Hours Security. Pop Ceiling. Big Compound. Drainage System. ...,ajah,1,1,1,1,ajah4,1200000.0,1500000.0,1300000.0,4,29,5,3000000
207, lekki scheme 2 ogombo ajah lagos,9,5,4,5,"4 Nos. Of 4 Bedroom semi detached house With A Room Servant Quarters Road 12, Lekki Scheme 2 Ogombo Ajah Lagos? 2,000,000 / year ... Parking Space. Water Treatment. Security. Security Doors. All Room Ensuit. 24 Hours Security. Pop Ceiling. Boys Quater. Big Compound. ...",ajah,1,1,0,1,ajah5,3000000.0,3000000.0,3000000.0,3,43,8,3000000
208, badore ajah lagos,9,5,4,5,It is a terrace duplex ... Dry. New. Parking Space. Church Nearby. Supermarket Nearby. Security. Pop Ceiling. Restaurants Nearby. Big Compound. Drainage System. ...,ajah,1,1,0,1,ajah5,3000000.0,3000000.0,3000000.0,3,43,8,3000000
209, .. thomas estate ajah lagos,5,3,2,3,2 bedroom Blocks of Flats House for rent Thomas estate Ajah Lagos ... New. ...,ajah,1,1,0,1,ajah3,900000.0,1000000.0,1000000.0,3,24,4,1000000
210, peninsula garden estate sangotedo ajah lagos,9,5,4,5,It has modern equipment and serviced ... Serviced. Furnished. New. All Room Ensuit. 24 Hours Security. Boys Quater. Big Compound. 24 Hours Electricity. ...,ajah,1,1,0,1,ajah5,3000000.0,3000000.0,3000000.0,3,43,8,3000000
211, lagos business school olokonla ajah lagos,5,3,2,3,"Serviced 24/7 power supply Newly built luxurious 2bedroom flats Rent :1.2million Serviced charge with generator and PHCN light 30,000 monthly ... Serviced. New. Water Treatment. ...",ajah,1,1,1,1,ajah3,900000.0,1000000.0,1000000.0,4,24,4,1200000
212, golden pearls estate sangotedo ajah lagos,11,6,5,6,It has modern equipment and serviced ... Serviced. Renovated. Furnished. All Room Ensuit. 24 Hours Security. Boys Quater. Big Compound. 24 Hours Electricity. ...,ajah,1,1,0,1,ajah6,4000000.0,4000000.0,4000000.0,3,50,9,4000000
213, mobil estate ilaje ajah lagos,9,5,4,5,"This is is a tastefully built 5 bedroom fully detached duplex within an very secure and well planned estate in Ajah, Lekki. The rooms are spacious, neatly tiled, well ventilated and properly fitted with modern ... Renovated. Cheap. Serviced. Parking Space. 24 Hours Security. Pop Ceiling. 24 Hours Electricity. Street Lights. Children Play Ground. Swimming Pool. Drainage System. Big Compound. Water Treatment. Security. ...",ajah,1,1,0,1,ajah5,3000000.0,3000000.0,3000000.0,3,43,8,3000000
214, alhaji folami street off mobil road illaje ajah ilaje ajah lagos,7,4,3,4,"Clean 3 bedroom flat upstairs with own staircase, all rooms ensuite, spacious kitchen, spacious rooms POP ceiling, water heater bathroom balcony in sitting room inside an interlocked compound. Self serviced ... Renovated. Big Compound. All Room Ensuit. Pop Ceiling. 24 Hours Security. ...",ajah,0,0,0,1,ajah4,1200000.0,1500000.0,1300000.0,1,29,5,1200000
215," unity avenue estate, pump and sell addo road ajah ado ajah lagos",6,3,3,3,"Brand new 3 bedroom bungalow only 2 rooms ensuite, spacious kitchen with small store, spacious sitting room inside an interlocked compound that can park 8 cars with space for relaxation. Prepaid meter ... New. Cheap. 24 Hours Security. ...",ajah,1,1,1,1,ajah3,900000.0,1000000.0,1000000.0,4,24,4,1200000
216, off mobil road illaje ajah ilaje ajah lagos,5,3,2,3,"Clean 2 bedroom flat upstairs with own staircase all rooms ensuite, spacious sitting room and balcony, standard kitchen entrance in front and another exit behind through the kitchen not far from interlocked road inside interlocked ... Renovated. Water Treatment. Big Compound. All Room Ensuit. Pop Ceiling. 24 Hours Security. ...",ajah,1,1,0,1,ajah3,900000.0,1000000.0,1000000.0,3,24,4,1000000
217, orile maroko estate opposite emerald estate mobil road illaje ajah ilaje ajah lagos,8,3,5,3,"Brand new Tastefully finished 2 bedroom flat with gas cooker, heat extractor, fitted kitchen, spacious sitting room, spacious rooms, POP ceiling, water heater bath, shower cubicle, italian marble floor etc inside an interlocked compound with ... New. Water Treatment. Security Doors. Big Compound. All Room Ensuit. Pop Ceiling. 24 Hours Security. ...",ajah,1,1,0,1,ajah3,900000.0,1000000.0,1000000.0,3,24,4,1000000
218, ado ajah lagos,5,3,2,3,Newly built 2bedroom flat in Ado and Environs ... New. Security. Children Play Ground. All Room Ensuit. Restaurants Nearby. Big Compound. Security Doors. Pop Ceiling. ...,ajah,0,0,0,1,ajah3,900000.0,1000000.0,1000000.0,1,24,4,900000
219, ado ajah lagos,5,3,2,3,Newly built 2bedroom in Ado and Environs ... New. Serviced. Security. Supermarket Nearby. Printing Service. All Room Ensuit. Restaurants Nearby. Security Doors. ...,ajah,0,0,0,1,ajah3,900000.0,1000000.0,1000000.0,1,24,4,900000
220, off mobile road ajiwe ajah lagos,4,2,2,2,"Fully serviced 2 Bedroom flat to let, off Mobil road, Ajah, Lagos. N1m/annum Service Charge: N500K/Annum ... New. Serviced. 24 Hours Security. All Room Ensuit. Big Compound. Parking Space. Pop Ceiling. 24 Hours Electricity. ...",ajah,1,1,1,1,ajah2,800000.0,800000.0,800000.0,4,21,4,1000000
221, badore ajah lagos,9,4,5,4,"Clean 3bedroom apartment Rent: 950k SC: 170k Legal:10% Agreement:10% Caution deposit:10% SC: covers; Security, water treatment 20k monthly, pumping machine recharge, dirty, evacuation of septic tank and general Maintenance. ... Cheap. Dry. Big Compound. Pop Ceiling. Supermarket Nearby. 24 Hours Security. All Room Ensuit. Water Treatment. ...",ajah,0,0,0,1,ajah4,1200000.0,1500000.0,1300000.0,1,29,5,1200000
222, thomas estate ajah lagos,9,5,4,5,Well finished 4bedroom semi detached duplex with a Bq located in a gated estate at Thomas estate ajah with a good road and clean water ... Renovated. Big Compound. Children Play Ground. Pop Ceiling. Street Lights. Supermarket Nearby. 24 Hours Security. Security Doors. Drainage System. Boys Quater. All Room Ensuit. Security. Water Treatment. ...,ajah,1,1,0,1,ajah5,3000000.0,3000000.0,3000000.0,3,43,8,3000000
223, thomas estate ajah lagos,9,5,4,5,4 bedroom Detached Duplex House for rent Thomas estate Ajah Lagos ... New. Cheap. Dry. Street Lights. Drainage System. Boys Quater. Security. Water Treatment. Restaurants Nearby. Big Compound. Parking Space. Pop Ceiling. Supermarket Nearby. 24 Hours Security. Security Doors. All Room Ensuit. Cctv Cameras. Jacuzzi. ...,ajah,1,1,0,1,ajah5,3000000.0,3000000.0,3000000.0,3,43,8,3000000
224, harmony estate lanbasa ado ajah lagos,8,4,4,4,Newly Built 3bedroom apartment Rent: 1.2m Caution deposit: 100k Professional fee: 120k Legal fee: 120k Contact Cruzi Global for more detailed information. Thank you ... New. Cheap. Big Compound. Parking Space. Pop Ceiling. 24 Hours Security. All Room Ensuit. Water Treatment. ...,ajah,0,0,0,1,ajah4,1200000.0,1500000.0,1300000.0,1,29,5,1200000
225, badore ajah lagos,9,5,4,5,Very Decent 2bedroom apartment Location: Badore Ajah Rent: 700k SC: 100k Brokers fee: 70k Legal fee: 70k Caution deposit: 70k (refundable ??) ... Cheap. Pop Ceiling. 24 Hours Security. All Room Ensuit. Security. Water Treatment. ...,ajah,1,1,0,1,ajah5,3000000.0,3000000.0,3000000.0,3,43,8,3000000
226, awoyaya awoyaya ajah lagos,9,5,4,5,Well finished brand new 4bedroom semi detached duplex available for rent in a well secure estate located at Awoyaya sangotedo ... New. Serviced. Big Compound. Parking Space. Pop Ceiling. Street Lights. Supermarket Nearby. 24 Hours Security. Security Doors. Drainage System. All Room Ensuit. Security. Water Treatment. Jacuzzi. ...,ajah,1,1,0,1,ajah5,3000000.0,3000000.0,3000000.0,3,43,8,3000000
227, abraham adesanya estate ajah lagos,2,1,1,1,1 bedroom mini flat Shared Apartment Flat / Apartment for rent Abraham adesanya estate Ajah Lagos ... ...,ajah,0,0,0,1,ajah1,400000.0,500000.0,450000.0,1,6,1,400000
228," langbasa, addo road. ajah. ado ajah lagos",6,3,3,3,"Newly Built 2bedroom on Langbasa, Addo Road. Ajah. Nice and conducive environment with accessible road. comes with Service charge.. ... Furnished. Dry. New. Cheap. 24 Hours Security. Restaurants Nearby. Big Compound. Parking Space. Drainage System. Security. Supermarket Nearby. All Room Ensuit. Church Nearby. Mosques Nearby. Water Treatment. Security Doors. Pop Ceiling. ...",ajah,0,0,0,1,ajah3,900000.0,1000000.0,1000000.0,1,24,4,900000
229," greenville estate badore, ajah badore ajah lagos",6,3,3,3,"Brand New 2bedroom at Greenville Estate Badore, Ajah. modern facilities, water system, security, pop.. comes with service charge. ... Dry. New. Cheap. Fast Internet. 24 Hours Security. Parking Space. Drainage System. Security. Supermarket Nearby. Street Lights. All Room Ensuit. Church Nearby. Mosques Nearby. Water Treatment. Security Doors. Pop Ceiling. ...",ajah,0,0,0,1,ajah3,900000.0,1000000.0,1000000.0,1,24,4,900000
230, ajah lagos,12,6,6,6,"AN Executive Furnished 6 Bedroom Semi- Detached House , All Rooms Ensuite, + 3 Bedroom, Duplex All Ensuite. Making 9 Rooms All Together. With Modern Swimming Pool And ... ...",ajah,1,1,0,1,ajah6,4000000.0,4000000.0,4000000.0,3,50,9,4000000
231, ajah lagos,6,3,3,3,A decent 3 bedroom flat for rent in Ajah Service charge: #200k Caution fee #200k Agency and legal fee ... ...,ajah,1,1,0,1,ajah3,900000.0,1000000.0,1000000.0,3,24,4,1000000
232, ajah lagos,10,5,5,5,Exotic 5 Bedroom duplex with bq. All Room Ensuite. Title global C of I Price : 52m LocationAjah Lagos ... ...,ajah,1,1,1,1,ajah5,3000000.0,3000000.0,3000000.0,4,43,8,5000000
233, ado ajah lagos,5,3,2,3,A beautiful 2 Bedroom Serviced Flat with Pop Finiahing in a secured and serene Estate. All Service Charge inclusive for a year. ... Serviced. Furnished. New. Pop Ceiling. All Room Ensuit. Front Desk Service. Big Compound. Supermarket Nearby. Drainage System. Church Nearby. Printing Service. Children Play Ground. 24 Hours Security. Restaurants Nearby. ...,ajah,0,0,0,1,ajah3,900000.0,1000000.0,1000000.0,1,24,4,950000
234, mobil road immediately after emerald estate ilaje ajah lagos,7,4,3,4,"very clean 3bedroom flat with a Mini Flat attached to the main flat,,all room en suit with a Guest toilet,,All tiles,,Large compound with Decorate Flowers,,A Bar Place for Relaxation,, Security House,,Generator house,,Car Pot,,Interlocked Compound,, Very ... Renovated. Pop Ceiling. All Room Ensuit. Big Compound. Boys Quater. Parking Space. Security. Street Lights. Security Doors. ...",ajah,0,0,0,1,ajah4,1200000.0,1500000.0,1300000.0,1,29,5,1200000
235, value county estate near lagos business school off lekki epe expressway ajah lagos,8,4,4,4,A newly built 3 bedrooms flat is up for rent at a beautiful estate in Ajah. The said apartment is in Value County Estate just after the Lagos business School. The said apartment comes with ... Big Compound. All Room Ensuit. 24 Hours Security. 24 Hours Electricity. ...,ajah,1,0,0,1,ajah4,1200000.0,1500000.0,1300000.0,2,29,5,1300000
236, after lbs in olokonla in ajah axis lekki. olokonla ajah lagos,7,4,3,4,"A Newly Built Superbly Spacious 3 Bedrooms Flat in a very cool, well gated, safely guarded and highly secured Estate with clean water, good light, good roads, easy access to the roads and good road ... Cheap. New. Supermarket Nearby. Parking Space. All Room Ensuit. Fast Internet. Street Lights. Water Treatment. Big Compound. Restaurants Nearby. Pop Ceiling. Drainage System. Security Doors. Security. 24 Hours Security. ...",ajah,0,0,0,1,ajah4,1200000.0,1500000.0,1300000.0,1,29,5,1200000
237, opp ikota villa before ajah in lekki. lekki phase 2 lekki lagos,4,2,2,2,"A Brand New Mini Flat in a very serene, well gated, guarded and secured area with easy access to the express road, close to the express road, clean water, good light and good roads opposite ... Cheap. New. Supermarket Nearby. Parking Space. All Room Ensuit. Fast Internet. Street Lights. Water Treatment. Big Compound. Restaurants Nearby. Pop Ceiling. Drainage System. Security Doors. Security. 24 Hours Security. ...",ajah,1,1,0,1,ajah2,800000.0,800000.0,800000.0,3,21,4,850000
238, ado ajah lagos,7,4,3,4,Newly Built Exquisite 3 bedroom Flat with POP finishing ... Serviced. New. Supermarket Nearby. Big Compound. Church Nearby. Restaurants Nearby. Pop Ceiling. Children Play Ground. Drainage System. Security Doors. Printing Service. Security. ...,ajah,0,0,0,1,ajah4,1200000.0,1500000.0,1300000.0,1,29,5,1200000
239, ado ajah lagos,7,4,3,4,All Ensuite 3bedroom Flat in a serene and secure Estate ... Renovated. Serviced. Supermarket Nearby. Big Compound. Church Nearby. Pop Ceiling. Child Care. ...,ajah,0,0,0,1,ajah4,1200000.0,1500000.0,1300000.0,1,29,5,1200000
240, peace estate badore ajah lagos,3,2,1,2,Newly built One Bedroom miniflats in peace estate. ... ...,ajah,1,1,0,1,ajah2,800000.0,800000.0,800000.0,3,21,4,800000
241, ajah lagos,2,1,1,1,A decent mini flat available for rent in Ajah The house is located in a clean and secured environment. Its also very close to the main road. ... ...,ajah,0,0,0,1,ajah1,400000.0,500000.0,450000.0,1,6,1,400000
242, ado ajah lagos,4,2,2,2,A tastefully finished 2 bedroom flat. Location:Addo Rent: #900k Service charge #150k Caution fee #150k Agency and legal fee#10% each ... ...,ajah,1,1,1,1,ajah2,800000.0,800000.0,800000.0,4,21,4,900000
243, remlek estate badore ajah badore ajah lagos,4,2,2,2,"Clean 2 bedroom flat upstairs with all rooms ensuite, spacious kitchen and sitting room inside an interlocked compound. The apartment will be renovated before u move in after payment. Rent 700k Agreement 70k Agency 70k ... Renovated. All Room Ensuit. Big Compound. Pop Ceiling. Security Doors. Water Treatment. ...",ajah,1,1,0,1,ajah2,800000.0,800000.0,800000.0,3,21,4,800000
244, badore ajah lagos,3,2,1,2,Newly built miniature with POP finishing in a secure estate ... New. Security. Pop Ceiling. Security Doors. Supermarket Nearby. Church Nearby. ...,ajah,1,1,0,1,ajah2,800000.0,800000.0,800000.0,3,21,4,800000
245, badore ajah lagos,3,2,1,2,Newly Built Miniflat ... New. Serviced. Security. Pop Ceiling. Restaurants Nearby. Security Doors. Supermarket Nearby. ...,ajah,1,1,0,1,ajah2,800000.0,800000.0,800000.0,3,21,4,800000
246, badore ajah lagos,3,2,1,2,Newly renovated Miniflat ... Renovated. Security. Restaurants Nearby. Big Compound. Security Doors. Supermarket Nearby. ...,ajah,1,1,0,1,ajah2,800000.0,800000.0,800000.0,3,21,4,800000
247," iyabus plaza pump and sell area, ado ajah lagos",6,3,3,3,"TO LET A Neatly Used 2 Bedroom Up Stairs apartment with a personal meter, Interlocking neat and clean compound and all rooms ensuite LOCATION: IYABUS PLAZA - very close to Blenco Super Market along Ado road, Ajah ... ...",ajah,0,0,0,1,ajah3,900000.0,1000000.0,1000000.0,1,24,4,900000
248, ado ajah lagos,4,2,2,2,Newly built 2bedroom built in Ado and Environs ... New. Security. All Room Ensuit. Drainage System. Restaurants Nearby. Security Doors. Supermarket Nearby. Church Nearby. ...,ajah,1,1,0,1,ajah2,800000.0,800000.0,800000.0,3,21,4,800000
249, badore ajah lagos,4,2,2,2,Newly built 2bedroom flat at badore ... New. Big Compound. Supermarket Nearby. Restaurants Nearby. Drainage System. ...,ajah,1,1,0,1,ajah2,800000.0,800000.0,800000.0,3,21,4,800000
250, badore ajah lagos,2,1,1,1,"Spacious roomselfcontain contained in a fence and gated compound. Shares meter in the compound, pave compound ... ...",ajah,0,0,0,1,ajah1,400000.0,500000.0,450000.0,1,6,1,400000
251, thomas estates thomas estate ajah lagos,3,2,1,2,A room and parlour self contain in Thomas Estate with visitors toilet for 450k A/A 10/10per ... Renovated. Furnished. Dry. Water Treatment. Big Compound. Child Care. Supermarket Nearby. Swimming Pool. Security Doors. Drainage System. Restaurants Nearby. Pop Ceiling. 24 Hours Security. Church Nearby. Street Lights. Security. Parking Space. ...,ajah,1,1,0,1,ajah2,800000.0,800000.0,800000.0,3,21,4,800000
252, orile maroko estate opp emerald estate mobil road illaje ajah ilaje ajah lagos,6,3,3,3,"Clean 3 bedroom Terrace duplex with spacious sitting room and kitchen, spacious masters bedroom and madam room, POP ceiling. Prepaid meter. Clean water running ... Renovated. Water Treatment. All Room Ensuit. Pop Ceiling. 24 Hours Security. Security Doors. ...",ajah,0,0,0,1,ajah3,900000.0,1000000.0,1000000.0,1,24,4,900000
253, ajiwe ajah lagos,4,2,2,2,Exquisite Renovated 2 bedroom flat with POP finishing ... Serviced. Renovated. All Room Ensuit. Big Compound. Children Play Ground. Supermarket Nearby. Church Nearby. ...,ajah,1,1,1,1,ajah2,800000.0,800000.0,800000.0,4,21,4,1300000
254, badore ajah lagos,6,3,3,3,Newly renovated 3bedroom apartment ... Renovated. Big Compound. Restaurants Nearby. Security Doors. Church Nearby. Supermarket Nearby. Security. ...,ajah,0,0,0,1,ajah3,900000.0,1000000.0,1000000.0,1,24,4,900000
255, around blenco supermarket before sangotedo. peninsula estate ajah lagos,7,4,3,4,"A Superbly Built New 3 Bedrooms Terrace Duplex in a highly guarded, seriously secured, well gated and very cool Estate with clean water, good lighting, very close to the express road, easy access roads, good ... Serviced. Cheap. New. Drainage System. Parking Space. Fast Internet. 24 Hours Security. Boys Quater. Security. Security Doors. Big Compound. Restaurants Nearby. Supermarket Nearby. All Room Ensuit. 24 Hours Electricity. Water Treatment. Pop Ceiling. Street Lights. ...",ajah,1,1,1,1,ajah4,1200000.0,1500000.0,1300000.0,4,29,5,2000000
256, around blenco supermarket before sangotedo in ajah axis lekki. peninsula estate ajah lagos,3,2,1,2,"A Beautifully Finished Mini Flat in a very serene, highly secured, seriously guarded, well gated, well maintained and serviced Estate with clean water, good light, good roads, easy access to the express road, very close ... Serviced. Cheap. New. Drainage System. Parking Space. Fast Internet. 24 Hours Security. Security. Security Doors. Big Compound. Restaurants Nearby. Supermarket Nearby. All Room Ensuit. 24 Hours Electricity. Water Treatment. Pop Ceiling. Street Lights. ...",ajah,1,1,0,1,ajah2,800000.0,800000.0,800000.0,3,21,4,800000
257, after blenco supermarket before sangotedo market in ajah axis lekki. sangotedo ajah lagos,7,4,3,4,"A Very Fine 3 Bedrooms Flat in a gated, guarded and secured Estate that's very close to the express road, easy access roads, clean water, good light and good roads after Blenco Supermarket before Sangotedo ... Cheap. New. Drainage System. Parking Space. Fast Internet. 24 Hours Security. Security. Security Doors. Big Compound. Restaurants Nearby. Supermarket Nearby. All Room Ensuit. Water Treatment. Pop Ceiling. Street Lights. ...",ajah,0,0,0,1,ajah4,1200000.0,1500000.0,1300000.0,1,29,5,1200000
258, fidiso estate in kingdom hall road in abijo in ajah axis lekki. abijo ajah lagos,2,1,1,1,"A Well Kept Room Self-contained in a gated and secured area with clean water, good light and easy access roads in Abijo in Ajah axis Lekki For Rent. ... Renovated. Cheap. Drainage System. Big Compound. Parking Space. Restaurants Nearby. Supermarket Nearby. All Room Ensuit. Fast Internet. 24 Hours Security. Water Treatment. Street Lights. Security. Security Doors. ...",ajah,0,0,0,1,ajah1,400000.0,500000.0,450000.0,1,6,1,400000
259, after blenco supermarket before sangotedo market in ajah axis lekki. sangotedo ajah lagos,9,5,4,5,"A Brand New 4 Bedrooms Duplex with a Mini Flat BQ in a very serene, well secured, gated and guarded Estate with easy access to the express road, clean water, easy access roads and good ... Cheap. New. Drainage System. Parking Space. Fast Internet. 24 Hours Security. Boys Quater. Security. Security Doors. Big Compound. Restaurants Nearby. Supermarket Nearby. All Room Ensuit. Water Treatment. Pop Ceiling. Street Lights. ...",ajah,1,1,0,1,ajah5,3000000.0,3000000.0,3000000.0,3,43,8,3000000
260, majek sangotedo in ajah axis lekki. sangotedo ajah lagos,3,2,1,2,"A Very Nice New Mini Flat in a safe, guarded and secured area with clean water, good light and easy to access in Majek in Sangotedo in Ajah axis Lekki For Rent. ... Cheap. New. Drainage System. Parking Space. Fast Internet. 24 Hours Security. Security. Security Doors. Big Compound. Restaurants Nearby. Supermarket Nearby. All Room Ensuit. Water Treatment. Pop Ceiling. Street Lights. ...",ajah,1,1,0,1,ajah2,800000.0,800000.0,800000.0,3,21,4,800000
261, opp sangotedo market in ajah axis lekki. sangotedo ajah lagos,5,3,2,3,"A Very Sweet New 2 Bedrooms Flat in a well gated, guarded and secured Estate with clean water, good light and easy access to the express road Opposite Sangotedo Market in Ajah axis Lekki For ... Cheap. New. Drainage System. Big Compound. Parking Space. Supermarket Nearby. All Room Ensuit. Fast Internet. 24 Hours Security. Water Treatment. Pop Ceiling. Street Lights. Security. Security Doors. ...",ajah,0,0,0,1,ajah3,900000.0,1000000.0,1000000.0,1,24,4,900000
262, opp sangotedo market in ajah axis lekki. sangotedo ajah lagos,7,4,3,4,"A Newly Finished 3 Bedrooms Flat in cool, guarded, secure and gated Estate with easy access roads, close to the express road, clean water and good light opposite Sangotedo Market in Sangotedo in Ajah axis ... Cheap. New. Drainage System. Parking Space. Fast Internet. 24 Hours Security. Security. Security Doors. Big Compound. Restaurants Nearby. Supermarket Nearby. All Room Ensuit. Water Treatment. Pop Ceiling. Street Lights. ...",ajah,0,0,0,1,ajah4,1200000.0,1500000.0,1300000.0,1,29,5,1200000
263, abijo ajah lagos,2,1,1,1,1 bedroom mini flat Mini flat Flat / Apartment for rent Abijo Ajah Lagos ... New. ...,ajah,1,0,0,1,ajah1,400000.0,500000.0,450000.0,2,6,1,450000
264, seaside estate badore ajah lagos,5,3,2,3,2 bedroom flat all en-suite For rent at an estate in Ajah. ... ...,ajah,0,0,0,1,ajah3,900000.0,1000000.0,1000000.0,1,24,4,900000
265, ado and environs ado ajah lagos,6,3,3,3,Newly renovated 3bedroom flat ... New. Drainage System. Big Compound. Restaurants Nearby. Supermarket Nearby. Security. Security Doors. Children Play Ground. ...,ajah,0,0,0,1,ajah3,900000.0,1000000.0,1000000.0,1,24,4,900000
266, ado ajah lagos,6,3,3,3,Newly Renovated 3 Bedroom flat ... Serviced. Renovated. Big Compound. All Room Ensuit. Security. Children Play Ground. ...,ajah,0,0,0,1,ajah3,900000.0,1000000.0,1000000.0,1,24,4,900000
267, ado and environs ado ajah lagos,6,3,3,3,"Newly built 3 bedroom flat in a good estate with 2 toilets and baths, big kitchen and paved compound. ... New. Church Nearby. Security Doors. Parking Space. Mosques Nearby. Printing Service. All Room Ensuit. 24 Hours Security. Supermarket Nearby. Security. Big Compound. Child Care. Restaurants Nearby. Fast Internet. ...",ajah,0,0,0,1,ajah3,900000.0,1000000.0,1000000.0,1,24,4,900000
268, abraham adesanya estate ajah lagos,10,5,5,5,Newly built 4bedroom duplex @kekki scheme 2...2m rent ... Dry. New. Restaurants Nearby. Water Treatment. Pop Ceiling. Street Lights. Security. Security Doors. ...,ajah,1,1,0,1,ajah5,3000000.0,3000000.0,3000000.0,3,43,8,3000000
269, majek sangotedo ajah lagos,2,1,1,1,"A room self contained apartment. Rent 120k Agency 30k Agreement 30k Inspection fee 2k For more Enquiries, Call/WhatsApp [redacted]. ... Renovated. Furnished. Children Play Ground. Drainage System. All Room Ensuit. Big Compound. ...",ajah,0,0,0,1,ajah1,400000.0,500000.0,450000.0,1,6,1,400000
270, thomas estate ajah lagos,5,2,3,2,Newly built room and parlor in Thomas estate 600k rent ... New. Swampy. Pop Ceiling. Supermarket Nearby. Security Doors. Water Treatment. Street Lights. ...,ajah,1,1,0,1,ajah2,800000.0,800000.0,800000.0,3,21,4,800000
271, abraham adesanya estate ajah lagos,2,1,1,1,Spacious self contained in Graceland estate 450k rent ... Security. Supermarket Nearby. Security Doors. Water Treatment. Street Lights. ...,ajah,1,1,1,1,ajah1,400000.0,500000.0,450000.0,4,6,1,1000000
272, abraham adesanya estate ajah lagos,4,2,2,2,Spacious room and parlor in lekki scheme 2. 450k rent ... Security. Supermarket Nearby. Security Doors. Water Treatment. Street Lights. Restaurants Nearby. ...,ajah,1,1,0,1,ajah2,800000.0,800000.0,800000.0,3,21,4,800000
273, thomas estate ajah lagos,4,2,2,2,Neatly built 2bedroom flat in Thomas estate 600k rent ... Supermarket Nearby. Security Doors. Water Treatment. Street Lights. ...,ajah,1,1,0,1,ajah2,800000.0,800000.0,800000.0,3,21,4,800000
274, thomas estate ajah lagos,3,2,1,2,Neatly room and parlor in Thomas estate rent 650k ... Dry. Security. Church Nearby. Drainage System. Supermarket Nearby. Security Doors. Water Treatment. Street Lights. ...,ajah,1,1,0,1,ajah2,800000.0,800000.0,800000.0,3,21,4,800000
275, badore ajah lagos,5,3,2,3,Clean new 2bedroom apartment available Tolet. situated in a clean and siren environment with security. Agent fee - 10% Agreement fee - 5% ... ...,ajah,0,0,0,1,ajah3,900000.0,1000000.0,1000000.0,1,24,4,900000
276, mobil road illaje ajah lagos state ilaje ajah lagos,9,5,4,5,"Brand new 4 bedroom fully detached duplex with a room bq all rooms ensuite with modern fitted kitchen, modern Lightening fixtures, shower cubicle, water heater bathroom, italian tiles, security doors POP ceiling etc. ... New. Water Treatment. 24 Hours Security. All Room Ensuit. Security Doors. Pop Ceiling. ...",ajah,1,1,1,1,ajah5,3000000.0,3000000.0,3000000.0,4,43,8,5000000
277, good news estate sangotedo ajah lagos,10,5,5,5,DESTRESS! DESTRESS!! DESTRESS!!! SALE.. Awoof hot coke distress sale of newly built luxury 4bedroom duplex with 2 large rooms 1 family room upstair guest toilet large compound fitted kitchen estate security all ensuite master bedroom king-size.The ... Dry. New. Big Compound. Parking Space. All Room Ensuit. Boys Quater. Pop Ceiling. C Of O. ...,ajah,1,1,1,1,ajah5,3000000.0,3000000.0,3000000.0,4,43,8,5000000
278, lekki garden estate phase 4 lekki gardens estate ajah lagos,9,5,4,5,Four bedroom duplex for rent located inside a well organised estate with 22 hours light guratee each day and 24/7 with a central water system. Along side a second to Non security. ... Furnished. Dry. Renovated. Serviced. 24 Hours Security. 24 Hours Electricity. C Of O. All Room Ensuit. ...,ajah,1,1,0,1,ajah5,3000000.0,3000000.0,3000000.0,3,43,8,3000000
279, ajiwe ajah lagos,9,5,4,5,"Fully serviced estate Other charges include: Agency- 10% Legal-5% Caution-N100,000 Service charge- N420,000 per year Total- N3,050,000 ... New. Serviced. Swimming Pool. Gym. 24 Hours Security. Governor's Consent. All Room Ensuit. Supermarket Nearby. Cctv Cameras. Big Compound. 24 Hours Electricity. ...",ajah,1,1,0,1,ajah5,3000000.0,3000000.0,3000000.0,3,43,8,3000000
280, behind the new shoprite in sangotedo in ajah axis lekki. sangotedo ajah lagos,10,5,5,5,"A Brand New Luxury and Superbly Finished 4 Bedrooms Duplex in a very beautiful, serene, cool, well gated, seriously guarded and highly secured Estate with clean water, good light, street lights, good roads, easy access ... Serviced. New. Cheap. Boys Quater. Cctv Cameras. Big Compound. Free Wifi. Restaurants Nearby. Security Doors. Front Desk Service. 24 Hours Security. Drainage System. Street Lights. Jacuzzi. Security. All Room Ensuit. Supermarket Nearby. Fast Internet. Gym. Parking Space. 24 Hours Electricity. Swimming Pool. Pop Ceiling. Children Play Ground. Child Care. Water Treatment. ...",ajah,1,1,0,1,ajah5,3000000.0,3000000.0,3000000.0,3,43,8,3000000
281, pump and sell bustop addo road ajah ado ajah lagos,5,3,2,3,"Renovated 2 bedroom flat all rooms ensuite, spacious sitting room with visitors toilet, spacious masters bedroom inside interlocked compound. Prepaid meter not far from Addo road Ajah ... Renovated. All Room Ensuit. Big Compound. Security Doors. Pop Ceiling. Water Treatment. ...",ajah,0,0,0,1,ajah3,900000.0,1000000.0,1000000.0,1,24,4,900000
282, lekki palm city estate off lekki epe expressway ajah lagos,7,4,3,4,"The apartment is a newly built 3 bedroom flat located in a gated, serene and secured estate. It is exquisitely painted both internally and externally. Floor is finished with vitrified tiles and ceiling with POP. ... New. Dry. All Room Ensuit. Water Treatment. ...",ajah,1,1,1,1,ajah4,1200000.0,1500000.0,1300000.0,4,29,5,1700000
283, greenville estate badore ajah badore ajah lagos,2,1,1,1,"Brand new Miniflat with spacious kitchen, spacious room and sitting room. Security doors POP ceiling ... New. Security Doors. Pop Ceiling. 24 Hours Security. ...",ajah,1,1,1,1,ajah1,400000.0,500000.0,450000.0,4,6,1,500000
284, badore ajah lagos,4,2,2,2,EXQUISITELY FINISHED BRAND NEW 2 BEDROOM FLAT FOR RENT *FEATURES* -Large Sitting Room. -All Rooms Ensuite -Fitted Kitchen -Visitor's Toilet. -Water Heater -Stylish Wardrobe -Shower Cubicles -POP Finished -Water Treatment Plant -Excellent Parking Space. -Stamping Floor. Interlocked Road. -24Hrs Estate Security -Great Lighting -House Security Post. -Generator House. -Serena Environment. E.T.C ... New. Furnished. All Room Ensuit. Big Compound. Parking Space. 24 Hours Electricity. Pop Ceiling. 24 Hours Security. ...,ajah,1,1,1,1,ajah2,800000.0,800000.0,800000.0,4,21,4,1000000
285, off addo road marshy hill estate ado ajah lagos,6,3,3,3,"A neat 3 bedroom flat at serene environment with interlocked rd, off Ado Rd. Marshy Hill Estate.The Flat is Spacious bedroom, kitchen with store, the living room plus the compound. Everything space is big. price:1.2m ... ...",ajah,1,1,1,1,ajah3,900000.0,1000000.0,1000000.0,4,24,4,1200000
286, bakery bustop opp rockstone estate badore road ajah badore ajah lagos,5,3,2,3,"Renovated w bedroom bungalow all rooms ensuite with spacious kitchen and store, spacious sitting room and both rooms have 2 windows for cross ventilation with just 3 people in the compound not far from Badore ... Renovated. All Room Ensuit. Big Compound. Pop Ceiling. ...",ajah,0,0,0,1,ajah3,900000.0,1000000.0,1000000.0,1,24,4,900000
287, before blenco supermarket in olokonla in ajah axis lekki. olokonla ajah lagos,10,5,5,5,"A Brand New 4 Bedrooms Duplex in a serene, well gated, seriously guarded and highly secured Environment with easy access to the road, very close to the road, good light and clean water before Blenco ... New. Cheap. Security. All Room Ensuit. Big Compound. Supermarket Nearby. Restaurants Nearby. Security Doors. Parking Space. Pop Ceiling. 24 Hours Security. Drainage System. Street Lights. Water Treatment. ...",ajah,1,1,0,1,ajah5,3000000.0,3000000.0,3000000.0,3,43,8,3000000
288, pump and sell addo road ajah ado ajah lagos,7,4,3,4,"Renovated 3 bedroom flat all rooms ensuite, spacious sitting room, spacious kitchen and spacious masters bedroom inside an interlocked compound not far from the tared road. Prepaid meter. ... Renovated. Security. All Room Ensuit. Water Treatment. ...",ajah,0,0,0,1,ajah4,1200000.0,1500000.0,1300000.0,1,29,5,1200000
289, off mobile road ajah lagos,4,2,2,2,"Fully serviced 2 Bedroom flat to let, off Mobil road, Ajah, Lagos. N1m/annum Service Charge: N500K/Annum ... New. Furnished. All Room Ensuit. Big Compound. Parking Space. 24 Hours Electricity. Pop Ceiling. 24 Hours Security. ...",ajah,1,1,1,1,ajah2,800000.0,800000.0,800000.0,4,21,4,1000000
290, marshy hill estate akins bustop addo road ajah ado ajah lagos,2,1,1,1,Portable and Nice Roomself contain inside a modern building not shared apartment with big room inside an interlocked compound not far from.the interlocked road inside the estate. ... Renovated. All Room Ensuit. Big Compound. Pop Ceiling. ...,ajah,0,0,0,1,ajah1,400000.0,500000.0,450000.0,1,6,1,400000
291, marshy hill estate ado ajah lagos,7,4,3,4,Clean and spacious three bedroom flat all rooms Ensuite ... Renovated. Security. All Room Ensuit. Big Compound. Supermarket Nearby. Restaurants Nearby. Security Doors. Parking Space. 24 Hours Electricity. Pop Ceiling. 24 Hours Security. Street Lights. Water Treatment. ...,ajah,0,0,0,1,ajah4,1200000.0,1500000.0,1300000.0,1,29,5,1200000
292," ologunfe, awoyaya ajah lagos",7,4,3,4,Newly built 3 bedroom flat in a good location of awoyaya with good access road stable light and very clean water etc ... ...,ajah,0,0,0,1,ajah4,1200000.0,1500000.0,1300000.0,1,29,5,1200000
293, mobil road ilaje ajah lagos,8,4,4,4,An executive 4bedroom terrace duplex on Mobil road ajah Rent: #1.5M/annum Legal:10% Agency: 10% Refundable caution:100k Total Package - #1.9M ... ...,ajah,1,1,1,1,ajah4,1200000.0,1500000.0,1300000.0,4,29,5,1500000
294, majek opp fara park after crown estate in sangotedo in ajah axis lekki. crown estate ajah lagos,8,4,4,4,"Freshly Built Superb 3 Bedrooms Flat in a cool, gated and secured area with clean water, good light and easy access roads in Majek opp Fara Park after Crown Estate in Sangotedo in Ajah axis ... New. Cheap. Security. All Room Ensuit. Big Compound. Supermarket Nearby. Fast Internet. Restaurants Nearby. Security Doors. Parking Space. Pop Ceiling. Drainage System. Street Lights. Water Treatment. ...",ajah,0,0,0,1,ajah4,1200000.0,1500000.0,1300000.0,1,29,5,1200000
295, ogombo ajah lagos,9,5,4,5,"A Newly built 4 terrace duplex well finished and built in a newly developed estate on Ogombo road. The property comes serviced with 24 hours security and, back-up power, clean water, green areas lovely garden, ... ...",ajah,1,1,0,1,ajah5,3000000.0,3000000.0,3000000.0,3,43,8,3000000
296, greenville estate badore ajah badore ajah lagos,5,3,2,3,"Tastefully finished e bedroom flat upstairs all rooms ensuite with spacious sitting room, spacious rooms with 2 windows each room for proper ventilation. POP ceiling with Prepaid meter inside an interlocked compound. ... New. All Room Ensuit. Big Compound. Pop Ceiling. 24 Hours Security. Water Treatment. ...",ajah,0,0,0,1,ajah3,900000.0,1000000.0,1000000.0,1,24,4,900000
297, lekki palms estate lavalon hotel estate off addo road ajah ado ajah lagos,9,5,4,5,4 bedroom stand alone detached duplex all rooms ensuite with big studio kitchen with spacious sitting room and dinning inside a mini estate facing interlocked road. ... Renovated. All Room Ensuit. Big Compound. Security Doors. Pop Ceiling. 24 Hours Security. Water Treatment. ...,ajah,1,1,0,1,ajah5,3000000.0,3000000.0,3000000.0,3,43,8,3000000
298, esfort estate opp mfm ajah off addo road ajah ado ajah lagos,9,5,4,5,"Tastefully Finished 4 bedroom Semi Detached duplex with spacious sitting room and rooms, spacious kitchen and family lounge upstairs inside an Estate with tight security, interlocked road with drainage and quiet environment not ... Cheap. Renovated. All Room Ensuit. Security Doors. Pop Ceiling. 24 Hours Security. Water Treatment. ...",ajah,1,1,0,1,ajah5,3000000.0,3000000.0,3000000.0,3,43,8,3000000
299, marshy hill estate ado ajah lagos,7,4,3,4,The property is a 3 bedroom flat located in a gated and serene estate. The ceiling is finished with POP and Floor with Vitrified tiles. ... Security. All Room Ensuit. Security Doors. Water Treatment. ...,ajah,1,0,0,1,ajah4,1200000.0,1500000.0,1300000.0,2,29,5,1300000
300, before fara park after crown estate in sangotedo in ajah axis. crown estate ajah lagos,11,6,5,6,"A Freshly Built Superb 4 Bedrooms Bungalow with BQ and Penthouse in a quiet, gated, guarded and very secure Estate with easy access roads, street lights, good roads, clean water and good light before Fara ... New. Cheap. Boys Quater. Big Compound. Restaurants Nearby. Security Doors. 24 Hours Security. Drainage System. Street Lights. Security. All Room Ensuit. Supermarket Nearby. Fast Internet. Parking Space. Pop Ceiling. Water Treatment. ...",ajah,1,1,0,1,ajah6,4000000.0,4000000.0,4000000.0,3,50,9,4000000
301," around crown estate, sangotedo, ajah axis, lekki. sangotedo ajah lagos",6,3,3,3,"A Newly Built Luxury 2 Bedrooms Flat in a very cool, serene, seriously guarded, well gated and highly secured Estate with clean water, good light, easy access to the road and close to the road ... New. Security. All Room Ensuit. Big Compound. Supermarket Nearby. Restaurants Nearby. Parking Space. Pop Ceiling. 24 Hours Security. Drainage System. Street Lights. Water Treatment. ...",ajah,1,1,0,1,ajah3,900000.0,1000000.0,1000000.0,3,24,4,1000000
302, greenville estate badore ajah badore ajah lagos,5,3,2,3,"Clean and spacious 3 bedroom flat upstairs with masters bedroom ensuite only, kitchen and store, spacious rooms with wardrobe inside an interlocked compound not far from the interlocked road inside the estate. ... Renovated. Big Compound. 24 Hours Security. ...",ajah,0,0,0,1,ajah3,900000.0,1000000.0,1000000.0,1,24,4,900000
303, within an estate sangotedo ajah lagos,7,4,3,4,"This is a family friendly apartment with wardrobes, kitchen cabinets, a store and four toilets. Rent: N1.1m Agency Fee: N110k Legal Fee: N55k Caution: N110k Service Charge: N10k a month (Refuse disposal, Estate Security, Compound Security, Cleaning of ... Serviced. New. Dry. Security. All Room Ensuit. Big Compound. Security Doors. Parking Space. Pop Ceiling. 24 Hours Security. Church Nearby. ...",ajah,0,0,0,1,ajah4,1200000.0,1500000.0,1300000.0,1,29,5,1200000
304," gated estate, addo road ado ajah lagos",5,3,2,3,"Brand new tastefully built flat in a gated estate on addo road Ajah before addo round about, it built with arct design, tastefully finished decorated POP, all rooms ensuite with quest toilet, gass cooker, fitted ... ...",ajah,1,1,0,1,ajah3,900000.0,1000000.0,1000000.0,3,24,4,1000000
305," gated estate, addo road ado ajah lagos",5,3,2,3,"Brand new tastefully built flat in a gated estate on addo road Ajah before addo round about, it built with arct design, tastefully finished decorated POP, all rooms ensuite with quest toilet, gass cooker, fitted ... ...",ajah,1,1,0,1,ajah3,900000.0,1000000.0,1000000.0,3,24,4,1000000
306, ajah ajah lagos,2,1,1,1,"A single room boys quarter is available in an estate with security,light, interlock compound clean water, personal toilet and bathroom but no kitchen. Standby generator as from 7 pm till day brake. ... ...",ajah,0,0,0,1,ajah1,400000.0,500000.0,450000.0,1,6,1,400000
307, greenville estate badore ajah lagos,4,2,2,2,"The apartment is a tastefully finished one bedroom apartment located in a gated estate and serene neighborhood. It is relatively new house, painted both internally & externally and compound is finished with interlocks. Ceiling is ... Serviced. New. Big Compound. ...",ajah,1,1,0,1,ajah2,800000.0,800000.0,800000.0,3,21,4,800000
308, ado ado ajah lagos,5,3,2,3,2 bedroom Semi Detached Bungalow House for rent Ado Ado Ajah Lagos ... ...,ajah,0,0,0,1,ajah3,900000.0,1000000.0,1000000.0,1,24,4,900000
309, ajah lagos,6,3,3,3,3 Bedroom Flat all ensuite with visitor's toilet in Ajah. 1m (rent ) Agency -10% Legal. -5% Caution - 50K Service Charge -150K ... ...,ajah,1,1,0,1,ajah3,900000.0,1000000.0,1000000.0,3,24,4,1000000
310, gated street by junction/harmony estate bustop langbasa road addo ajah ado ajah lagos,4,2,2,2,"Spacious 3 bedroom flat with big kitchen, big sitting room and dinning and it comes with split Ac in the sitting room and Ac in masters bedroom. Prepaid meter and interlocked compound. ... Cheap. Big Compound. 24 Hours Security. Water Treatment. ...",ajah,1,1,0,1,ajah2,800000.0,800000.0,800000.0,3,21,4,800000
311, before sangotedo market in sangotedo in ajah axis lekki. sangotedo ajah lagos,6,3,3,3,"A Well Kept 2 Bedrooms Flat in a peaceful, gated and secure area with good roads, very close to the road, clean water, easy access to the roads and good light in Sangotedo in Ajah ... Cheap. Renovated. Big Compound. Restaurants Nearby. Security Doors. 24 Hours Security. Drainage System. Street Lights. Church Nearby. Security. All Room Ensuit. Supermarket Nearby. Fast Internet. Parking Space. Pop Ceiling. Water Treatment. ...",ajah,0,0,0,1,ajah3,900000.0,1000000.0,1000000.0,1,24,4,900000
312, ajah lagos,4,2,2,2,"Newly build 2 bedroom is available for rent at Ajah,price 650k for upstairs ,600k for downstairs yearly ... ...",ajah,1,1,0,1,ajah2,800000.0,800000.0,800000.0,3,21,4,800000
313, chinese road junction bustop addo - langbasa rd ajah ado ajah lagos,5,3,2,3,"Renovated 2 bedroom flat rooms ensuite with kitchen, 2 windows in each room for cross ventilation, spacious sitting room and rooms inside floored compound facing interlocked road. ... Renovated. All Room Ensuit. Big Compound. ...",ajah,0,0,0,1,ajah3,900000.0,1000000.0,1000000.0,1,24,4,900000
314, around the new shoprite in sangotedo in ajah axis lekki. sangotedo ajah lagos,10,5,5,5,"A Newly Built Nice 4 Bedrooms Duplex in a very cool, seriously guarded, well gated and highly secured Estate with good roads, easy access to the roads, good light, clean water, very close to the ... Serviced. New. Cheap. Boys Quater. Cctv Cameras. Big Compound. Restaurants Nearby. Security Doors. 24 Hours Security. Drainage System. Street Lights. Security. All Room Ensuit. Supermarket Nearby. Fast Internet. Parking Space. 24 Hours Electricity. Pop Ceiling. Children Play Ground. Child Care. Water Treatment. ...",ajah,1,1,0,1,ajah5,3000000.0,3000000.0,3000000.0,3,43,8,3000000
315, remlek estate badore ajah badore ajah lagos,2,1,1,1,"Decent and Clean Miniflat with Spacious sitting room, POP ceiling, interlocked compound facing interlocked road inside the estate. ... Renovated. Security Doors. Pop Ceiling. Water Treatment. ...",ajah,1,1,1,1,ajah1,400000.0,500000.0,450000.0,4,6,1,500000
316, greenville estate badore ajah badore ajah lagos,2,1,1,1,New Miniflat inside an interlocked compound. ... New. Big Compound. Pop Ceiling. ...,ajah,0,0,0,1,ajah1,400000.0,500000.0,450000.0,1,6,1,400000
317, greenville estate badore ajah badore ajah lagos,2,1,1,1,"Renovated Miniflat with POP, modern kitchen and spacious sitting room. ... Cheap. Renovated. Pop Ceiling. 24 Hours Security. ...",ajah,1,1,1,1,ajah1,400000.0,500000.0,450000.0,4,6,1,500000
318, teran x estate near bleco super market olokonla ajah lagos,5,3,2,3,A very good road and security Wise light u will not regret it ... ...,ajah,1,1,1,1,ajah3,900000.0,1000000.0,1000000.0,4,24,4,1100000
319, elegant court estate mobil road illaje ajah ilaje ajah lagos,7,4,3,4,"Clean 3 bedroom flat upstairs all rooms ensuite, spacious sitting room, heat extractor in the kitchen, study room inside an interlocked mini Estate compound facing Mobil road Illaje Ajah ... Renovated. All Room Ensuit. Big Compound. Security Doors. Pop Ceiling. 24 Hours Security. ...",ajah,0,0,0,1,ajah4,1200000.0,1500000.0,1300000.0,1,29,5,1200000
320, royal palm will estate remlek badore ajah lagos,5,3,2,3,This two bedrooms is new and good looking ... ...,ajah,0,0,0,1,ajah3,900000.0,1000000.0,1000000.0,1,24,4,900000
321," majek, after crown estate in ajah axis lekki. crown estate ajah lagos",8,4,4,4,"A Brand New 3 Bedrooms Flat in a guarded and gated area of Majek with good light, easy access to the roads and clean water after Crown Estate in Ajah axis Lekki For Rent. ... New. Cheap. Big Compound. Restaurants Nearby. Security Doors. 24 Hours Security. Drainage System. Street Lights. Church Nearby. Security. All Room Ensuit. Supermarket Nearby. Fast Internet. Parking Space. Pop Ceiling. Water Treatment. ...",ajah,0,0,0,1,ajah4,1200000.0,1500000.0,1300000.0,1,29,5,1200000
322, peninsula estate ajah lagos,7,4,3,4," *Lovely 3 bedroom flat, master ensuite, tiled, kitchen cabinet+water heater, pop, wardrobe, gated, good road networking, parking space etc @ rotea close, Penniisulla garden estate ajah itâ€™s going for #1.6m negotiable* ... ...",ajah,1,1,1,1,ajah4,1200000.0,1500000.0,1300000.0,4,29,5,1600000
323, anu crescent estate badore ajah lagos,4,2,2,2,EXQUISITELY FINISHED BRAND NEW 2 BEDROOM FLAT FOR RENT FEATURES -Large Sitting Room. -All Rooms Ensuite -Fitted Kitchen -Visitor's Toilet. -Water Heater -Stylish Wardrobe -Shower Cubicles -POP Finished -Water Treatment Plant -Excellent Parking Space. -Stamping Floor. Interlocked Road. -24Hrs Estate Security -Great Lighting -House Security Post. -Generator House. -Serena Environment. E.T.C ... All Room Ensuit. Big Compound. 24 Hours Electricity. Pop Ceiling. 24 Hours Security. ...,ajah,1,1,1,1,ajah2,800000.0,800000.0,800000.0,4,21,4,1000000
324, powerline estate opp sunny villa estate badore ajah badore ajah lagos,5,3,2,3,"Renovated 2 bedroom flat all rooms ensuite spacious sitting room and rooms, good for young couple not far from the major road. ... Renovated. All Room Ensuit. Big Compound. Pop Ceiling. 24 Hours Security. Water Treatment. ...",ajah,0,0,0,1,ajah3,900000.0,1000000.0,1000000.0,1,24,4,900000
325," onison street, lakowe lakowe ajah lagos",5,3,2,3,Newly buit 2bedroom flat in a cerene neighbourhood ... Serviced. New. Cheap. Security. All Room Ensuit. Supermarket Nearby. Restaurants Nearby. Parking Space. Pop Ceiling. 24 Hours Security. Drainage System. Water Treatment. Church Nearby. ...,ajah,0,0,0,1,ajah3,900000.0,1000000.0,1000000.0,1,24,4,900000
326, anu crescent badore ajah lekki badore ajah lagos,4,2,2,2,EXQUISITELY FINISHED BRAND NEW 2 BEDROOM FLAT FOR RENT FEATURES -Large Sitting Room. -All Rooms Ensuite -Fitted Kitchen -Visitor's Toilet. -Water Heater -Stylish Wardrobe -Shower Cubicles -POP Finished -Water Treatment Plant -Excellent Parking Space. -Stamping Floor. Interlocked Road. -24Hrs Estate Security -Great Lighting -House Security Post. -Generator House. -Serena Environment. E.T.C ... New. All Room Ensuit. Pop Ceiling. ...,ajah,1,1,1,1,ajah2,800000.0,800000.0,800000.0,4,21,4,1000000
327, ajah lagos,4,2,2,2,Brand new 2 bedroom flat for rent in Ajah. The house is located in a clean and secured environment. Its also very close to the main road. ... ...,ajah,1,1,0,1,ajah2,800000.0,800000.0,800000.0,3,21,4,800000
328, ogunfayo ibeju-lekki sangotedo ajah lagos,2,1,1,1,"Very clean and durable flat. Water, good light. Nice facilities. A spacious sitting room. Flat to share. Agreement 20,000.00 No Agency. ... ...",ajah,0,0,0,1,ajah1,400000.0,500000.0,450000.0,1,6,1,400000
329," cooperative villa road, badore badore ajah lagos",12,6,6,6,"Tastefully finished and well-managed bungalow for rent in Badore, well-managed road. The apartment comes with a swimming pool, children playground, CCTV camera the water treatment plant, generator house, and security house, pet house, etc. ... Dry. Boys Quater. Cctv Cameras. Restaurants Nearby. Drainage System. Church Nearby. Mosques Nearby. Security. All Room Ensuit. Supermarket Nearby. Parking Space. Swimming Pool. Pop Ceiling. Children Play Ground. Child Care. Water Treatment. ...",ajah,1,1,0,1,ajah6,4000000.0,4000000.0,4000000.0,3,50,9,4000000
330, red roof bustop langbasa road ajah ado ajah lagos,3,2,1,2,Brand new Miniflat with 2 toilets spacious sitting room and spacious kitchen. ... New. All Room Ensuit. Big Compound. Pop Ceiling. 24 Hours Security. ...,ajah,1,1,0,1,ajah2,800000.0,800000.0,800000.0,3,21,4,800000
331, majek opp fara park after crown estate in ajah axis lekki. crown estate ajah lagos,2,1,1,1,"A Newly Built Room Self-contained in a decent, gated and guarded area of Majek with clean water, easy access to the roads and good light opposite Fara Park after Crown Estate in Ajah axis Lekki ... New. Cheap. Big Compound. Restaurants Nearby. Security Doors. 24 Hours Security. Drainage System. Street Lights. Church Nearby. Security. All Room Ensuit. Supermarket Nearby. Fast Internet. Parking Space. Pop Ceiling. Water Treatment. ...",ajah,0,0,0,1,ajah1,400000.0,500000.0,450000.0,1,6,1,400000
332, greenville estate badore ajah badore ajah lagos,2,1,1,1,Renovated Miniflat with spacious kitchen and sitting room. ... Renovated. Security Doors. Pop Ceiling. Water Treatment. ...,ajah,0,0,0,1,ajah1,400000.0,500000.0,450000.0,1,6,1,400000
333," mayfair garden, awoyaya, ajah axis lekki. awoyaya ajah lagos",8,4,4,4,"A Well Finished 3 Bedrooms Bungalow with BQ and Penthouse in a very well maintained, serviced, serene, well gated, seriously guarded and highly secured Estate with good street lights, good access roads, clean environment, good ... Serviced. New. Cheap. Boys Quater. Big Compound. Restaurants Nearby. Security Doors. 24 Hours Security. Drainage System. Street Lights. Security. All Room Ensuit. Supermarket Nearby. Fast Internet. Parking Space. 24 Hours Electricity. Pop Ceiling. Children Play Ground. Child Care. Water Treatment. ...",ajah,1,1,1,1,ajah4,1200000.0,1500000.0,1300000.0,4,29,5,1500000
334, marshy hill estate akins bustop off addo road ajah ado ajah lagos,7,4,3,4,"Brand new 3 bedroom flat all rooms ensuite with POP ceiling, water heater bath, front and back balcony, modern kitchen cabinet and wardrobe inside an interlocked compound inside a gated Estate. Downstairs N1.1m Rent, Upstairs ... New. All Room Ensuit. Big Compound. Pop Ceiling. 24 Hours Security. Water Treatment. ...",ajah,0,0,0,1,ajah4,1200000.0,1500000.0,1300000.0,1,29,5,1200000
335, an estate in abijo after crown estate in ajah axis lekki. abijo ajah lagos,6,3,3,3,"A Very Spacious 2 Bedrooms Flat in a gated, secured and cool Estate with clean water, good light and easy access roads in Abijo after Crown Estate in Ajah axis Lekki For Rent. ... Cheap. Renovated. Security. All Room Ensuit. Big Compound. Supermarket Nearby. Fast Internet. Restaurants Nearby. Security Doors. Parking Space. Pop Ceiling. 24 Hours Security. Street Lights. Water Treatment. ...",ajah,0,0,0,1,ajah3,900000.0,1000000.0,1000000.0,1,24,4,900000
336, ajah ajah lagos,2,1,1,1,"A single room boys quarter is available in an estate with security,light, interlock compound clean water, personal toilet and bathroom but no kitchen. Standby generator as from 7 pm till day brake. ... ...",ajah,0,0,0,1,ajah1,400000.0,500000.0,450000.0,1,6,1,400000
337, ajah lagos,6,3,3,3,Decent 3 bedroom flat for rent in Ajah. Only 4 people in a compound ... ...,ajah,1,1,0,1,ajah3,900000.0,1000000.0,1000000.0,3,24,4,1000000
338, badore ajah lagos,6,3,3,3,"VERY DECENT 3 BEDROOMS FLAT, ALL ROOMS ENSUITE, FULLY TILED WITH WARDROBES, POP CEILING, WATER HEATER @ SEASIDE ESTATE, BADORE AJAH RENT: #800,000 P/A ... Serviced. New. Renovated. Security. All Room Ensuit. Big Compound. Supermarket Nearby. Restaurants Nearby. Security Doors. Parking Space. Pop Ceiling. 24 Hours Security. Drainage System. ...",ajah,0,0,0,1,ajah3,900000.0,1000000.0,1000000.0,1,24,4,900000
339," within an estate, off ado road. ado ajah lagos",7,4,3,4,"Three bedroom flat, ground floor available. No BQ. Rhe ... Renovated. All Room Ensuit. Supermarket Nearby. Restaurants Nearby. 24 Hours Security. ...",ajah,0,0,0,1,ajah4,1200000.0,1500000.0,1300000.0,1,29,5,1200000
340, gated street by junction bustop opp harmony estate langbasa road ajah ado ajah lagos,5,3,2,3,"Brand new 2 bedroom flat pall rooms ensuite with visitors toilet, modern kitchen with store POP ceiling, shower cubicle bathroom.with water heater, spacious sitting room with dinning section. ... New. All Room Ensuit. Big Compound. Security Doors. Parking Space. Pop Ceiling. 24 Hours Security. ...",ajah,0,0,0,1,ajah3,900000.0,1000000.0,1000000.0,1,24,4,900000
341," blenco supermarket before sangotedo, after lbs. peninsula estate ajah lagos",9,5,4,5,"Tastefully Finished New 4 Bedrooms Duplex with BQ in a very serene, lovely, well gated, seriously guarded and highly secured Estate with clean water, good lighting, very good roads, easy access roads, good light, very ... Serviced. New. Cheap. Boys Quater. Big Compound. Restaurants Nearby. Security Doors. 24 Hours Security. Drainage System. Street Lights. Security. All Room Ensuit. Supermarket Nearby. Fast Internet. Parking Space. Pop Ceiling. Children Play Ground. Child Care. Water Treatment. ...",ajah,1,1,0,1,ajah5,3000000.0,3000000.0,3000000.0,3,43,8,3000000
342, meridian luxury park estate awoyaya ajah lagos,7,4,3,4,"*Update* Only one unit remaining! ------------------------------------------------------------------------------------------------------------------------------------------------------------------------------------------------------ Luxury newly built 3 bedroom terraced apartment with all rooms ensuite with top-class finishing in a well-interlocked, secure estate. Rent per annum: 1,200,000 Service Charge: 250,000 Agency: 120,000 Agreement: 120,000 Caution Fee: 100,000 ... Serviced. New. Security. All Room Ensuit. Security Doors. Parking Space. 24 Hours Electricity. Pop Ceiling. Children Play Ground. 24 Hours Security. Street Lights. Water Treatment. ...",ajah,0,0,0,1,ajah4,1200000.0,1500000.0,1300000.0,1,29,5,1200000
343, .. sangotedo ajah lagos,6,3,3,3,Tastefully built 3 bedroom flat for rent in Sangotedo. Price Breakdown ====== Annual rent: N1.4m Annual Service Charge: 150k 10% Refundable caution fee: 140k 10% Legal fee (agreement): 140k 10% Agents fee: 140k ... ...,ajah,1,1,1,1,ajah3,900000.0,1000000.0,1000000.0,4,24,4,1400000
344," majek after fara park, after crown estate in ajah axis lekki. crown estate ajah lagos",8,4,4,4,A Well Kept Very Spacious 3 Bedrooms Flat along the express road in a guarded and gated Compound in Majek with good light and clean water after Fara Park and after Crown Estate in Ajah ... Cheap. Renovated. Big Compound. Restaurants Nearby. Security Doors. 24 Hours Security. Drainage System. Street Lights. Church Nearby. Security. All Room Ensuit. Supermarket Nearby. Fast Internet. Parking Space. Water Treatment. ...,ajah,0,0,0,1,ajah4,1200000.0,1500000.0,1300000.0,1,29,5,1200000
345," behind abraham adesanya round about, ajah lagos",11,6,5,6,A very affordable 5 Bedroom duplex For Rent N1.2M Legal 10% Agent 10% Caution N60k Total package N1.5M ... ...,ajah,1,1,0,1,ajah6,4000000.0,4000000.0,4000000.0,3,50,9,4000000
346, lagum view estate opp catholic church ajah lagos,12,6,6,6,A bed room duplex for rent in lagum view estate Opp Catholic church Ado Road Ajah Lagos State ... ...,ajah,1,1,0,1,ajah6,4000000.0,4000000.0,4000000.0,3,50,9,4000000
347, before blenco supermarket before sangotedo in ajah axis lekki. olokonla ajah lagos,6,3,3,3,"A Very Decent 3 Bedrooms Flat in a quiet, well gated and highly secured Estate with clean water, good light, easy access to the road and very close to the road before Blenco Supermarket in ... New. Cheap. Security. All Room Ensuit. Big Compound. Supermarket Nearby. Restaurants Nearby. Security Doors. Parking Space. Pop Ceiling. 24 Hours Security. Drainage System. Street Lights. Water Treatment. ...",ajah,0,0,0,1,ajah3,900000.0,1000000.0,1000000.0,1,24,4,900000
348, emerald housing estate ilaje ajah lagos,8,4,4,4,The property is a 5 bedroom detached house located in a serene and highly secured gated estate off Mobil Road Ilaje. It is painted both internally and externally. Ceiling is finished with POP and Floor ... Serviced. Cheap. Renovated. Water Treatment. ...,ajah,1,1,1,1,ajah4,1200000.0,1500000.0,1300000.0,4,29,5,2500000
349, general paint bus stop just by abraham adesanya estate abraham adesanya estate ajah lagos,9,5,4,5,4 bedroom Semi detached house Feature: Gym Swimming pool Spacious compound Good road Good water ... New. Security. All Room Ensuit. Big Compound. Gym. Security Doors. 24 Hours Electricity. Swimming Pool. 24 Hours Security. Street Lights. Water Treatment. ...,ajah,1,1,0,1,ajah5,3000000.0,3000000.0,3000000.0,3,43,8,3000000
350, sangotedo sangotedo ajah lagos,7,4,3,4,"Beautiful 3 bedroom flat for rent at in an estate at Ajah, off Lekki expressway. Fully fitted kitchen Inverter 24hrs light Heat extractor AC in all rooms and kitchen Spacious sitting room Fitted modern wardrobes Tight security. Refundable caution fee: 150k ... ...",ajah,1,0,0,1,ajah4,1200000.0,1500000.0,1300000.0,2,29,5,1300000
351, lekki scheme 2 ajiwe ajah lagos,10,5,5,5,Newly Built 4bedroom Flat at Lekki Scheme 2...rent 2m ... ...,ajah,1,1,0,1,ajah5,3000000.0,3000000.0,3000000.0,3,43,8,3000000
352, after lbs in olokonla in ajah axis lekki. olokonla ajah lagos,6,3,3,3,"A Very New 2 Bedrooms Flat in a quiet, safe, guarded, well gated and highly secured Estate with good light, clean water and easy access roads after the Lagos Business School in Olokonla in Ajah ... New. Cheap. Big Compound. Restaurants Nearby. Security Doors. 24 Hours Security. Drainage System. Street Lights. Security. All Room Ensuit. Supermarket Nearby. Fast Internet. Parking Space. Pop Ceiling. Water Treatment. ...",ajah,0,0,0,1,ajah3,900000.0,1000000.0,1000000.0,1,24,4,900000
353, olokonla olokonla ajah lagos,7,4,3,4,A very uniquely spacious 3 bedrooms with features as follow: A well interlocked road. A big parking space Large living room with a guest toilet and dinning session cabinet kitchen spacious bedrooms all ensuit uniques masters' bedrooms design balconies ... ...,ajah,0,0,0,1,ajah4,1200000.0,1500000.0,1300000.0,1,29,5,1200000
354, loshoro..school gate badore ajah lagos,2,1,1,1,Room.and parlour to rent at loshoro..school gate.. ... ...,ajah,0,0,0,1,ajah1,400000.0,500000.0,450000.0,1,6,1,400000
355, reservation estate langbasa road owode addo ajah ado ajah lagos,5,3,2,3,"Brand new 2 Bedroom Flat all rooms ensuite POP ceiling water heater bathroom modern kitchen with prepaid meter, interlocked compound facing interlocked road inside the estate. ... New. All Room Ensuit. Big Compound. Pop Ceiling. 24 Hours Security. Water Treatment. ...",ajah,1,1,0,1,ajah3,900000.0,1000000.0,1000000.0,3,24,4,1000000
356, off mobil road ilaje ajah lagos,4,2,2,2,"Fully serviced 2 Bedroom flat to let, off Mobil road, Ajah, Lagos. N1m/annum Service Charge: N500K/Annum ... Serviced. All Room Ensuit. Cctv Cameras. Big Compound. Parking Space. 24 Hours Electricity. Pop Ceiling. 24 Hours Security. ...",ajah,1,1,1,1,ajah2,800000.0,800000.0,800000.0,4,21,4,1000000
357, sangotedo ajah lagos,4,2,2,2,"VERY DECENT 2 BEDROOM FLAT, ALL ROOMS ENSUITE, FULLY TILED WITH WARDROBES, POP CEILING, WATER HEATER @ CANAAN ESTATE, SANGOTEDO AJAH Rent: #750,000 P/A ... New. Renovated. Security. All Room Ensuit. Big Compound. Supermarket Nearby. Restaurants Nearby. Security Doors. Parking Space. Pop Ceiling. 24 Hours Security. Drainage System. ...",ajah,1,1,0,1,ajah2,800000.0,800000.0,800000.0,3,21,4,800000
358, awoyaya bus stop awoyaya ajah lagos,7,4,3,4,"Standard 3bedroom flat at awoyaya, upstair with massive sitting rooms with mordern facilities ... Serviced. Cheap. Renovated. Mosques Nearby. Security. All Room Ensuit. Big Compound. Supermarket Nearby. Restaurants Nearby. Security Doors. Pop Ceiling. 24 Hours Security. Drainage System. Water Treatment. Church Nearby. ...",ajah,0,0,0,1,ajah4,1200000.0,1500000.0,1300000.0,1,29,5,1200000
359, sangotedo ajah lagos,6,3,3,3,Decent and well tiled 3 bedroom for rent in Ajah It's in a clean and secured environment ... ...,ajah,0,0,0,1,ajah3,900000.0,1000000.0,1000000.0,1,24,4,900000
360, red roof bustop addo - langbasa rd ajah ado ajah lagos,3,2,1,2,"Spacious Miniflat with large sitting room and dinning section, spacious room ensuite with visitors toilet and POP ceiling. ... New. All Room Ensuit. Big Compound. Security Doors. Pop Ceiling. 24 Hours Security. Water Treatment. ...",ajah,1,1,0,1,ajah2,800000.0,800000.0,800000.0,3,21,4,800000
361, greenville estate badore ajah badore ajah lagos,2,1,1,1,"Clean and Portable Miniflat perfect for a Bachelor or spinster with 2 windows in the room and sitting room inside an interlocked compound with own prepaid meter. Rent N500k upstairs, Downstairs Rent N450k ... New. Cheap. Big Compound. Pop Ceiling. 24 Hours Security. Water Treatment. ...",ajah,1,1,1,1,ajah1,400000.0,500000.0,450000.0,4,6,1,500000
362, crown estate crown estate ajah lagos,8,4,4,4,Do you know Crown estate lekki peninsula just after the popular shop right at sangotedo eti-osa local government area ajah Lagos. I have a brand new distress 4bedroom duplex with a mini flat BQ on ... ...,ajah,1,1,1,1,ajah4,1200000.0,1500000.0,1300000.0,4,29,5,3000000
363, esfort estate addo road ajah ado ajah lagos,2,1,1,1,Standard Miniflat with POP inside the main building inside interlocked compound facing interlocked road inside the Estate with tight security. Owner will put the place in order and also paint with few day after receipt ... Renovated. All Room Ensuit. Big Compound. Pop Ceiling. 24 Hours Security. Water Treatment. ...,ajah,1,1,1,1,ajah1,400000.0,500000.0,450000.0,4,6,1,700000
364, estate after crown estate in ajah axis lekki. abijo ajah lagos,6,3,3,3,"A 2 Bedrooms Flat in a well gated and guarded Estate with easy access road, good light, clean water and very close to the road after Crown Estate in Ajah axis Lekki For Rent. ... Cheap. Renovated. Security. All Room Ensuit. Big Compound. Supermarket Nearby. Restaurants Nearby. Security Doors. Parking Space. Pop Ceiling. 24 Hours Security. Drainage System. Street Lights. Water Treatment. ...",ajah,0,0,0,1,ajah3,900000.0,1000000.0,1000000.0,1,24,4,900000
365," abraham adesanya estate, ajah lagos",2,1,1,1,Very lovely apartment in good location of the estate Rent 400k Agency and agreement 10% each ... ...,ajah,0,0,0,1,ajah1,400000.0,500000.0,450000.0,1,6,1,400000
366, marshy hill estate ado ajah lagos,7,4,3,4,Clean three bedroom flat Ensuite and spacious rooms. ... Renovated. All Room Ensuit. ...,ajah,0,0,0,1,ajah4,1200000.0,1500000.0,1300000.0,1,29,5,1200000
367, chevron alternative ajah lagos,9,5,4,5,"Features,a large BQ,a large compound, CCTV cameras both interior and exterior,central speakers in all the rooms, and toilet,Jacuzzi in the masters bedroom,cooker,heat extractor,microwave,oven and inverter power. ... ...",ajah,1,1,1,1,ajah5,3000000.0,3000000.0,3000000.0,4,43,8,3500000
368, gated estate opp emerald estate mobil road illaje ajah ilaje ajah lagos,5,3,2,3,"Modern 2 bedroom flat all rooms ensuite with fitted kitchen, POP.ceiling visitors toilet with 2 windows in each room for cross ventilation. ... Cheap. All Room Ensuit. Security Doors. Pop Ceiling. 24 Hours Security. Water Treatment. ...",ajah,0,0,0,1,ajah3,900000.0,1000000.0,1000000.0,1,24,4,900000
369," destiny homes estate in abijo, after fara park, after crown estate in ajah axis lekki. crown estate ajah lagos",8,4,4,4,"A Very New 3 Bedrooms Flat in a quiet, well gated and highly guarded Destiny Homes Estate with clean water, good light, easy access to the roads, good roads and very close to the express ... New. Cheap. Big Compound. Restaurants Nearby. Security Doors. 24 Hours Security. Drainage System. Street Lights. Church Nearby. Security. All Room Ensuit. Supermarket Nearby. Fast Internet. Parking Space. Pop Ceiling. Water Treatment. ...",ajah,0,0,0,1,ajah4,1200000.0,1500000.0,1300000.0,1,29,5,1200000
370, ajose street badore ajah badore ajah lagos,7,4,3,4,"Tastefully Finished 3 Bedroom Terrace duplex with 2 sitting room spacious kitchen, rooms POP ceiling, water heater bathroom, water treatment plant, prepaid meter, interlocked compound facing interlocked road. ... Renovated. All Room Ensuit. Big Compound. Security Doors. Parking Space. 24 Hours Security. Water Treatment. ...",ajah,0,0,0,1,ajah4,1200000.0,1500000.0,1300000.0,1,29,5,1250000
371, gated street by junction bustop harmony estate langbasa rd ajah ado ajah lagos,3,2,1,2,Brand new spacious Miniflat with 2 toilets spacious kitchen with store and balcony ... New. All Room Ensuit. Big Compound. Pop Ceiling. 24 Hours Security. ...,ajah,1,1,0,1,ajah2,800000.0,800000.0,800000.0,3,21,4,800000
372, ajah lagos,6,3,3,3,Newly built 3bedroom service Apartment with swimming pool for rent. Rent-1. 5m S/c-400k Refundable Caution-150k Agent-150k Legal-150k ... ...,ajah,1,1,1,1,ajah3,900000.0,1000000.0,1000000.0,4,24,4,1500000
373, gated estate by junction bustop facing harmony estate langbasa road ajah ado ajah lagos,5,3,2,3,"Brand new 2 bedroom flat all rooms ensuite with shower cubicles spacious modern kitchen with cupboard and cabinet, store and balcony upstairs. ... New. All Room Ensuit. Big Compound. Pop Ceiling. 24 Hours Security. ...",ajah,0,0,0,1,ajah3,900000.0,1000000.0,1000000.0,1,24,4,900000
374, remlek estate badore ajah badore ajah lagos,7,4,3,4,Brand new 3 bedroom duplex with spacious kitchen and sitting room inside a gated estate.. Not far from the interlocked road inside Remlek Estate Badore Ajah ... New. All Room Ensuit. Big Compound. Pop Ceiling. 24 Hours Security. Water Treatment. ...,ajah,0,0,0,1,ajah4,1200000.0,1500000.0,1300000.0,1,29,5,1200000
375, omoba bade street marshy hill estate ado ajah lagos,7,4,3,4,"Description:- 3-Bedroom flat with Maid's room in a block of 6-flats within Marshy Hill Estate, Ado Road, Lekki, Lagos. Rent:- N1,100,000 Service Charge:- N150,000pa Agency Fee:- N110,000 Legal Fee:- N110,000 TOTAL = N1,470,000 ... Serviced. New. Boys Quater. Security. All Room Ensuit. Big Compound. Supermarket Nearby. Restaurants Nearby. Security Doors. Pop Ceiling. Street Lights. Water Treatment. Church Nearby. ...",ajah,0,0,0,1,ajah4,1200000.0,1500000.0,1300000.0,1,29,5,1200000
376, ocean palm estate sangotedo ajah lagos,5,3,2,3,"House features: Spacious living room and bedrooms, all rooms en-suite with spacious bathrooms, well equipped kitchen two conducive balcony 24hours power supply, well treated water system. Located in a serene and secured estate at sangotedo immediately after ... ...",ajah,1,1,1,1,ajah3,900000.0,1000000.0,1000000.0,4,24,4,1100000
377, unity estate maryland badore ajah badore ajah lagos,9,5,4,5,"Spacious 4 bedroom semi detached duplex all rooms ensuite with spacious kitchen, spacious sitting room and big compound good for both residential and commercial purpose close to the interlocked road inside the estate. ... Cheap. Renovated. All Room Ensuit. Big Compound. Pop Ceiling. 24 Hours Security. Water Treatment. ...",ajah,1,1,0,1,ajah5,3000000.0,3000000.0,3000000.0,3,43,8,3000000
378, pearl garden estate sangotedo ajah lagos,9,5,4,5,NEWLY BUILT 4BEDRM FULLY DETACHED DUPLEX WITH A ROOM BOYS QUARTER PRICE: 1.6M LOCATION: PEARL GARDEN ESTATE SANGOTEDO ... Boys Quater. Security. All Room Ensuit. Big Compound. Gym. Pop Ceiling. ...,ajah,1,1,0,1,ajah5,3000000.0,3000000.0,3000000.0,3,43,8,3000000
379, greenville estate badore ajah badore ajah lagos,5,3,2,3,Spacious and Tastefully Finished 2 bedroom flat all rooms ensuite spacious kitchen with spacious sitting room. Masters bedroom has balcony inside an interlocked compound ... New. All Room Ensuit. Security Doors. Pop Ceiling. 24 Hours Security. Water Treatment. ...,ajah,0,0,0,1,ajah3,900000.0,1000000.0,1000000.0,1,24,4,900000
380, marshy hill estate addo road ajah ado ajah lagos,2,1,1,1,Brand new roomself contain with studio kitchen spacious room and balcony facing an interlocked road inside the estate. ... New. Big Compound. Security Doors. Pop Ceiling. ...,ajah,1,0,0,1,ajah1,400000.0,500000.0,450000.0,2,6,1,450000
381, before the new shoprite in sangotedo in ajah axis lekki. sangotedo ajah lagos,8,4,4,4,"A Very Fine 3 Bedrooms Flat in a cool, gated and secured Estate with clean water, easy access to the roads, very close to the road, good light and good roads in Sangotedo in Ajah ... New. Cheap. Big Compound. Restaurants Nearby. Security Doors. 24 Hours Security. Drainage System. Street Lights. Church Nearby. Security. All Room Ensuit. Supermarket Nearby. Fast Internet. Parking Space. Pop Ceiling. Water Treatment. ...",ajah,0,0,0,1,ajah4,1200000.0,1500000.0,1300000.0,1,29,5,1200000
382, golf road lakowe lakowe ajah lagos,8,4,4,4,"Super clean Rent 750k Agency 75k, legal 75k couation deposit 50k. ... ...",ajah,1,1,1,1,ajah4,1200000.0,1500000.0,1300000.0,4,29,5,3000000
383," crown estate, sangotedo, ajah axis lekki. crown estate ajah lagos",8,4,4,4,"A Standard 3 Bedrooms Bungalow in a serene, beautiful, well gated, seriously guarded, highly secured and well maintained environment with good water, street lights, good light, easy access roads, good roads and nicely serviced Crown ... Serviced. New. Cheap. Renovated. Boys Quater. Cctv Cameras. Big Compound. Restaurants Nearby. Security Doors. 24 Hours Security. Drainage System. Street Lights. Security. All Room Ensuit. Supermarket Nearby. Fast Internet. Parking Space. 24 Hours Electricity. Pop Ceiling. Children Play Ground. Child Care. Water Treatment. ...",ajah,1,1,1,1,ajah4,1200000.0,1500000.0,1300000.0,4,29,5,1500000
384, green ville estate badore ajah lagos,2,1,1,1,Standard mini flat in a cerene neighbourhood with modern facilities ... Serviced. New. Cheap. Security. All Room Ensuit. Big Compound. Supermarket Nearby. Parking Space. Pop Ceiling. 24 Hours Security. Drainage System. Water Treatment. ...,ajah,1,1,1,1,ajah1,400000.0,500000.0,450000.0,4,6,1,500000
385, thomas estate thomas estate ajah lagos,6,3,3,3,Very lovely apartment in good location of the estate ... ...,ajah,1,1,1,1,ajah3,900000.0,1000000.0,1000000.0,4,24,4,1600000
386," infinity estate, ado road. ado ajah lagos",5,3,2,3,"Fully fitted luxury 2 bedroom apartment in Infinity estate, with automatic gates and state of the art fittings. ... New. Dry. Security. All Room Ensuit. Parking Space. Pop Ceiling. 24 Hours Security. Drainage System. Water Treatment. ...",ajah,1,1,1,1,ajah3,900000.0,1000000.0,1000000.0,4,24,4,1500000
387, seaside estate badore ajah lagos,5,3,2,3,The property is located in a gated serene neighborhood. It is painted both internally and externally with interlocked ample parking space. The ceiling is finished with POP and floor with tiles ... Serviced. ...,ajah,0,0,0,1,ajah3,900000.0,1000000.0,1000000.0,1,24,4,900000
388, by hot bread sangotedo ajah lagos,2,1,1,1,A cozy room self contain to let. Female preferably needed. ... ...,ajah,0,0,0,1,ajah1,400000.0,500000.0,450000.0,1,6,1,400000
389," united estate, sangotedo ajah lagos",7,4,3,4,_Well finished 3 Bedroom Flat _3mins to Lekki Epe Expressway _4Mins to Novare Mall ( ShopRite ) _Paved Compound _Can contain 6 Cars Rent : 1M Legal :100k Agent 100k Service Charge : 100k: ... ...,ajah,0,0,0,1,ajah4,1200000.0,1500000.0,1300000.0,1,29,5,1200000
390, divine homes estate thomas estate ajah lagos,9,5,4,5,Four bedroom fully detached duplex with Bq on a paved road. D/SAJ ... Boys Quater. Security. All Room Ensuit. Supermarket Nearby. Restaurants Nearby. Parking Space. ...,ajah,1,1,0,1,ajah5,3000000.0,3000000.0,3000000.0,3,43,8,3000000
391, an estate in abijo after crown estate in ajah axis lekki. abijo ajah lagos,6,3,3,3,"A Very Sweet and Beautiful 2 Bedrooms Duplex in a cool, highly secured, seriously guarded and well gated Estate with good access roads, clean water and good light in Abijo after Crown Estate in Ajah ... New. Cheap. Big Compound. Restaurants Nearby. Security Doors. 24 Hours Security. Drainage System. Street Lights. Security. All Room Ensuit. Supermarket Nearby. Fast Internet. Parking Space. Pop Ceiling. Water Treatment. ...",ajah,0,0,0,1,ajah3,900000.0,1000000.0,1000000.0,1,24,4,900000
392, peace estate cocacola bustop badore ajah badore ajah lagos,3,2,1,2,"Brand New Spacious Miniflat with fitted kitchen cupboard and cabinet, 2 toilets spacious sitting room inside an interlocked compound facing interlocked road inside the estate and it's close to Badore road. ... New. Cheap. All Room Ensuit. Big Compound. Security Doors. Pop Ceiling. 24 Hours Security. Water Treatment. ...",ajah,1,1,0,1,ajah2,800000.0,800000.0,800000.0,3,21,4,800000
393, apteck rd sangotedo ajah lagos,7,4,3,4,Newly Built 3 Bedrooms Flat For Rent in a Fine Estate ... New. Cheap. Big Compound. Restaurants Nearby. Security Doors. 24 Hours Security. Drainage System. Street Lights. Security. All Room Ensuit. Supermarket Nearby. Fast Internet. Parking Space. Pop Ceiling. Water Treatment. ...,ajah,0,0,0,1,ajah4,1200000.0,1500000.0,1300000.0,1,29,5,1200000
394, within a very secure and peaceful estate ado ajah lagos,7,4,3,4,"Spacious three bedroom flat, all rooms ensuite with guest toilet in an estate along the road. The flat is close to the estate gate. The flat is on the third/last floor. Only six units in ... Renovated. Security. All Room Ensuit. Supermarket Nearby. Ocean View. Restaurants Nearby. Parking Space. 24 Hours Security. ...",ajah,0,0,0,1,ajah4,1200000.0,1500000.0,1300000.0,1,29,5,1200000
395, behind the new shoprite in sangotedo in ajah axis lekki. sangotedo ajah lagos,10,5,5,5,"A Brand New Superbly Built, Luxuriously Finished 4 Bedrooms Duplex with BQ in a very Beautiful, serene, cool, well gated, seriously guarded and highly secured Estate with clean water, good roads, easy access to the ... Serviced. New. Cheap. Boys Quater. Cctv Cameras. Big Compound. Restaurants Nearby. Security Doors. Front Desk Service. 24 Hours Security. Drainage System. Street Lights. Church Nearby. Jacuzzi. Security. All Room Ensuit. Supermarket Nearby. Fast Internet. Gym. Ocean View. Parking Space. 24 Hours Electricity. Swimming Pool. Pop Ceiling. Children Play Ground. Child Care. Water Treatment. ...",ajah,1,1,0,1,ajah5,3000000.0,3000000.0,3000000.0,3,43,8,3000000
396, lavalon hotel road opp eco bank addo road ajah ado ajah lagos,5,3,2,3,"Brand new 2 bedroom flat all rooms ensuite with POP ceiling spacious rooms with 2 windows each for ventilation, spacious kitchen facing interlocked road inside a gated Estate. ... Serviced. New. All Room Ensuit. Big Compound. Pop Ceiling. 24 Hours Security. Water Treatment. ...",ajah,1,1,0,1,ajah3,900000.0,1000000.0,1000000.0,3,24,4,1000000
397, abijo ajah lagos,11,6,5,6,"5 bedroom duplex wit 2 rooom Bq Green area all rooms en-suite at Mobil estate, emerald estate Ajah Title c of o Price 90 million ... ...",ajah,1,1,1,1,ajah6,4000000.0,4000000.0,4000000.0,4,50,9,5000000
398, unity estate maryland badore ajah badore ajah lagos,2,1,1,1,Miniflat upstairs with 2 toilets spacious sitting room and wardrobe inside the room facing interlocked road inside the Estate. ... Renovated. Security Doors. 24 Hours Security. Water Treatment. ...,ajah,0,0,0,1,ajah1,400000.0,500000.0,450000.0,1,6,1,400000
399," around blenco supermarket before sangotedo, ajah axis lekki. sangotedo ajah lagos",10,5,5,5,"A Newly Built 4 Bedrooms Duplex in a very serene and secure Estate with good roads, clean water and good light around Blenco Supermarket before Sangotedo in Ajah axis Lekki For Rent. ... New. Cheap. Big Compound. Restaurants Nearby. Security Doors. 24 Hours Security. Drainage System. Street Lights. Church Nearby. Security. All Room Ensuit. Supermarket Nearby. Fast Internet. Parking Space. Pop Ceiling. Water Treatment. ...",ajah,1,1,0,1,ajah5,3000000.0,3000000.0,3000000.0,3,43,8,3000000
400, illaje off emerald estate mobil road illaje ajah ilaje ajah lagos,7,4,3,4,"Spacious 4 bedroom Terrace duplex with 2 sitting room, fitted kitchen, water heater bathroom POP ceiling just 4 people in the compound, water treatment plant not far from the interlocked Mobil road. ... Renovated. Big Compound. Security Doors. Pop Ceiling. 24 Hours Security. Water Treatment. ...",ajah,1,1,1,1,ajah4,1200000.0,1500000.0,1300000.0,4,29,5,1500000
401, ajah lagos,6,3,3,3,3 bedroom flat Rent: #1.7m Agency and Legal fees: 10% and Caution fee: #150k Decent building in a secured and clean environment. ... ...,ajah,1,1,1,1,ajah3,900000.0,1000000.0,1000000.0,4,24,4,1700000
402, marshy hill estate akins bustop addo road ajah ado ajah lagos,5,3,2,3,"Brand new 2 bedroom flat all rooms ensuite with POP ceiling, modern kitchen, wardrobe inside an interlocked compound facing interlocked road. Upstairs N950,000.00 Downstairs N900,000.00. ... New. Cheap. All Room Ensuit. Big Compound. Security Doors. Pop Ceiling. 24 Hours Security. Water Treatment. ...",ajah,0,0,0,1,ajah3,900000.0,1000000.0,1000000.0,1,24,4,950000
403, lekki palm city estate ado ajah lagos,8,4,4,4,New and tastefully finished 5units of 4 bedrooms detached houses Lekki Palm City Estate. Each unit is finished with state of the art facilities. The floor is finished with vitrified tiles and ceiling with POP. Sales ... ...,ajah,1,1,1,1,ajah4,1200000.0,1500000.0,1300000.0,4,29,5,2300000
404," united estate, sangotedo, ajah axis, lekki. sangotedo ajah lagos",6,3,3,3,"A Newly Built 2 Bedrooms Flat in a quiet, well guarded and gated area of United Estate with clean water, good light, easy access roads and good road in Sangotedo in Ajah axis Lekki For ... New. Cheap. Big Compound. Restaurants Nearby. Security Doors. 24 Hours Security. Drainage System. Street Lights. Security. All Room Ensuit. Supermarket Nearby. Fast Internet. Parking Space. Pop Ceiling. Water Treatment. ...",ajah,0,0,0,1,ajah3,900000.0,1000000.0,1000000.0,1,24,4,900000
405, harmony estate langbasa rd ajah ado ajah lagos,9,5,4,5,"A 4 bedroom bungalow alone in the compound with Miniflat bq spacious sitting room and dinning, kitchen with store, all rooms ensuite with compound that can park 8 cars with generator house and gate house ... Renovated. Boys Quater. All Room Ensuit. Big Compound. Parking Space. ...",ajah,1,1,0,1,ajah5,3000000.0,3000000.0,3000000.0,3,43,8,3000000
406, berulah estate by addo round about addo ajah ado ajah lagos,5,3,2,3,"Modern Bungalow with masters bedroom ensuite 3 toilets 2 bathrooms, POP ceiling in sitting room, spacious sitting room, spacious dinning, big kitchen and store just 2 people in the compound inside a gated Estate and ... Renovated. Pop Ceiling. ...",ajah,0,0,0,1,ajah3,900000.0,1000000.0,1000000.0,1,24,4,900000
407, seaside estate ajah lagos,6,3,3,3,"For rent: Well finished two-bedrooms in a safe and secure estate with steady light, clean water, prepared meter, close to the gate, wardrobes, quality doors,fitted cabinets,POP finished all round, interlock compound just four people in ... ...",ajah,1,1,0,1,ajah3,900000.0,1000000.0,1000000.0,3,24,4,1000000
408, silverpoint estate badore ajah lagos,5,3,2,3,The property is a newly built and tastefully finished 12 units of 2 bedroom flats located in a gated and secured estate. It is painted both internally and externally with ample parking space. The floor ... Serviced. New. ...,ajah,0,0,0,1,ajah3,900000.0,1000000.0,1000000.0,1,24,4,900000
409," lekki palm city estate, off ado road, ajah, lagos. badore ajah lagos",9,5,4,5,"4bedroom detached house with a room bq at Lekki palm city estate, off ado road, Ajah, Lagos. ... Serviced. New. Boys Quater. Security. All Room Ensuit. Big Compound. Supermarket Nearby. Security Doors. Parking Space. Pop Ceiling. 24 Hours Security. Water Treatment. ...",ajah,1,1,0,1,ajah5,3000000.0,3000000.0,3000000.0,3,43,8,3000000
410," otunla street, lakowe lakowe ajah lagos",5,3,2,3,Newly finished 2bedroom apartment in a good location and quick accessibility to the major road ... Serviced. New. Cheap. Security. All Room Ensuit. Big Compound. Supermarket Nearby. Parking Space. Pop Ceiling. 24 Hours Security. Drainage System. Water Treatment. Church Nearby. ...,ajah,0,0,0,1,ajah3,900000.0,1000000.0,1000000.0,1,24,4,900000
411, lavalon hotel estate opp eco bank addo road ajah ado ajah lagos,7,4,3,4,"Clean and spacious 3 bedroom flat upstairs with bq all rooms ensuite, spacious kitchen, spacious sitting room with 2 windows each inside 2 rooms for proper ventilation, visitors toilet with POP ceiling inside an interlocked ... Cheap. Renovated. All Room Ensuit. Big Compound. Pop Ceiling. 24 Hours Security. Water Treatment. ...",ajah,1,0,0,1,ajah4,1200000.0,1500000.0,1300000.0,2,29,5,1300000
412, ajah lagos,6,3,3,3,"3 bedrooms flat for rent at llasan lekki Ajah, All rooms ensuites. ... ...",ajah,1,1,1,1,ajah3,900000.0,1000000.0,1000000.0,4,24,4,2300000
413, before blenco supermarket in olokonla in ajah axis lekki. olokonla ajah lagos,6,3,3,3,"A Very Cute 3 Bedrooms Flat in seriously guarded, well gated and quiet Estate with good light, clean water and very close to the road before Blenco Supermarket in Olokonla in Ajah axis Lekki For ... New. Cheap. Big Compound. Restaurants Nearby. Security Doors. 24 Hours Security. Drainage System. Street Lights. Church Nearby. Security. All Room Ensuit. Supermarket Nearby. Parking Space. Pop Ceiling. Water Treatment. ...",ajah,0,0,0,1,ajah3,900000.0,1000000.0,1000000.0,1,24,4,900000
414, harmony estate langbasa rd ajah ado ajah lagos,5,3,2,3,"Clean renovated 2 bedroom flat upstairs with all rooms ensuite, spacious kitchen with exit door and staircase behind. Spacious sitting room and small dinning. Prepaid meter. ... Renovated. All Room Ensuit. Big Compound. Water Treatment. ...",ajah,0,0,0,1,ajah3,900000.0,1000000.0,1000000.0,1,24,4,900000
415, mega estate black gate bustop badore ajah badore ajah lagos,7,4,3,4,"Brand new 3 bedroom flat all rooms ensuite with spacious kitchen, spacious sitting room POP ceiling, water heater bathroom, water treatment plant, interlocked compound facing interlocked road inside the estate. ... New. All Room Ensuit. Big Compound. Pop Ceiling. 24 Hours Security. Water Treatment. ...",ajah,1,0,0,1,ajah4,1200000.0,1500000.0,1300000.0,2,29,5,1300000
416, royal garden estate ajah lagos,10,5,5,5, 4 bed fully detached duplex in Royal Garden Estate Ajah ... ...,ajah,1,1,1,1,ajah5,3000000.0,3000000.0,3000000.0,4,43,8,4000000
417, general paint bus stop sangotedo ajah lagos,11,5,6,5,Exclusive houses for RENT ___4bedrooms Terrance duplex ___________________________ ______________________________ â€¢4 Bedrooms â€¢Fully Service â€¢All en-suite bedrooms. â€¢18-24hours power supply daily â€¢24hours security. â€¢Gym â€¢Swimming pool â€¢Clean water supply. â€¢Partly furnished. â€¢Kitchen fully fitted. ______________________________ ______________________________ Location:Ajah _______________________________ _______________________________ LAND MARKS:*General Paint bus-Stop* _________________________________ _________________________________ Rent Price:N2.2million ... Serviced. New. Cheap. Dry. Cctv Cameras. Big Compound. Restaurants Nearby. Security Doors. 24 Hours Security. Drainage System. Street Lights. Jacuzzi. Security. All Room Ensuit. Supermarket Nearby. Parking Space. 24 Hours Electricity. Swimming Pool. Pop Ceiling. Children Play Ground. Child Care. Water Treatment. ...,ajah,1,1,0,1,ajah5,3000000.0,3000000.0,3000000.0,3,43,8,3000000
418, beside lagos business school ajah lagos,7,4,3,4,"Trust me, this is the best apartment for you. Features of the property; Brand new luxury apartment 4 flats in the compound (up and down still available) Enough parking space ( 2 cars per flat) *Person prepaid meter *Osmosis water treatment ... ...",ajah,1,0,0,1,ajah4,1200000.0,1500000.0,1300000.0,2,29,5,1300000
419, gated mobile road opposite llaje bf ajah bridge ilaje ajah lagos,4,2,2,2,"Brand new tastefully built service 2bed room flats on mobile phone opposite llaje bf ajah bridge, the built in a gated estate, 24hrs uniform security and power supply, water heater, gass cooker , water treatment ... ...",ajah,1,1,1,1,ajah2,800000.0,800000.0,800000.0,4,21,4,1200000
420," majek after fara park, after crown estate in ajah axis lekki. crown estate ajah lagos",6,3,3,3,"A Very Cool 2 Bedrooms Flat in a secured and gated street in Majek with easy access to the roads, good light, very close to the express road and clean water after Fara Park and ... Cheap. Renovated. Big Compound. Restaurants Nearby. Security Doors. 24 Hours Security. Drainage System. Street Lights. Church Nearby. Security. All Room Ensuit. Supermarket Nearby. Fast Internet. Parking Space. Pop Ceiling. Water Treatment. ...",ajah,0,0,0,1,ajah3,900000.0,1000000.0,1000000.0,1,24,4,900000
421," majek, opposite fara park, in ajah axis lekki. crown estate ajah lagos",4,2,2,2,"A New Mini Flat in a lovely and secured place in Majek with good light, clean water and easy access to the roads opposite Fara Park in Ajah axis Lekki For Rent. ... New. Cheap. Big Compound. Restaurants Nearby. Security Doors. 24 Hours Security. Drainage System. Street Lights. Church Nearby. Security. All Room Ensuit. Supermarket Nearby. Fast Internet. Parking Space. Pop Ceiling. Water Treatment. ...",ajah,1,1,0,1,ajah2,800000.0,800000.0,800000.0,3,21,4,800000
422," united estate, sangotedo, ajah axis, lekki. sangotedo ajah lagos",4,2,2,2,"A Very New Mini Flat in a decent, secure and gated United Estate with easy access to the express road, close to the gate, clean water, good light and very close to the road in ... New. Cheap. Big Compound. Restaurants Nearby. Security Doors. 24 Hours Security. Drainage System. Street Lights. Security. All Room Ensuit. Supermarket Nearby. Fast Internet. Parking Space. Pop Ceiling. Water Treatment. ...",ajah,1,1,0,1,ajah2,800000.0,800000.0,800000.0,3,21,4,800000
423, ajah lagos,6,3,3,3,3 bedroom flat Rent: #1.6m downstairs Agency and Legal fees: 10% and Caution fee: #150k ... ...,ajah,1,1,1,1,ajah3,900000.0,1000000.0,1000000.0,4,24,4,1600000
424, lekki scheme 2 abraham adesanya ogombo road ajah ogombo ajah lagos,5,3,2,3,"Brand new 2 bedroom flat upstairs and downstairs all rooms ensuite, fitted kitchen, water heater bathroom, POP ceiling inside interlocked compound facing interlocked road. ... New. 24 Hours Security. All Room Ensuit. Pop Ceiling. ...",ajah,1,1,0,1,ajah3,900000.0,1000000.0,1000000.0,3,24,4,1000000
425, westwood estate badore ajah lagos,2,1,1,1," A LUXURY MINI FLAT, (1 BEDROOM FLAT) FOR RENT FEATURES -Sitting Room. - Visitor's Toilet - Ensuite Room -Fitted Kitchen -Clean Water -24Hrs Estate Security -Serena Environment. E.T.C Price : 600K Upstairs Price 500k Downstairs Agency : 50 Legal : 50 ... Pop Ceiling. All Room Ensuit. Big Compound. 24 Hours Security. 24 Hours Electricity. ...",ajah,1,1,1,1,ajah1,400000.0,500000.0,450000.0,4,6,1,600000
426, lekki scheme 2 abraham adesanya ogombo road ajah ilaje ajah lagos,7,4,3,4,"Clean 3 bedroom flat upstairs all rooms ensuite, spacious kitchen, spacious sitting room and big rooms, POP ceiling with just 2 people in the compound facing interlocked road. ... Renovated. Cheap. Big Compound. Pop Ceiling. 24 Hours Security. Security Doors. All Room Ensuit. ...",ajah,1,1,1,1,ajah4,1200000.0,1500000.0,1300000.0,4,29,5,1500000
427, unity estate maryland badore ajah badore ajah lagos,7,4,3,4,Clean 3 bedroom Duplex all rooms ensuite with spacious sitting room and balcony in masters bedroom. The house is close to the interlocked road inside the estate. You have your own prepaid meter. ... Renovated. All Room Ensuit. Security. Big Compound. Water Treatment. Pop Ceiling. ...,ajah,0,0,0,1,ajah4,1200000.0,1500000.0,1300000.0,1,29,5,1200000
428, thera annex sangotedo ajah lagos,5,3,2,3,"Two bedroom apartments Rent 600/650k Caution fee 70k Agency 10 % Legal 10 % Location sangotedo /Thera annex CALL US FOR YOUR DREAM APARTMENTS FOR FURTHER ENQUIRIES, SPECIFIC ARRANGEMENTS FOR PHYSICAL INSPECTION, KINDLY SEND A SCREENSHOT OR THE LUXURY APARTMENT OF INTEREST ... Drainage System. Security. Big Compound. Street Lights. Parking Space. Restaurants Nearby. Supermarket Nearby. Children Play Ground. Church Nearby. Pop Ceiling. ...",ajah,0,0,0,1,ajah3,900000.0,1000000.0,1000000.0,1,24,4,900000
429, blenco sangotedo ajah lagos,7,4,3,4,"Three bedroom apartment Rent 1m Caution fee 100k Agency 10 % Legal 10 % Location sangotedo /blenco CALL US FOR YOUR DREAM APARTMENTS FOR FURTHER ENQUIRIES, SPECIFIC ARRANGEMENTS FOR PHYSICAL INSPECTION, KINDLY SEND A SCREENSHOT OR THE LUXURY APARTMENT OF INTEREST ... Drainage System. Security. Big Compound. Water Treatment. Street Lights. Parking Space. Restaurants Nearby. Supermarket Nearby. ...",ajah,0,0,0,1,ajah4,1200000.0,1500000.0,1300000.0,1,29,5,1200000
430," salvation estate, owode, ajah ado ajah lagos",4,2,2,2,Very clean mini flat in owode. ... Furnished. Dry. Serviced. New. All Room Ensuit. Big Compound. Free Wifi. Mosques Nearby. Supermarket Nearby. Parking Space. Security. Church Nearby. ...,ajah,1,1,0,1,ajah2,800000.0,800000.0,800000.0,3,21,4,800000
431, salvation estate scheme 2 ado ajah lagos,7,4,3,4,Very spacious Newly built 3bedroom bungalow alone in compound with security house in a very beautiful location in Ado. ... Dry. New. Drainage System. Street Lights. Big Compound. Mosques Nearby. Security Doors. Pop Ceiling. Supermarket Nearby. 24 Hours Security. Parking Space. Security. Church Nearby. ...,ajah,0,0,0,1,ajah4,1200000.0,1500000.0,1300000.0,1,29,5,1200000
432," lekki palm city estate, opposite ecobank ado road ajah lagos ado ajah lagos",5,3,2,3,Two bedrooms penthouse apartment available for rent with parking space and state of the art kitchens cupboard & restrooms at lekki palm city estate lavalon hotel road ajah lagos ... Dry. Security Doors. Restaurants Nearby. Pop Ceiling. Parking Space. Security. Big Compound. Street Lights. ...,ajah,1,1,1,1,ajah3,900000.0,1000000.0,1000000.0,4,24,4,1400000
433, cooperative villa badore ajah badore ajah lagos,5,3,2,3,"Nice and Standard 2-bedroom apartment available in a Serene and Secured estate in Cooperative villa badore Ajah Lagos. Features: room with cooking space, Serene and cozy environment; fence and gated compound; good road network; good ... Cheap. Water Treatment. Restaurants Nearby. Supermarket Nearby. 24 Hours Security. Mosques Nearby. Big Compound. Drainage System. ...",ajah,0,0,0,1,ajah3,900000.0,1000000.0,1000000.0,1,24,4,900000
434, new road awoyaya ajah lagos,4,2,2,2,"Mini flat at new road, Awoyaya in a gated and interlock compound POP ceiling, fitted kitchen, wardrobes etc Rent is 300,000, Agency fee is 30,000, Legal fee is 30,000, Caution fee is 30,000 and ... ...",ajah,1,1,0,1,ajah2,800000.0,800000.0,800000.0,3,21,4,800000
435, new road awoyaya ajah lagos,6,3,3,3,"2bedroom apartment at new road, awoyaya in a gated and interlock compound with POP ceiling, fitted kitchen etc Rent is 450,000, Agency fee is 45,000, Legal fee is 45,000 and Caution fee is 45,000. Total ... ...",ajah,0,0,0,1,ajah3,900000.0,1000000.0,1000000.0,1,24,4,900000
436, divine estate okun ajah okun ajah ajah lagos,4,2,2,2,Newly built 2bedroom in a mini estate ... New. Security. Ocean View. Street Lights. Big Compound. C Of O. Governor's Consent. ...,ajah,1,1,0,1,ajah2,800000.0,800000.0,800000.0,3,21,4,850000
437, greenville estate badore ajah lagos,4,2,2,2,Well built 2 bedroom flats for rent at Greenville estate ... New. Security. All Room Ensuit. Cctv Cameras. Restaurants Nearby. 24 Hours Electricity. 24 Hours Security. ...,ajah,1,1,0,1,ajah2,800000.0,800000.0,800000.0,3,21,4,800000
438," madam theresa avenue, maryland estate badore ajah lagos",6,3,3,3,Ground Floor and very quiet and neat compound. ... Dry. Old. 24 Hours Security. Water Treatment. All Room Ensuit. Big Compound. ...,ajah,0,0,0,1,ajah3,900000.0,1000000.0,1000000.0,1,24,4,900000
439," ogunfayo,awoyaya (immediately after mayfair garden estate, awoyaya) awoyaya ajah lagos",4,2,2,2,"Standard 2 Bedroom flat for Rent at Ogunfayo,Awoyaya at N400K per year LOCATION: It's located at Ogunfayo,Awoyaya (immediately after MAYFAIR GARDEN Estate, Awoyaya) RENT: N400,000 per year Agency: N40,000 Agreement: N40,000 Caution Fee: N40,000 IMPORTANT FEATURES -It's a Standard Apartment -Spacious Balcony -Room En-suite -Standard ... ...",ajah,1,1,0,1,ajah2,800000.0,800000.0,800000.0,3,21,4,800000
440," ogunfayo,awoyaya (immediately after mayfair garden estate, awoyaya) awoyaya ajah lagos",2,1,1,1,"Standard Mini flat for Rent at Ogunfayo,Awoyaya at N300K per year LOCATION: It's located at Ogunfayo,Awoyaya (immediately after MAYFAIR GARDEN Estate, Awoyaya) RENT: N300,000 per year Agency: N30,000 Agreement: N30,000 Caution Fee: N30,000 IMPORTANT FEATURES -It's a Standard Apartment -Spacious Balcony -Room En-suite -Standard Kitchen ... ...",ajah,0,0,0,1,ajah1,400000.0,500000.0,450000.0,1,6,1,400000
441, abraham adesanya estate ajah lagos,2,1,1,1,1 bedroom mini flat Mini flat Flat / Apartment for rent Abraham adesanya estate Ajah Lagos ... ...,ajah,1,0,0,1,ajah1,400000.0,500000.0,450000.0,2,6,1,450000
442, sangotedo ajah lagos,2,1,1,1,Miniflat available for rent Rent:500k Agency:70k Legal:30 ... New. Cheap. Dry. Furnished. Security. Big Compound. Security Doors. ...,ajah,1,1,1,1,ajah1,400000.0,500000.0,450000.0,4,6,1,500000
443," awoyaya, ajah lagos",2,1,1,1,Sharp a room and parlour Mini Flat at Awoyaya. Rent: 270k ... ...,ajah,0,0,0,1,ajah1,400000.0,500000.0,450000.0,1,6,1,400000
444, ogadan ajah lagos,5,3,2,3,Features On a tarred road Water heater Gas burner and extractor to be installed Kitchen cabinets POP finishing Too tile finishing Wadrobes Note: the house will be fully ready in two weeks...(someone is already living in one flat) ... ...,ajah,1,1,0,1,ajah3,900000.0,1000000.0,1000000.0,3,24,4,1000000
445," majek town, sangotedo ajah lagos",5,3,2,3,"To let Brandnew 2bedroom flat, all rooms ensuite with visitors toilet At Majek sangotedo Rent 800k Agency fee 80k Agreement fee 80k Caution fee 100k ... ...",ajah,0,0,0,1,ajah3,900000.0,1000000.0,1000000.0,1,24,4,900000
446, alashela ogombo ajah lagos,5,3,2,3,Brand new 2bedroom well finished and all ensuite now available for rent in Alashela area of ogombo....you can also go through thera Annex estate sangotedo... Rent... 550k Legal...55k Agency... 55k Caution deposit.. 50k Total...710k ... ...,ajah,0,0,0,1,ajah3,900000.0,1000000.0,1000000.0,1,24,4,900000
447, liberty bells schools badore ajah lagos,7,4,3,4,"Standard 3 bedrooms apartment in ajah-badore, with all rooms ensuite and spacious parking. There's 24/7 security at the estate gate, and the house is at a walking distance (3min) from badore main road, the compound ... Serviced. Dry. New. Furnished. Restaurants Nearby. Church Nearby. Security Doors. Street Lights. All Room Ensuit. Drainage System. Security. Big Compound. Supermarket Nearby. Parking Space. Pop Ceiling. 24 Hours Security. ...",ajah,0,0,0,1,ajah4,1200000.0,1500000.0,1300000.0,1,29,5,1200000
448," by total filling station, abraham adesanya ajiwe ajah lagos",10,5,5,5,"4 bedroom Detached Duplex House for rent By Total Filling Station, Abraham Adesanya Ajiwe Ajah Lagos ... ...",ajah,1,1,0,1,ajah5,3000000.0,3000000.0,3000000.0,3,43,8,3000000
449, adeba road lakowe ajah lagos,3,2,1,2,Now letting! Mini flats apartments to let at Adeba Lakowe Ibeju-Lekki Lagos. 1 bedroom 1 bathroom 2 toilet. Rent: ?270k for ?250k respectively. Call now: [redacted] ... New. ...,ajah,1,1,0,1,ajah2,800000.0,800000.0,800000.0,3,21,4,800000
450, liberty bells school badore ajah lagos,7,4,3,4,"Exquisite 3 bedrooms apartment with all rooms ensuite and balconies; Pop ceilings, quality tiling, water heaters , kitchen cabinets and wardrobes. The compound is fully interlocked and there is security at the gate , as ... Serviced. Dry. Renovated. Furnished. Restaurants Nearby. Church Nearby. Security Doors. Street Lights. Drainage System. Security. Big Compound. Supermarket Nearby. Parking Space. Pop Ceiling. 24 Hours Security. ...",ajah,0,0,0,1,ajah4,1200000.0,1500000.0,1300000.0,1,29,5,1200000
451, cooperative estate badore ajah lagos,8,4,4,4,Room self contained shared apartment at unity estate in cooperative estate ajah ... Dry. New. Supermarket Nearby. Restaurants Nearby. Child Care. Governor's Consent. Security Doors. All Room Ensuit. Fast Internet. Mosques Nearby. Security. Big Compound. Church Nearby. Street Lights. 24 Hours Electricity. Drainage System. Parking Space. Pop Ceiling. 24 Hours Security. ...,ajah,0,0,0,1,ajah4,1200000.0,1500000.0,1300000.0,1,29,5,1200000
452," 15 isah omale street, glorious estate badore ajah lagos",5,3,2,3,"Stoikmusah@gmail.com. 2 bedroom flat to let at 14 Isah Omale Street , Glorious estate badore all round tiles all rooms ensuite with Glass Shower cubicle. interlock compound fitted kitchen with cabinet functioning borehole with water ... Serviced. New. Security. Big Compound. All Room Ensuit. Water Treatment. ...",ajah,0,0,0,1,ajah3,900000.0,1000000.0,1000000.0,1,24,4,900000
453, adenike olotu street ilaje ajah lagos,10,5,5,5,"Tastefully Designed Fully Ensuite Bedroom Flat at Ilaje (Shared Apartment) Off Mobil road (3rd Junction after Emerald Estate Junction) Close to Ilaje bus stop All rooms are Upstairs except the BQ Total package is N450,000 per a Room No Agent ... New. Renovated. Cheap. Furnished. Dry. Big Compound. Church Nearby. All Room Ensuit. Parking Space. Ocean View. Street Lights. Boys Quater. Restaurants Nearby. Security Doors. Water Treatment. Children Play Ground. 24 Hours Security. Supermarket Nearby. Security. Pop Ceiling. ...",ajah,1,1,0,1,ajah5,3000000.0,3000000.0,3000000.0,3,43,8,3000000
454, greenville estate badore addo road ajah lagos badore ajah lagos,5,3,2,3,"The apartment is a tastefully finished 2 bedroom apartment located in Greenville Estate, Badore a gated estate and serene neighborhood. It is a relatively new house, painted both internally & externally. Ceiling, floor, compound area ... ...",ajah,0,0,0,1,ajah3,900000.0,1000000.0,1000000.0,1,24,4,900000
455," silverland estate, sangotedo ajah lagos",2,1,1,1,Super neat and clean room self contain to let in a good and secured estate at sangotedo ajah lekki ... ...,ajah,0,0,0,1,ajah1,400000.0,500000.0,450000.0,1,6,1,400000
456, adeniki olotu street ilajie ajah ilaje ajah lagos,10,5,5,5,"a shared tastefully designed modern apartment.the room is large,ensuite,comes with a balcony ,wardrobe,and upstairs.Adequate electricity,24/7 clean water.no agency and caution needed,100 percent security.call the number [redacted] ... New. Furnished. All Room Ensuit. Parking Space. Security. Pop Ceiling. 24 Hours Security. Water Treatment. ...",ajah,1,1,0,1,ajah5,3000000.0,3000000.0,3000000.0,3,43,8,3000000
457, seaside estate badore ajah lagos,2,1,1,1,Nicely finished shared apartment for rent All rooms ensuite with private bathroom... Pop ceiling Spacious room ... Renovated. 24 Hours Security. All Room Ensuit. Big Compound. ...,ajah,0,0,0,1,ajah1,400000.0,500000.0,450000.0,1,6,1,400000
458," 20 ganiyu ikotun street, marshy hill estate ajah okun ajah ajah lagos",4,2,2,2,A 2 bedroom flat for rent ... Dry. Serviced. Renovated. Security. 24 Hours Electricity. 24 Hours Security. ...,ajah,1,1,0,1,ajah2,800000.0,800000.0,800000.0,3,21,4,800000
459, okera-nla lekki ajah lagos ado ajah lagos,2,1,1,1,Newly Renovated Mini Flat ... Dry. Renovated. 24 Hours Electricity. Church Nearby. Fast Internet. 24 Hours Security. Street Lights. Water Treatment. ...,ajah,0,0,0,1,ajah1,400000.0,500000.0,450000.0,1,6,1,400000
460, - graceland estate ajah lagos,2,1,1,1,A clean spacious room self contained 450k rent in Graceland estate ... Security. Big Compound. Water Treatment. ...,ajah,1,0,0,1,ajah1,400000.0,500000.0,450000.0,2,6,1,450000
461, olokonla olokonla ajah lagos,7,4,3,4,FEATURES POP finishing with LED Lighting Heat Extractor In kitchen Water heater Kitchen cabinets Wadrobes Very spacious Sitting room In a very Secured Estate ... ...,ajah,1,1,1,1,ajah4,1200000.0,1500000.0,1300000.0,4,29,5,1500000
462, first unity estate cooperative villa badore addo badore ajah lagos,6,3,3,3,Brandnew 3 bedroom flat available at first unity estate cooperative villa badore addo road ajah lagos Rent 900k ... ...,ajah,0,0,0,1,ajah3,900000.0,1000000.0,1000000.0,1,24,4,900000
463, ado road ado ajah lagos,2,1,1,1,Good proximity All round tiles Neat Environment Treated water Spacious compound ... ...,ajah,1,1,1,1,ajah1,400000.0,500000.0,450000.0,4,6,1,500000
464, prince leye close ado ajah lagos,4,2,2,2,"2 bedroom apartment by Nipco filling station along Addo Road - 530,000 ... Supermarket Nearby. Parking Space. ...",ajah,1,1,0,1,ajah2,800000.0,800000.0,800000.0,3,21,4,800000
465, sangotedo sangotedo ajah lagos,11,6,5,6,5 bedroom detached duplex for rent in a gated estate in Sangotedo. Very spacious. Boy's quarter. Rent: 3 million naira. ... ...,ajah,1,1,0,1,ajah6,4000000.0,4000000.0,4000000.0,3,50,9,4000000
466, sangotedo sangotedo ajah lagos,9,5,4,5,Brand new 4 bedroom duplex for rent in an estate in Sangotedo. Spacious rooms and compound. Fitted kitchen. Rent: 1.8 million naira. ... ...,ajah,1,1,0,1,ajah5,3000000.0,3000000.0,3000000.0,3,43,8,3000000
467, mobil road ilaje ajah lagos,5,3,2,3,. ... ...,ajah,1,1,0,1,ajah3,900000.0,1000000.0,1000000.0,3,24,4,1000000
468," penisula garden estate, few houses away from police post peninsula estate ajah lagos",10,5,5,5,"Newly and Tastefully finished four (4) bedroom terrace - two story building in a secured and serene neighbourhood (Peninsula Garden Estate) behind Blenco super market, Ajah-Sangotedo, Lagos ... New. 24 Hours Security. Security. Big Compound. Security Doors. Pop Ceiling. All Room Ensuit. Water Treatment. ...",ajah,1,1,0,1,ajah5,3000000.0,3000000.0,3000000.0,3,43,8,3000000
469, sangotedo sangotedo ajah lagos,7,4,3,4,"A well built Three(3 )Bedroom flats (downstairs) in a secured Goodnews estate at Sangotedo, Ajah, Lagos. The features are: Solar system (green house) for 24-hours electricity supply from the sun Air conditioners in all rooms, parlor, dining ... ...",ajah,0,0,0,1,ajah4,1200000.0,1500000.0,1300000.0,1,29,5,1200000
470," agungi, ajah lagos",2,1,1,1,*A Spacious Mini Flat to let* *Location*: Agungi. *Rent*: 1m upstairs *Service Charge*: 400k per year *Agency fee*: 10% *Legal*: 10% *Total Package:* 1.6M Features: - Gated Estate - AC - Fitted Kitchen - Treated water Pay and pack in. ... ...,ajah,1,1,1,1,ajah1,400000.0,500000.0,450000.0,4,6,1,1000000
471, peninsula gardens estate sangotedo ajah lagos,6,3,3,3,"Lovely And Nicely Situated 4 Bedrooms Fully Detached Duplex For Rent In Peninsula Gardens Estate By Blenco Supermarket, Sangotedo, Ajah. Rent Is 2M Per Annum, Total Is 2.5M ... ...",ajah,1,1,1,1,ajah3,900000.0,1000000.0,1000000.0,4,24,4,2000000
472, awoyaya ajah lagos,8,4,4,4,"House is fully detached, pay and pack in, 4 bedroom duplex, with a self contained in front that can be used as bq, house is in a very good location in Ajah. Note- Property is pay ... Dry. Cheap. Boys Quater. Security. Pop Ceiling. Church Nearby. Big Compound. Children Play Ground. ...",ajah,1,1,1,1,ajah4,1200000.0,1500000.0,1300000.0,4,29,5,2000000
473, divine homesl thomas estate ajah lagos,10,5,5,5,Just completed 6 bedroom duplex with very spacious compound ... New. Big Compound. Pop Ceiling. Parking Space. All Room Ensuit. ...,ajah,1,1,0,1,ajah5,3000000.0,3000000.0,3000000.0,3,43,8,3000000
474, keji olajide street majek sangotedo ajah lagos,7,4,3,4,"Specious 3 Bedroom flat apartment for rent at Majek, Sangotedo, Ajah. the Apartment is en-suit, having visitor's toilet, wardrobes, fitted kitchen wardrobes, balcony, security door, POP ceiling etc.. in a gated and interlocked compound. The ... Serviced. Cheap. New. Furnished. Pop Ceiling. 24 Hours Security. Security. 24 Hours Electricity. Street Lights. Restaurants Nearby. Big Compound. Supermarket Nearby. Security Doors. Parking Space. Fast Internet. All Room Ensuit. Church Nearby. ...",ajah,0,0,0,1,ajah4,1200000.0,1500000.0,1300000.0,1,29,5,1200000
475," keji olajide street, majek sangotedo ajah lagos",5,3,2,3,"Specious 2 Bedroom flat apartment for rent at Majek, Sangotedo, Ajah. the Apartment is en-suit, having visitor's toilet, wardrobes, fitted kitchen wardrobes, balcony, security door, POP ceiling etc.. in a gated and interlocked compound. The ... Serviced. Cheap. New. Furnished. Pop Ceiling. 24 Hours Security. Security. 24 Hours Electricity. Street Lights. Restaurants Nearby. Big Compound. Front Desk Service. Supermarket Nearby. Security Doors. Parking Space. Fast Internet. Water Treatment. All Room Ensuit. Church Nearby. ...",ajah,0,0,0,1,ajah3,900000.0,1000000.0,1000000.0,1,24,4,900000
476, 23 james wood street ajah lagos,6,3,3,3,"Brand new luxurious 2bedroom furnished apartment for rent in homeland estate LBS Ajah lekki, the house come kitchen cabinets and wardrobes in all the rooms, water heater in all the bathrooms, stable power supply, nice ... Dry. New. Furnished. Pop Ceiling. Big Compound. 24 Hours Security. Restaurants Nearby. All Room Ensuit. Fast Internet. Security. Street Lights. Water Treatment. Drainage System. Security Doors. ...",ajah,1,1,1,1,ajah3,900000.0,1000000.0,1000000.0,4,24,4,2300000
477, ajah lekki gardens estate ajah lagos,10,5,5,5,"Very clean, conducive ... New. Cheap. Dry. Supermarket Nearby. Drainage System. Pop Ceiling. Water Treatment. Street Lights. Restaurants Nearby. 24 Hours Electricity. Child Care. Security Doors. Big Compound. Cctv Cameras. Security. Free Wifi. All Room Ensuit. Front Desk Service. 24 Hours Security. Free Coffee. Fast Internet. Church Nearby. Jacuzzi. Parking Space. ...",ajah,1,1,1,1,ajah5,3000000.0,3000000.0,3000000.0,4,43,8,5000000
478," abijo gra, ajah lagos abijo ajah lagos",15,8,7,8,"Abijo gra, Lekki A fantastically built 7 bedroom fully detached house having all room ensuite, a room bq and an open terrace for sit out.... Location: Abijo gra , Lekki , Lagos Rent : #2.5m per annum Note: Ideal ... Dry. Furnished. Parking Space. Water Treatment. Big Compound. All Room Ensuit. 24 Hours Security. Security. ...",ajah,1,1,0,1,ajah8,5500000.0,5500000.0,5500000.0,3,54,10,5500000
479, university view estate opposite lagos business school off lekki epe expressway ajah lagos,2,1,1,1,"Tastefully furnished 1 Bedroom Mini Flat for Rent at University View Estate Opp Lagos Business School, AJAH. Rent : 500k Agency: 50k Legal: 50k Caution deposit: 50k Service charge: 50k Total: 700k ... ...",ajah,1,1,1,1,ajah1,400000.0,500000.0,450000.0,4,6,1,500000
480, .... ikate lekki lagos,7,4,3,4,"It's a lovely 3 Bedroom flat ( only the ground floor is available) for rent in a serene area with good access roads in Ikate Elegushi Lekki Lagos. Renovated, All Room En suit, Water Treatment, ... Renovated. Big Compound. All Room Ensuit. Parking Space. Pop Ceiling. Water Treatment. ...",lekki,0,0,0,1,lekki4,2500000.0,3500000.0,3000000.0,1,39,7,2500000
481,  lekki phase 1 lekki lagos,7,4,3,4," For more information, pricing and private viewings, please contact: ?Freke: 09062511345 ?Daniel: 09093272547 Or send us a DM on Instagram @cwrelagos Twitter: @cwrelagos Facebook: @cwrelagos Email : hello@cwlagos.com Website: www.cwlagos.com ... Serviced. Big Compound. 24 Hours Electricity. All Room Ensuit. 24 Hours Security. C Of O. ...",lekki,1,1,1,1,lekki4,2500000.0,3500000.0,3000000.0,4,39,7,3500000
482,  ologolo lekki lagos,7,4,3,4," For more information, pricing and private viewings, please contact: ?Freke: 09062511345 ?Daniel: 09093272547 Or send us a DM on Instagram @cwrelagos Twitter: @cwrelagos Facebook: @cwrelagos Email : hello@cwlagos.com Website: www.cwlagos.com ... New. Big Compound. 24 Hours Electricity. All Room Ensuit. 24 Hours Security. ...",lekki,0,0,0,1,lekki4,2500000.0,3500000.0,3000000.0,1,39,7,2500000
483,  lekki phase 1 lekki lagos,9,5,4,5," This Luxurious house comes with a Service Charge of 1.5m, Diesel 750k caution 300k agency 10% legal 5% For more information, pricing and private viewings, please contact Adeyemi: 09093272572 Daniel: 09093272547 Or ... ...",lekki,1,1,1,1,lekki5,3500000.0,5000000.0,4000000.0,4,48,9,5500000
484,  ikate elegushi lekki ikate lekki lagos,9,5,4,5,"Its a lovely Terrace located in a well secure court in Ikate Elegushi Lekki Lagos. Renovated, All Room En suit, CCTV Camera, Water Treatment, Serviced without 24 hours light, Within an Estate. ... Renovated. Serviced. 24 Hours Electricity. All Room Ensuit. Parking Space. Pop Ceiling. Cctv Cameras. Security Doors. Water Treatment. Boys Quater. ...",lekki,1,0,0,1,lekki5,3500000.0,5000000.0,4000000.0,2,48,9,4000000
485,  lekki phase 1 lekki lagos,7,4,3,4,3 bedroom Flat / Apartment for rent Lekki Phase 1 Lekki Lagos ... New. Street Lights. Big Compound. 24 Hours Electricity. All Room Ensuit. Parking Space. 24 Hours Security. Security Doors. Water Treatment. Swimming Pool. ...,lekki,1,1,1,1,lekki4,2500000.0,3500000.0,3000000.0,4,39,7,4300000
486,  osapa london lekki lagos,7,4,3,4," For more information, pricing and private viewings, please contact: ? Adeyemi: 09093272572 ?Freke: 09062511345 ?Daniel: 09093272547 Or send us a DM on Instagram @cwrelagos Twitter: @cwrelagos Facebook: @cwrelagos Email : hello@cwlagos.com Website: www.cwlagos.com ... ...",lekki,0,0,0,0,lekki4,2500000.0,3500000.0,3000000.0,0,39,7,2300000
487,  ikota lekki lagos,9,5,4,5,4 bedroom Semi Detached Duplex House for rent Ikota Lekki Lagos ... ...,lekki,0,0,0,1,lekki5,3500000.0,5000000.0,4000000.0,1,48,9,3500000
488, ikate lekki lagos,7,4,3,4," For more information, pricing and private viewings, please contact: ?Freke: [redacted] ?Daniel: [redacted] Or send us a DM on Instagram @cwrelagos Twitter: @cwrelagos Facebook: @cwrelagos Email : [redacted] Website: www.cwlagos.com ... ...",lekki,0,0,0,0,lekki4,2500000.0,3500000.0,3000000.0,0,39,7,2000000
489,  lekki phase 1 lekki lagos,7,4,3,4,3 bedroom Flat / Apartment for rent Lekki Phase 1 Lekki Lagos ... Street Lights. Big Compound. 24 Hours Electricity. All Room Ensuit. Parking Space. Drainage System. 24 Hours Security. Security Doors. Restaurants Nearby. ...,lekki,1,1,1,1,lekki4,2500000.0,3500000.0,3000000.0,4,39,7,4000000
490,  lekki phase 1 lekki lagos,7,4,3,4," For more information, pricing and private viewings, please contact: ? Adeyemi: 09093272572 ?Freke: 09062511345 ?Daniel: 09093272547 Or send us a DM on Instagram @cwrelagos Twitter: @cwrelagos Facebook: @cwrelagos Email : hello@cwlagos.com Website: www.cwlagos.com ... ...",lekki,0,0,0,1,lekki4,2500000.0,3500000.0,3000000.0,1,39,7,2500000
491,  ikota lekki lagos,5,3,2,3,"Its a fully serviced apartment with air conditioners and a fully equipped kitchen. Rent 1.6 Million Naira, Service fee inclusive of diesel 650,000 Naira, Agency 10%, Legal 10% and Caution 150,000 Naira. ... Dry. New. Serviced. Big Compound. Supermarket Nearby. All Room Ensuit. Parking Space. Pop Ceiling. Drainage System. Security Doors. Water Treatment. Security. ...",lekki,0,0,0,0,lekki3,2000000.0,2500000.0,2500000.0,0,38,7,1600000
492,  ikota villa estate lekki phase 2 lekki lagos,11,6,5,6,"FOR RENT: Brand New Superbly Finished 4 Bedroom Semi-Detached House at Westend Estate, Lekki, Lagos. FEATURES â€¢ All Rooms Ensuite â€¢ Fantastic Location: Close to Chevron Headquarter â€¢ Corner Piece Available â€¢ In-house speakers â€¢ Modern, top-notch quality fittings/ fixtures â€¢ CCTV ... New. All Room Ensuit. Parking Space. Pop Ceiling. Cctv Cameras. Security Doors. Boys Quater. Security. ...",lekki,0,0,0,0,lekki6,5500000.0,6200000.0,6200000.0,0,54,10,4700000
493, lekki phase 1 lekki lagos,8,4,4,4," For more information, pricing and private viewings, please contact: ?Freke: 09062511345 ?Daniel: 09093272547 Or send us a DM on Instagram @cwrelagos Twitter: @cwrelagos Facebook: @cwrelagos Email : hello@cwlagos.com Website: www.cwlagos.com ... ...",lekki,0,0,0,1,lekki4,2500000.0,3500000.0,3000000.0,1,39,7,2800000
494,  kajola estate ibeju lekki lagos,7,4,3,4,"Very Spacious And Superbly Finished Three (3) Bedroom Flat at Kajola Estate, Ibeju-Lekki, Lagos. OTHER FEATURES: - Fully fenced and gated - Very serene and secured area - Upper floor available - En suite master bedroom with guests' toilet - Sizable ... ...",lekki,0,0,0,0,lekki4,2500000.0,3500000.0,3000000.0,0,39,7,2000000
495,  lekki phase 1 lekki lagos,7,4,3,4,"Fully serviced 3 bedroom apartment for rent in Lekki Phase 1 with large living spaces and fully functional kichen and baths Price Guide: N4.5M For more information, pricing and private viewings, please contact: Adeyemi: 09093272572 ... ...",lekki,1,1,1,1,lekki4,2500000.0,3500000.0,3000000.0,4,39,7,4300000
496,  lekki phase 1 lekki lagos,7,4,3,4,"For more information, pricing and private viewings, please contact: ? Adeyemi: 09093272572 ?Freke: 09062511345 ?Daniel: 09093272547 Or send us a DM on Instagram @cwrelagos Twitter: @cwrelagos Facebook: @cwrelagos Email : hello@cwlagos.com Website: www.cwlagos.com ... ...",lekki,1,1,1,1,lekki4,2500000.0,3500000.0,3000000.0,4,39,7,4300000
497, osapa london lekki lagos,5,3,2,3,Newly Built 2 Bedroom Flat In A Very Good Environment And good Security Network ... New. Big Compound. 24 Hours Electricity. Supermarket Nearby. All Room Ensuit. Parking Space. Fast Internet. 24 Hours Security. Restaurants Nearby. Security. Street Lights. Pop Ceiling. Church Nearby. Jacuzzi. Security Doors. Water Treatment. ...,lekki,1,1,0,1,lekki3,2000000.0,2500000.0,2500000.0,3,38,7,2500000
498,  lekki phase 1 lekki lagos,7,4,3,4,"Partly-serviced 3 bedroom apartment for rent in Lekki Phase 1 with large living spaces and fully functional kichen and baths (You are allowed to use your personal Gen) Price Guide: N3.5M?Service Charge: N400K ?????????? For more information, ... New. Big Compound. All Room Ensuit. ...",lekki,1,1,1,1,lekki4,2500000.0,3500000.0,3000000.0,4,39,7,3500000
499,  lekki phase 1 lekki lagos,7,4,3,4,3 bedroom Flat / Apartment for rent Lekki Phase 1 Lekki Lagos ... ...,lekki,1,1,1,1,lekki4,2500000.0,3500000.0,3000000.0,4,39,7,4300000
500,  westend estate ikota lekki lagos,13,7,6,7,"FOR RENT: Massive 5 Bedroom Detached Duplex at Ikota Villa Estate, Lekki, Lagos. FEATURES â€¢ All Rooms Ensuite â€¢ Anteroom â€¢ 2 Large sitting area (Ground and first floor) â€¢ Fantastic Location: Close to 2nd toll gate â€¢ Prepaid Metre â€¢ Modern, ... Big Compound. All Room Ensuit. Parking Space. Pop Ceiling. Drainage System. 24 Hours Security. Jacuzzi. Cctv Cameras. Security Doors. Boys Quater. Security. ...",lekki,0,0,0,0,lekki7,6000000.0,6800000.0,6529999.999999999,0,56,10,5500000
501,  ikota lekki lagos,7,4,3,4," For more information, pricing and private viewings, please contact: ? Adeyemi: 09093272572 ?Freke: 09062511345 ?Daniel: 09093272547 Or send us a DM on Instagram @cwrelagos Twitter: @cwrelagos Facebook: @cwrelagos Email : hello@cwlagos.com Website: www.cwlagos.com ... ...",lekki,0,0,0,1,lekki4,2500000.0,3500000.0,3000000.0,1,39,7,2600000
502, lekki phase 1 lekki lagos,11,6,5,6, ?Freke: 09062511345 ?Daniel: 09093272547 Or send us a DM on Instagram @cwrelagos Twitter: @cwrelagos Facebook: @cwrelagos Email : hello@cwlagos.com Website: www.cwlagos.com ... ...,lekki,0,0,0,0,lekki6,5500000.0,6200000.0,6200000.0,0,54,10,4700000
503,  lekki phase 1 lekki lagos,11,6,5,6,Lovely 5 bedroom detached duplex with 2 bqs for rent Location??Lekki Phase 1 Price: N15 Million Features: Siting room â€¢ Spacious. â€¢ LED Chandelier. â€¢ Spanish Porcelain Tiles. â€¢ Central Entertainment Sound System. â€¢ Two A/Cs Masters bedroom: This has got to be the cruise ... New. Boys Quater. Swimming Pool. Pop Ceiling. All Room Ensuit. Water Treatment. Gym. Parking Space. ...,lekki,1,1,0,1,lekki6,5500000.0,6200000.0,6200000.0,3,54,10,6200000
504,  osapa lekki phase 1 lekki lagos,7,4,3,4,"Serviced 3 Bedroom Flat at Osapa, Lekki For rent at N2.3m SC at N350 ... Serviced. Cheap. Dry. Big Compound. Pop Ceiling. Security. All Room Ensuit. Parking Space. ...",lekki,0,0,0,0,lekki4,2500000.0,3500000.0,3000000.0,0,39,7,2300000
505,  lekki phase 1 lekki lagos,5,3,2,3,Fully Serviced 2 Bedroom Flat within Lekki Phase 1 For rent at N2.4m SC at N1.2m ... Serviced. Dry. Swimming Pool. Big Compound. Pop Ceiling. Security. All Room Ensuit. Parking Space. Water Treatment. Security Doors. ...,lekki,0,0,0,1,lekki3,2000000.0,2500000.0,2500000.0,1,38,7,2400000
506,"  lakowe gulf resort eatate, sixk tiger close ibeju lekki lagos",8,4,4,4,Ground floor 3 bedroom flat with 1 room Bq at lakowe gulf resort estate ... Serviced. Dry. New. Street Lights. Swimming Pool. Water Treatment. Drainage System. 24 Hours Security. Church Nearby. Big Compound. Pop Ceiling. Children Play Ground. All Room Ensuit. Cctv Cameras. 24 Hours Electricity. Supermarket Nearby. Security Doors. ...,lekki,1,0,0,1,lekki4,2500000.0,3500000.0,3000000.0,2,39,7,3000000
507,"  6, abimbola owodunni close, seaside estate, off badore road, ajah, lekki, lagos. badore ajah lagos",7,4,3,4,"Ground floor flat in a block of six flats of 3 bedroom each, there is water and power available services include security and cleaning of common area. Itâ€™s a plug and play apartment. ... Serviced. New. Big Compound. Pop Ceiling. All Room Ensuit. Parking Space. Water Treatment. ...",lekki,0,0,0,0,lekki4,2500000.0,3500000.0,3000000.0,0,39,7,2000000
508,  alpha beach road igbo efon lekki lagos,7,4,3,4," Consists of A Block of 6 units of premium and exquisitely finished 3 bedroom (Maisonettes with BQ and Apartments) and ample parking space. Located in Atlantic View Estate (before Chevron), Lekki. Service charge - N600,000 Agency ... New. Big Compound. Pop Ceiling. Security. All Room Ensuit. Parking Space. Ocean View. Water Treatment. Security Doors. Governor's Consent. ...",lekki,0,0,0,1,lekki4,2500000.0,3500000.0,3000000.0,1,39,7,2700000
509,  igbo efon lekki lagos,7,4,3,4,"3 Bedroom Flat with BQ at Igbo-efon, Lekki For rent at N1.3m Caution at N80k ... Renovated. Cheap. Dry. Big Compound. Security. All Room Ensuit. Parking Space. Boys Quater. ...",lekki,0,0,0,0,lekki4,2500000.0,3500000.0,3000000.0,0,39,7,2000000
510,  oral estate lekki lagos,11,6,5,6,5 bedroom detached duplex for rent Location: Oral Estate Lekki Lagos?????? Price: 4.5m/p.a Features: - All Rooms Ensuite - New - CCTV Cameras - Fitted Kitchen - Security - Fitted Air Conditioners - 24hrs Security ... New. Street Lights. Big Compound. Pop Ceiling. Security. All Room Ensuit. Cctv Cameras. Parking Space. Jacuzzi. Boys Quater. Governor's Consent. Drainage System. ...,lekki,0,0,0,0,lekki6,5500000.0,6200000.0,6200000.0,0,54,10,4700000
511,  chevron lekki lagos,11,6,5,6,"5 Bedroom Semi Detached Duplex within Chevy View, Chevron, Lekki For Rent at N3.8m ... Cheap. Dry. New. Street Lights. Big Compound. Pop Ceiling. Security. All Room Ensuit. Parking Space. Jacuzzi. Water Treatment. Security Doors. 24 Hours Security. ...",lekki,0,0,0,0,lekki6,5500000.0,6200000.0,6200000.0,0,54,10,4700000
512," u3 estate, akinleye street lekki phase 1 lekki lagos",9,5,4,5,Furnished 4 bedroom wing of duplex and 2 room Bq. Property comes with standby generator and solar power as alternate power at the corner piece plot of U3 estate adjacent petrocam filling station by Lekki ... Furnished. Dry. Big Compound. All Room Ensuit. Cctv Cameras. 24 Hours Electricity. Gym. Boys Quater. 24 Hours Security. ...,lekki,1,1,1,1,lekki5,3500000.0,5000000.0,4000000.0,4,48,9,5600000
513,  lekki phase 1 lekki lagos,7,4,3,4,Self Serviced 3 Bedroom Flat within Lekki Phase 1 For rent at N2.5m ... Cheap. Dry. Big Compound. Security. All Room Ensuit. ...,lekki,0,0,0,1,lekki4,2500000.0,3500000.0,3000000.0,1,39,7,2500000
514,  lekki phase 1 lekki lagos,5,3,2,3,Serviced 2 Bedroom Flat within Lekki Phase 1 For rent at N2.5m SC at N1m ... Serviced. Dry. Big Compound. Security. All Room Ensuit. Parking Space. Water Treatment. ...,lekki,1,1,0,1,lekki3,2000000.0,2500000.0,2500000.0,3,38,7,2500000
515,  lekki phase 1 lekki lagos,5,3,2,3,Well Finished serviced 2 bedroom flat . Rent is 2.5m per annum service charge is 400k exclusive of power diesel contribution is 35k monthly ... Serviced. Cheap. Dry. C Of O. Street Lights. Swimming Pool. Big Compound. Security. All Room Ensuit. Supermarket Nearby. Water Treatment. Security Doors. Survey. 24 Hours Security. ...,lekki,1,1,0,1,lekki3,2000000.0,2500000.0,2500000.0,3,38,7,2500000
516,  babatunde anjouse lekki phase 1 lekki lagos,9,5,4,5,Well finished 4 bedroom bedroom terrace with a room servant quarter. Features include; 24/7 security guards Ample parking space Portable water Security post Fitted kitchen Generator house All rooms ensuite Anti room Guest toilet 2 living areas On 3 floors Each unit ... Renovated. C Of O. Big Compound. Security. All Room Ensuit. Parking Space. Supermarket Nearby. Water Treatment. Security Doors. Boys Quater. 24 Hours Security. Church Nearby. ...,lekki,1,1,1,1,lekki5,3500000.0,5000000.0,4000000.0,4,48,9,5000000
517,  chevron lekki lagos,9,5,4,5,NEW LISTING???? 4 bedroom terrace duplex for sale Location: Chevron Lekki Lagos?????? Price: 45m Features: - All Rooms Ensuite - New - Interlocking - Pop Cieling - CCTV Cameras - Fitted Kitchen - Security - Serviced Estate - 24hrs Electricity ... Serviced. New. Pop Ceiling. Security. All Room Ensuit. Cctv Cameras. Parking Space. 24 Hours Electricity. Water Treatment. Governor's Consent. ...,lekki,0,0,0,1,lekki5,3500000.0,5000000.0,4000000.0,1,48,9,3500000
518,  chevron lekki lagos,9,5,4,5,"Superbly finished , nicely tiled floor Quality Interior with an accessible road network, DRAINAGE NETWORK adequate bedroom and sitting room sizes. located in a very serene environment Adorned with top-notch finishing ... New. Big Compound. 24 Hours Electricity. All Room Ensuit. 24 Hours Security. ...",lekki,1,0,0,1,lekki5,3500000.0,5000000.0,4000000.0,2,48,9,4000000
519,  osapa london lekki lagos,7,4,3,4,"Neatly finished self serviced 3 bedroom flat with a room Location: Osapa. Features: *Large rooms and living spaces *Marked parking lots *A room boys quarters *Good road *Clean water *Security Rent: N3,000,000.00 Caution fee: N200,000.00 Kindly contact Chidi on +234 808 216 ... New. All Room Ensuit. Parking Space. Pop Ceiling. ...",lekki,1,0,0,1,lekki4,2500000.0,3500000.0,3000000.0,2,39,7,3000000
520,  osapa london lekki lagos,9,5,4,5,"Rent 4million, Caution 400k, Agency 10%, Legal 10%. ... Dry. New. Street Lights. All Room Ensuit. Parking Space. Pop Ceiling. Drainage System. Jacuzzi. Security Doors. Boys Quater. Security. ...",lekki,1,0,0,1,lekki5,3500000.0,5000000.0,4000000.0,2,48,9,4000000
521,  lekki right oniru lekki lagos,3,2,1,2,"Serviced Mini flat. Price: 1.7 million per year. Service charge: 400k Features: It's located at an easily accessible place,it has 24 hours light and 24hours security. Has ample space,well finished with key card for each room Kindly ... 24 Hours Electricity. All Room Ensuit. Parking Space. Pop Ceiling. 24 Hours Security. ...",lekki,1,0,0,1,lekki2,1500000.0,2000000.0,1700000.0,2,34,6,1700000
522,  ikota lekki lagos,7,4,3,4,"3 Bedroom En-suite Terrace House with Bq Location: Westend Estate in Ikota Villa Estate Price: Rent at 2m, agency 10% and legal 5%. Direct instruction Features: All rooms en-suite, fitted kitchen, serene and secured environment, ample ... All Room Ensuit. Parking Space. Pop Ceiling. Boys Quater. ...",lekki,0,0,0,0,lekki4,2500000.0,3500000.0,3000000.0,0,39,7,2000000
523,  lekki phase 1 lekki lagos,7,4,3,4,"Service charge 950,000, Caution 200,000, agency 500,000, Legal 250,000. ... Dry. New. Serviced. Elevator. Big Compound. 24 Hours Electricity. Supermarket Nearby. All Room Ensuit. Parking Space. Fast Internet. Drainage System. 24 Hours Security. Restaurants Nearby. Mosques Nearby. Security. Swimming Pool. Street Lights. Pop Ceiling. Church Nearby. Jacuzzi. Security Doors. Water Treatment. Boys Quater. ...",lekki,1,1,1,1,lekki4,2500000.0,3500000.0,3000000.0,4,39,7,4300000
524,  osapa london lekki lagos,9,5,4,5,"Rent 4million, Caution 100k, Agency 10%, Legal 5%. ... New. Supermarket Nearby. All Room Ensuit. Parking Space. Pop Ceiling. Security Doors. Water Treatment. Boys Quater. Security. ...",lekki,1,0,0,1,lekki5,3500000.0,5000000.0,4000000.0,2,48,9,4000000
525,  osapa london lekki lagos,11,6,5,6,"Rent 4million, Caution 300k, Agency 10%, Legal 5%. ... Renovated. Big Compound. All Room Ensuit. Parking Space. Pop Ceiling. Security Doors. Water Treatment. ...",lekki,0,0,0,0,lekki6,5500000.0,6200000.0,6200000.0,0,54,10,4700000
526,"  off orchid hotel road, lafiaji lekki lagos",9,5,4,5,"Brand New 4-Bedroom Semi-Detached House with BQ for rent; Location: Off Orchid Hotel Road, Lafiaji, Lekki. Rent: N3.2M Features; Security Gatehouse, Borehole with Treatment Plant, BQ, Fitted Kitchen, All Rooms Ensuite etc For enquiries, call 09093662343 ... New. All Room Ensuit. Parking Space. Pop Ceiling. Jacuzzi. Boys Quater. ...",lekki,0,0,0,1,lekki5,3500000.0,5000000.0,4000000.0,1,48,9,3500000
527,  lekki phase 1 lekki lagos,11,6,5,6,"Five bedroom semi detached duplex for rent Location- lekki phase 1, Lekki Price - 6million Features - All rooms en-suite, Pop ceiling, Ample Parking space Kindly contact Michael on +234 810 020 3228 for enquiries MORTGAGE PLANS OF UP ... All Room Ensuit. Parking Space. Pop Ceiling. Jacuzzi. ...",lekki,0,0,0,1,lekki6,5500000.0,6200000.0,6200000.0,1,54,10,6000000
528,  megamound estate ikota lekki lagos,9,5,4,5,Nicely Built 4 Bedroom Semi-Detached Duplex Location??Megamound Estate Ikota Lekki Rent: N3.5 Million per annum. â€¢ Features: â€¢ All Rooms Ensuite. â€¢ CCTV Cameras. â€¢ Fully Fitted Kitchen. â€¢ Interlocked Estate. â€¢ Central Entertainment System. â€¢ Security House. â€¢ Carport. â€¢ 1 BQ. Kindly contact Chidi on +234 ... New. All Room Ensuit. Parking Space. Pop Ceiling. Jacuzzi. Cctv Cameras. Boys Quater. ...,lekki,0,0,0,1,lekki5,3500000.0,5000000.0,4000000.0,1,48,9,3500000
529,  ologolo lekki lagos,9,5,4,5," For more information, pricing and private viewings, please contact: ? Adeyemi: 09093272572 ?Freke: 09062511345 ?Daniel: 09093272547 Or send us a DM on Instagram @cwrelagos Twitter: @cwrelagos Facebook: @cwrelagos Email : hello@cwlagos.com Website: www.cwlagos.com ... ...",lekki,1,0,0,1,lekki5,3500000.0,5000000.0,4000000.0,2,48,9,4000000
530,  lekki phase 1 lekki lagos,9,5,4,5,4 bedroom Flat / Apartment for rent Lekki Phase 1 Lekki Lagos ... New. ...,lekki,0,0,0,1,lekki5,3500000.0,5000000.0,4000000.0,1,48,9,3500000
531,  chevron lekki lagos,9,5,4,5,4 bedroom Semi Detached Duplex House for rent chevron Lekki Lagos ... ...,lekki,0,0,0,1,lekki5,3500000.0,5000000.0,4000000.0,1,48,9,3600000
532,  lekki phase 1 lekki lagos,7,4,3,4," For more information, pricing and private viewings, please contact: Service Charge is 400,000 per annum ?Freke: 09062511345 ?Daniel: 09093272547 Or send us a DM on Instagram @cwrelagos Twitter: @cwrelagos Facebook: @cwrelagos Email : hello@cwlagos.com Website: www.cwlagos.com ... ...",lekki,0,0,0,1,lekki4,2500000.0,3500000.0,3000000.0,1,39,7,2500000
533,  lekki phase 1 lekki lagos,11,6,5,6,"Five bedroom semi detached for rent Location- lekki phase 1, Lekki Price - 6.5million Features - All rooms en-suite, Pop ceiling, Ample Parking space Kindly contact Michael on +234 810 020 3228 for enquiries MORTGAGE PLANS OF UP TO ... Old. All Room Ensuit. Parking Space. ...",lekki,1,1,0,1,lekki6,5500000.0,6200000.0,6200000.0,3,54,10,6200000
534,  lekki phase 1 lekki lagos,11,6,5,6,Nicely built five bedroom detached house for rent located at lekki phase 1. Features: En-suite rooms Easily accessible Spacious rooms Price -6.5million Call for Michael at +234 810 020 3228 for more details and tour guide ... All Room Ensuit. Parking Space. Pop Ceiling. ...,lekki,1,1,0,1,lekki6,5500000.0,6200000.0,6200000.0,3,54,10,6200000
535,  orchid lekki lagos,9,5,4,5,"Luxury 4 Bedroom Detached Duplex With BQ and a Swimming Pool Location: Orchid, Lekki, Lagos Price: 5 million Per Annum Features: - New - All Rooms En-suite - Carport - CCTV Cameras - Fully Fitted Kitchen - Stamped Concrete Floor - Sound System - Security House -Swimming ... New. All Room Ensuit. Parking Space. Boys Quater. Swimming Pool. ...",lekki,1,1,1,1,lekki5,3500000.0,5000000.0,4000000.0,4,48,9,5000000
536,  lekki phase 1 lekki lagos,5,3,2,3,"Nicely built 2 Bedroom flat with a Bq Location: Lekki phase 1, Lekki Price: 2.8million Features: Ample parking space, All room en-suite, Serene environment, easily accessible Kindly contact Michael on +234 810 020 3228 more enquiries MORTGAGE PLANS ... All Room Ensuit. Parking Space. Pop Ceiling. Boys Quater. ...",lekki,1,1,1,1,lekki3,2000000.0,2500000.0,2500000.0,4,38,7,2800000
537,  lekki phase 1 lekki lagos,7,4,3,4,Nicely built three bedroom terrace located at lekki phase 1. Features: En-suite rooms Ample car park 1 room servant quarters Spacious rooms Price - 3.5 million per annum Self serviced Call for Michael at +234 810 020 3228 ... New. All Room Ensuit. Parking Space. Pop Ceiling. ...,lekki,1,1,1,1,lekki4,2500000.0,3500000.0,3000000.0,4,39,7,3500000
538,  lekki phase 1 lekki lagos,7,4,3,4,3 bedroom Flat / Apartment for rent Lekki Phase 1 Lekki Lagos ... New. ...,lekki,0,0,0,1,lekki4,2500000.0,3500000.0,3000000.0,1,39,7,2700000
539,  lekki phase 1 lekki lagos,7,4,3,4,3 bedroom Boys Quarters Flat / Apartment for rent Lekki Phase 1 Lekki Lagos ... ...,lekki,1,1,1,1,lekki4,2500000.0,3500000.0,3000000.0,4,39,7,3500000
540,  lekki phase 1 lekki lagos,9,5,4,5," For more information, pricing and private viewings, please contact: ?Freke: 09062511345 ?Daniel: 09093272547 Or send us a DM on Instagram @cwrelagos Twitter: @cwrelagos Facebook: @cwrelagos Email : hello@cwlagos.com Website: www.cwlagos.com ... ...",lekki,1,1,1,1,lekki5,3500000.0,5000000.0,4000000.0,4,48,9,5600000
541,  lekki phase 1 lekki lagos,7,4,3,4," For more information, pricing and private viewings, please contact: ?Freke: 09062511345 ?Daniel: 09093272547 Or send us a DM on Instagram @cwrelagos Twitter: @cwrelagos Facebook: @cwrelagos Email : hello@cwlagos.com Website: www.cwlagos.com ... ...",lekki,0,0,0,1,lekki4,2500000.0,3500000.0,3000000.0,1,39,7,2500000
542,  lekki phase 1 lekki lagos,11,6,5,6,Nicely built five bedroom detached house for rent located at lekki phase 1. Features: En-suite rooms Easily accessible Spacious rooms Price -6million Call for Michael at +234 810 020 3228 for more details and tour guide ... All Room Ensuit. Parking Space. Pop Ceiling. ...,lekki,0,0,0,1,lekki6,5500000.0,6200000.0,6200000.0,1,54,10,6000000
543,  off orchid road lekki lagos,11,6,5,6,"Brand New 5-Bedroom Fully-Detached House with BQ for rent Location: Off Orchid Hotel Road, Lekki. Rent: N4M Features; Security Gatehouse, Borehole with Treatment Plant, BQ, Fitted Kitchen, All Rooms Ensuite etc For enquiries, call 09093662343 ... New. All Room Ensuit. Parking Space. Boys Quater. ...",lekki,0,0,0,0,lekki6,5500000.0,6200000.0,6200000.0,0,54,10,4700000
544,  lekki phase 1 lekki lagos,12,6,6,6,A Well Finished 5 Bedroom Duplex with a very good road access and 2 hours electricity and good environment. ... Dry. New. Big Compound. 24 Hours Electricity. Supermarket Nearby. All Room Ensuit. Parking Space. Fast Internet. Drainage System. 24 Hours Security. Restaurants Nearby. Mosques Nearby. Street Lights. Printing Service. Pop Ceiling. Church Nearby. Jacuzzi. Cctv Cameras. Security Doors. Water Treatment. ...,lekki,1,1,0,1,lekki6,5500000.0,6200000.0,6200000.0,3,54,10,6200000
545,  lekki phase 1 lekki lagos,7,4,3,4,"Serviced 3 bedroom Flat for Rent Location: Lekki phase 1 Features: All rooms en-suite, Ample parking space Price: 2.5 million Contact Michael on +234 810 020 3228 ... Serviced. All Room Ensuit. Parking Space. Pop Ceiling. ...",lekki,0,0,0,1,lekki4,2500000.0,3500000.0,3000000.0,1,39,7,2500000
546,  lekki phase 1 lekki lagos,11,6,5,6,Nicely built five bedroom detached house for rent located at lekki phase 1. Features: En-suite rooms Easily accessible Spacious rooms Price -7million Call for Michael at +234 810 020 3228 for more details and tour guide ... All Room Ensuit. Parking Space. Pop Ceiling. ...,lekki,1,1,0,1,lekki6,5500000.0,6200000.0,6200000.0,3,54,10,6200000
547,  chevron lekki lagos,7,4,3,4,"Neatly finished serviced 3 bedrooms flat Location: Lekki conservation/Chevron toll axis Rent: N1,700,000.00 S/c: N300,000.00 Features: All rooms en-suite, Fitted Kitchen, Ample parking space, Generator running time 7pm-7am, Water treatment, Serene and secured environment. Kindly contact Chidi on +234 ... New. Serviced. All Room Ensuit. Parking Space. Pop Ceiling. Water Treatment. ...",lekki,0,0,0,0,lekki4,2500000.0,3500000.0,3000000.0,0,39,7,2000000
548,  agungi lekki phase 2 lekki lagos,2,1,1,1,"OR RENT: Brand New and Spacious Shop & Office Space at Agungi, Lekki, Lagos. FEATURES â€¢ Spacious Office & Shop Space â€¢ Shops on Ground floor â€¢ Not far from Lekki-Epe Expressway â€¢ Spacious compound space â€¢ 24 hours security â€¢ Located ... New. 24 Hours Security. ...",lekki,0,0,0,1,lekki1,800000.0,1300000.0,1169999.9999999988,1,21,4,800000
549,  lekki phase 1 lekki lagos,7,4,3,4,3 bedroom Flat / Apartment for rent Lekki Phase 1 Lekki Lagos ... Big Compound. 24 Hours Electricity. All Room Ensuit. 24 Hours Security. ...,lekki,0,0,0,1,lekki4,2500000.0,3500000.0,3000000.0,1,39,7,2500000
550,  lekki lagos,2,1,1,1,Newly Built Mall and Event Center in a clean and secured environment with constant power supply with parking space of about 500 cars ... New. Big Compound. 24 Hours Electricity. Supermarket Nearby. Parking Space. Fast Internet. Drainage System. 24 Hours Security. Office Supplies. Restaurants Nearby. Mosques Nearby. Security. Front Desk Service. Street Lights. Pop Ceiling. Church Nearby. Cctv Cameras. Security Doors. Water Treatment. ...,lekki,0,0,0,0,lekki1,800000.0,1300000.0,1169999.9999999988,0,21,4,650000
551,  lekki phase 1 lekki lagos,9,5,4,5,"Brand new 4 bedroom terrace duplex with a bq Rent : 5m Service charge 800k / year Location : Lekki phase 1 Features: All rooms en-suite, fitted kitchen, serene and secure estate, ample parking space, spacious living areas Kindly ... New. All Room Ensuit. Parking Space. Pop Ceiling. 24 Hours Security. Boys Quater. ...",lekki,1,1,1,1,lekki5,3500000.0,5000000.0,4000000.0,4,48,9,5000000
552,  bera estate chevron lekki lagos,9,5,4,5,Luxury 4 Bedroom Semi-Detached Duplex Location: BERA Estate Chevron Lekki Rent: N3.5 Million per annum. â€¢ Features: â€¢ All Rooms Ensuite. â€¢ CCTV Cameras. â€¢ Fully Fitted Kitchen. â€¢ Interlocked Estate. â€¢ Central Entertainment System. â€¢ Security House. â€¢ 1 BQ. â€¢ Clean Water. Kindly contact Chidi ... New. All Room Ensuit. Parking Space. Pop Ceiling. Jacuzzi. Cctv Cameras. Boys Quater. ...,lekki,0,0,0,1,lekki5,3500000.0,5000000.0,4000000.0,1,48,9,3500000
553,  lekki phase 1 lekki lagos,11,6,5,6,"Nicely built 5 Bedroom semi Detached duplex with a Bq Location: Lekki phase 1, Lekki Price: 6million Features: Ample parking space, All room en-suite, Serene environment, easily accessible Kindly contact Michael on +234 810 020 3228 ... Big Compound. All Room Ensuit. Parking Space. Pop Ceiling. Boys Quater. ...",lekki,0,0,0,1,lekki6,5500000.0,6200000.0,6200000.0,1,54,10,6000000
554,  lekki phase 1 lekki lagos,8,5,3,5,"Nicely built 3 Bedroom flat with a Bq Location: Lekki phase 1, Lekki Price: 3.5million Features: Ample parking space, All room en-suite, Serene environment, easily accessible Kindly contact Michael on +234 810 020 3228 more enquiries ... All Room Ensuit. Parking Space. Pop Ceiling. Boys Quater. ...",lekki,0,0,0,1,lekki5,3500000.0,5000000.0,4000000.0,1,48,9,3500000
555,  lekki phase 1 lekki lagos,11,6,5,6,"Five bedroom semi detached duplex for rent Location- Lekki phase 1, Lekki Price - 6.5million Two years upfront Agency- 10% on the 2years Legal-5% Features - All rooms en-suite, Pop ceiling, Ample Parking space Kindly contact Michael on +234 810 020 ... All Room Ensuit. Parking Space. Pop Ceiling. Jacuzzi. ...",lekki,1,1,0,1,lekki6,5500000.0,6200000.0,6200000.0,3,54,10,6200000
556,  lekki phase 1 lekki lagos,11,6,5,6,"Nicely built five bedroom semi detached house for rent Location: lekki phase 1 Features: All rooms en-suite, Ample parking space Price: 5.5 million Contact Michael on +234 810 020 3228 ... All Room Ensuit. Parking Space. Pop Ceiling. ...",lekki,0,0,0,1,lekki6,5500000.0,6200000.0,6200000.0,1,54,10,5500000
557,  ... lekki phase 1 lekki lagos,9,5,4,5,Fully furnished 4 bedroom stand alone located at lekki phase 1. Features: Fully fitted and furnished rooms Ante room Dedicated dinning area En-suite rooms Fitted ACs Ample dark park 1 room servant quarters Fitted water waters Swimming ... New. All Room Ensuit. Pop Ceiling. Jacuzzi. Boys Quater. ...,lekki,1,1,1,1,lekki5,3500000.0,5000000.0,4000000.0,4,48,9,5600000
558,  lekki phase 1 lekki lagos,9,5,4,5,"Brand New 4 Bedroom Terrace Duplex with a Bq in one of the most secure and serene estates on the island. Rent : 5m Service charge 800k / year Location : Lekki phase 1 Features: All rooms en-suite, fitted ... New. All Room Ensuit. Parking Space. Pop Ceiling. 24 Hours Security. ...",lekki,1,1,1,1,lekki5,3500000.0,5000000.0,4000000.0,4,48,9,5000000
559,  chevron lekki lagos,9,5,4,5,"Lovely 4 Bedrooms Semi Detached Duplex Location: Chevron, Lekki Rent: N3,000,000 Features: - All rooms en-suite - Fitted kitchen - Ample parking space - Spacious living areas - Serene & Secured environment Kindly contact Chidi on +234 808 216 3583 for ... New. All Room Ensuit. Parking Space. Pop Ceiling. Boys Quater. ...",lekki,0,0,0,1,lekki5,3500000.0,5000000.0,4000000.0,1,48,9,3500000
560,  lekki phase 1 lekki lagos,11,6,5,6,5 bedroom Terraced Duplex House for rent Lekki Phase 1 Lekki Lagos ... Big Compound. Parking Space. C Of O. Survey. Water Treatment. ...,lekki,0,0,0,0,lekki6,5500000.0,6200000.0,6200000.0,0,54,10,5000000
561,  lekki phase 1 lekki lagos,9,5,4,5,4 bedroom House for rent Lekki Phase 1 Lekki Lagos ... Dry. All Room Ensuit. ...,lekki,1,0,0,1,lekki5,3500000.0,5000000.0,4000000.0,2,48,9,4000000
562,  lafiaji lekki lagos,7,4,3,4," Brand New Serviced 3-Bedroom Flat with BQ Location Lafiaji, Lekki Rent: N2.3M SC: N800K (Diesel Inclusive) 17hours of power daily For more enquiries; call 09093662343 MORTGAGE PLANS OF UP TO TEN YEARS ARE AVAILABLE WITH OUR LENDING PARTNER PS. Get ... New. Serviced. All Room Ensuit. Parking Space. Jacuzzi. Boys Quater. ...",lekki,0,0,0,0,lekki4,2500000.0,3500000.0,3000000.0,0,39,7,2300000
563,  ... osapa london lekki lagos,9,5,4,5,"Brand New Serviced 4-Bedroom Terrace with for rent; Location: Osapa, Lekki. Rent: N2,500,000 SC: N682,000 Power: Weekdays; 7pm - 7am; Weekends & Public Holidays; 7pm - 7am, 2pm - 6pm Features; Well finished with P.O.P & Vitrified Tiles, Borehole ... New. All Room Ensuit. Parking Space. Pop Ceiling. Boys Quater. ...",lekki,0,0,0,1,lekki5,3500000.0,5000000.0,4000000.0,1,48,9,3500000
564,  lafiaji community lekki lagos,4,2,2,2,"FOR RENT: Brand New and Nicely Finished 2 Bedroom Flat behind Cooplag Garden, Lafiaji, Lekki-Lagos. Contact: 08177766550 (Call/Whatsapp) FEATURES: - Newly built - Located in a spacious and fully interlocked compound - Well finished apartment - Situated very close to Lekki ... ...",lekki,0,0,0,0,lekki2,1500000.0,2000000.0,1700000.0,0,34,6,900000
565,  lekki phase 1 lekki lagos,7,4,3,4,"Fully Serviced 3 Bedroom Penthouse For Rent Location: Lekki Phase 1 Features: All rooms en-suite, Fully fitted kitchen, 24 hours power supply, Secured environment, Water treatment, Elevator, Personal balconies Rent: 4.5 million Service Charge: 1 million For enquiries, contact ... Serviced. 24 Hours Electricity. All Room Ensuit. Parking Space. Cctv Cameras. Water Treatment. Boys Quater. ...",lekki,1,1,1,1,lekki4,2500000.0,3500000.0,3000000.0,4,39,7,4300000
566,  - lekki phase 1 lekki lagos,5,3,2,3,This is a lovely newly built two bedroom flat located in lekki phase 1. Features: Easily accessible 24hours light Elevator Key pass Rent price: 3m Service charge:45k per month For more details please contact is on [redacted] ... New. Elevator. All Room Ensuit. Parking Space. Pop Ceiling. ...,lekki,1,1,1,1,lekki3,2000000.0,2500000.0,2500000.0,4,38,7,3000000
567,  ikate lekki lagos,7,4,3,4,3 bedroom Flat / Apartment for rent Ikate Lekki Lagos ... New. ...,lekki,0,0,0,1,lekki4,2500000.0,3500000.0,3000000.0,1,39,7,2500000
568,  chevron lekki lagos,9,5,4,5,"Luxury 4 bedroom semi-detached duplex Location: Chevron Features: All rooms en-suite, Fitted Kitchen, Ample parking space, Fully serviced with gym and swimming pool Price: Rent - 4.5 million Kindly contact Bola on 08166792537 for more details ... New. All Room Ensuit. Parking Space. Gym. Pop Ceiling. 24 Hours Security. Swimming Pool. ...",lekki,1,0,1,1,lekki5,3500000.0,5000000.0,4000000.0,3,48,9,4500000
569,  lekki lekki lagos,2,1,1,1,"Nicely built mini flat at lekki right It's located at an easily accessible place,it has 24 hours light and 24hours security. Has ample space,well finished with key card for each room Rent price: 1.7m Service charge: 400k ... ...",lekki,1,1,1,1,lekki1,800000.0,1300000.0,1169999.9999999988,4,21,4,1700000
570,  osapa london lekki lagos,9,5,4,5,4 Bedroom Semi Detached House For Rent comes with 24hrs light and 46k monthly service charge ... ...,lekki,1,0,0,1,lekki5,3500000.0,5000000.0,4000000.0,2,48,9,4000000
571,  ikota lekki lagos,11,6,5,6,Tastefully finished fully detached 5bedroom duplex with a pent house all rooms en-suite. 2 units available Â·Â Â Â Â Â Â Â Â Â Master bedroom has Walk-in wardrobe Â·Â Â Â Â Â Â Â Â Â 1 sitting room and1 family lounge Â·Â Â Â Â Â Â Â Â Â Modern interior lightings and electrical fittings Â·Â Â Â Â Â Â Â Â Â Web enabled CCTV . ... Dry. New. All Room Ensuit. 24 Hours Security. C Of O. ...,lekki,1,1,0,1,lekki6,5500000.0,6200000.0,6200000.0,3,54,10,6200000
572,  chevron lekki lagos,9,5,4,5,"Newly built 4 bedrooms semi-detached house for rent in Chevron, Lekki Price Guide: N3.5M ?????????? For more information, pricing and private viewings, please contact ?Freke: 09062511345 ??hello@cwlagos www.cwlagos.com ... New. Big Compound. 24 Hours Electricity. All Room Ensuit. 24 Hours Security. ...",lekki,0,0,0,1,lekki5,3500000.0,5000000.0,4000000.0,1,48,9,3500000
573,  osapa london lekki lagos,7,4,3,4,"Luxury 3 Bedroom Apartment , 18 hours Week Day light and 24 Hours Weekends, 40,000 monthly Service Charge ... ...",lekki,0,0,0,1,lekki4,2500000.0,3500000.0,3000000.0,1,39,7,2500000
574,  lekki phase 1 lekki lagos,7,4,3,4," For more information, pricing and private viewings, please contact: ?Freke: [redacted] ?Daniel: [redacted] Or send us a DM on Instagram @cwrelagos Twitter: @cwrelagos Facebook: @cwrelagos Email : [redacted] Website: www.cwlagos.com ... ...",lekki,1,0,0,1,lekki4,2500000.0,3500000.0,3000000.0,2,39,7,3000000
575,  ikate lekki lagos,11,6,5,6,"Rent 4 million, Caution 300k, Agency 10%, Legal 10%. ... Renovated. Street Lights. Big Compound. Supermarket Nearby. All Room Ensuit. Parking Space. Pop Ceiling. Security Doors. Water Treatment. Boys Quater. Security. ...",lekki,0,0,0,1,lekki6,5500000.0,6200000.0,6200000.0,1,54,10,6000000
576,  lekki phase 1 lekki lagos,5,3,2,3,"Two bedroom flat for rent Location- Lekki phase 1, Lekki Price - 2million Service charge-160k Features - All rooms en-suite, Pop ceiling, Ample Parking space Kindly contact Michael on +234 810 020 3228 for enquiries MORTGAGE PLANS OF UP TO ... Serviced. All Room Ensuit. Parking Space. ...",lekki,0,0,0,1,lekki3,2000000.0,2500000.0,2500000.0,1,38,7,2000000
577,  .. lekki phase 1 lekki lagos,11,6,5,6,This is a lovely nicely built five bedroom detached house located in lekki phase 1. Features: Easily accessible Swimming pool Fitted kitchen Nicely finished Rent price: 7.5m Asking for 2years straight For more details please contact is on [redacted] ... All Room Ensuit. Parking Space. Pop Ceiling. Swimming Pool. ...,lekki,1,1,0,1,lekki6,5500000.0,6200000.0,6200000.0,3,54,10,6200000
578,  lekki phase 1 lekki lagos,9,5,4,5,Nicely built four bedroom semi-detached located at lekki phase 1. Features: En-suite rooms Easily accessible 1 room servant quarters Spacious rooms Price - 5 million per annum Call for Michael at +234 810 020 3228 for more details ... All Room Ensuit. Parking Space. Pop Ceiling. ...,lekki,1,1,1,1,lekki5,3500000.0,5000000.0,4000000.0,4,48,9,5000000
579,  westend estate ikota lekki lagos,7,4,3,4,"3 Bedroom Ensuite Terrace House with Bq Location: Westend Estate in Ikota Villa Estate Price: Rent at 2m, agency 10% and legal 5%. Direct instruction Features: All rooms en-suite, fitted kitchen, serene and secured environment, ample ... All Room Ensuit. Parking Space. Pop Ceiling. Boys Quater. ...",lekki,0,0,0,0,lekki4,2500000.0,3500000.0,3000000.0,0,39,7,2000000
580,  ikate lekki lagos,5,3,2,3,2 bedroom Flat / Apartment for rent Ikate Lekki Lagos ... ...,lekki,0,0,0,1,lekki3,2000000.0,2500000.0,2500000.0,1,38,7,2000000
581,  lekki palm city ajah lagos,11,6,5,6,"FOR RENT: Brand New and Tastefully finished 4 bedroom Fully Detached House with Boys Quarter, Close to Ajah Jubilee Bridge, Ajah, Lagos. This beautiful home is strategically located in a serene, organized and very secured estate ... New. Ocean View. Big Compound. All Room Ensuit. Parking Space. Pop Ceiling. Drainage System. Cctv Cameras. Security Doors. Boys Quater. Security. ...",lekki,0,0,0,0,lekki6,5500000.0,6200000.0,6200000.0,0,54,10,4700000
582,  lekki phase 1 lekki lagos,11,6,5,6,"Five bedroom twin duplex for rent Location- lekki phase 1, Lekki Price - 5million Features - All rooms en-suite, Pop ceiling, Ample Parking space Kindly contact Michael on +234 810 020 3228 for enquiries MORTGAGE PLANS OF UP TO ... All Room Ensuit. Parking Space. Pop Ceiling. Jacuzzi. ...",lekki,0,0,0,0,lekki6,5500000.0,6200000.0,6200000.0,0,54,10,5000000
583,  lekki phase 1 lekki lagos,2,1,1,1,Serviced Executive 1bed Apartment. Rent- 1.8m Utilitiles. (All) - 300k Gen & Diesel - 38.1k monthly. Agency: 10% Legal: 10% Gen times 7pm to 7am. Every day 12noon to 3pm. Weekends. Further enquiriesÂ  Contact Michael on +234 810 020 3228 ... Dry. Parking Space. ...,lekki,1,1,1,1,lekki1,800000.0,1300000.0,1169999.9999999988,4,21,4,1800000
584,"  buena vista estate, lekki lekki lagos",9,5,4,5,"Four bedroom semi detached for rent Location- Buena Vista Estate, Lekki Price - 3 million Features - All rooms en-suite, fully fitted kitchen, Pop ceiling, Ample Parking space, Jacuzzi Kindly contact Chidi on 0808 216 3583 for enquiries MORTGAGE ... New. All Room Ensuit. Parking Space. Pop Ceiling. Jacuzzi. ...",lekki,0,0,0,1,lekki5,3500000.0,5000000.0,4000000.0,1,48,9,3500000
585,  osapa london lekki lagos,9,5,4,5,"Serviced 4 Bedrooms Terrace Duplex Location: Osapa London Rent: N3,500,000.00 Service charge: N750,000.00 Features:All rooms en-suite, Ample parking space, Fitted kitchen, Spacious living areas, 24hrs light, swimming and gym facilities available. Kindly contact Chidi on +234 808 216 3583 ... New. 24 Hours Electricity. All Room Ensuit. Parking Space. Gym. Pop Ceiling. ...",lekki,0,0,0,1,lekki5,3500000.0,5000000.0,4000000.0,1,48,9,3500000
586,  lekki phase 1 lekki lagos,9,5,4,5,"Four bedroom semi detached for rent Location- lekki phase 1, Lekki Price - 4.5million Features - All rooms en-suite, Pop ceiling, Ample Parking space Kindly contact Michael on +234 810 020 3228 for enquiries MORTGAGE PLANS OF UP TO ... All Room Ensuit. Parking Space. Pop Ceiling. ...",lekki,1,0,1,1,lekki5,3500000.0,5000000.0,4000000.0,3,48,9,4500000
587,  .. lekki phase 1 lekki lagos,11,6,5,6,This is a lovely nicely built five bedroom semi detached house located in lekki phase 1. Features: Easily accessible Nicely finished Rent price: 10m For more details please contact is on [redacted] ... All Room Ensuit. Parking Space. Pop Ceiling. Swimming Pool. ...,lekki,1,1,0,1,lekki6,5500000.0,6200000.0,6200000.0,3,54,10,6200000
588,  agungi lekki lagos,7,4,3,4,3 Bedroom Apartment For Rent in Agungi ... Dry. Serviced. Big Compound. 24 Hours Electricity. All Room Ensuit. 24 Hours Security. C Of O. ...,lekki,1,0,0,1,lekki4,2500000.0,3500000.0,3000000.0,2,39,7,3000000
589,  lekki phase 1 lekki lagos,9,5,4,5,"TO LET: Newly Built, Exquisite and Well Located Six Unit of 3 Bedroom Terrace House with Boys Quarter at Lekki Phase 1, Lekki, Lagos. Every detail was carefully selected and quality crafted. The property comes with ... New. Big Compound. All Room Ensuit. Parking Space. Pop Ceiling. Security Doors. Security. ...",lekki,1,0,0,1,lekki5,3500000.0,5000000.0,4000000.0,2,48,9,4000000
590,  dreamworld africana way lekki phase 2 lekki lagos,11,6,5,6,"FOR RENT: Brand New, Exquisite 4 Bedroom Semi-Detached House with Boys Quarter at Dreamworld Africana Way, Lekki, Lagos. FEATURES: - Modern, top-notch quality fittings/ fixtures - Spacious compound with stamp concrete floor - Fantastic Location: Shortly after Chevron Tollgate - ... New. Ocean View. All Room Ensuit. Pop Ceiling. Jacuzzi. Cctv Cameras. Security Doors. Boys Quater. Security. ...",lekki,0,0,0,0,lekki6,5500000.0,6200000.0,6200000.0,0,54,10,4700000
591,  jakande lekki lagos,11,6,5,6,"Spacious 5 bedroom semi detached duplex with 1 room Bq located in Pinnock Beach Estate, Lekki Features: Spacious living area, All rooms ensuite, Fully fitted kitchen, Jacuzzi, 1 BQ. For enquiries, contact Bola on [redacted] MORTGAGE PLANS OF ... New. All Room Ensuit. Parking Space. Jacuzzi. ...",lekki,1,1,0,1,lekki6,5500000.0,6200000.0,6200000.0,3,54,10,6200000
592,  ikota lekki lagos,5,3,2,3,"Modern Serviced 2 Bedroom Flat Location: Ikota Rent: 1.6 million Sale price: 26 million Features: All rooms en-suite, fitted kitchen, ample parking space, serene and secured environment. Kindly contact Bola on +234 8166792525 for more details MORTGAGE PLANS OF ... New. Serviced. All Room Ensuit. Parking Space. Pop Ceiling. ...",lekki,0,0,0,0,lekki3,2000000.0,2500000.0,2500000.0,0,38,7,1600000
593,  chevron lekki lagos,9,5,4,5,4 bedroom House for rent chevron Lekki Lagos ... All Room Ensuit. ...,lekki,1,0,1,1,lekki5,3500000.0,5000000.0,4000000.0,3,48,9,4500000
594,  nicon town lekki lagos,9,5,4,5,"Rent 8 Million, Agency 10%, Legal 10%, Refundable caution 500k. ... Renovated. Furnished. New. Big Compound. Supermarket Nearby. All Room Ensuit. Parking Space. Fast Internet. 24 Hours Security. Children Play Ground. Restaurants Nearby. Mosques Nearby. Security. Street Lights. Pop Ceiling. Church Nearby. Jacuzzi. Security Doors. Water Treatment. Boys Quater. ...",lekki,1,1,1,1,lekki5,3500000.0,5000000.0,4000000.0,4,48,9,5600000
595,  lekki phase 1 lekki lagos,9,5,4,5,4 bedroom Terraced Duplex House for rent Lekki Phase 1 Lekki Lagos ... Dry. New. Big Compound. 24 Hours Electricity. All Room Ensuit. Water Treatment. ...,lekki,1,1,1,1,lekki5,3500000.0,5000000.0,4000000.0,4,48,9,5000000
596,  lekki phase 1 lekki lagos,11,6,5,6," For more information, pricing and private viewings, please contact: ? Adeyemi: 09093272572 ?Freke: 09062511345 ?Daniel: 09093272547 Or send us a DM on Instagram @cwrelagos Twitter: @cwrelagos Facebook: @cwrelagos Email : hello@cwlagos.com Website: www.cwlagos.com ... ...",lekki,0,0,0,1,lekki6,5500000.0,6200000.0,6200000.0,1,54,10,6000000
597,  chevron lekki lagos,5,3,2,3,Brand New 2 Bedroom Flat in a fully serviced Estate with 24 hour power supply. Location??Chevron Drive Lekki Rent: N2 Million Per Annum Service Charge: N240k Per Annum Features: â€¢ 24 hour power supply. â€¢ Secured Estate. â€¢ Brand New. â€¢ Spacious. â€¢ Fitted ... New. Serviced. 24 Hours Electricity. All Room Ensuit. Parking Space. Pop Ceiling. 24 Hours Security. ...,lekki,0,0,0,1,lekki3,2000000.0,2500000.0,2500000.0,1,38,7,2000000
598,  ikate lekki lagos,11,6,5,6,"Brand New 5-Bedroom Semi-Detached House with BQ; Location: Ikate Rent: N5M Service Charge: N1M (Diesel Inclusive) Located in a very secure residential estate in Ikate; spacious compound which takes up to 4cars, fitted kitchen with gas hubs, heat extractor, ... New. All Room Ensuit. Parking Space. Pop Ceiling. Boys Quater. ...",lekki,0,0,0,0,lekki6,5500000.0,6200000.0,6200000.0,0,54,10,5000000
599,  off oladimeji alo lekki phase 1 lekki lagos,7,4,3,4,"Fully Serviced 3 bedroom Flat with BQ Features Include: Swimming Pool Gym 2 stand by Generator Dedicated Elevator Dedicated Transformer Portable water 24/7 Security Guard CCTV Cameras Ample Parking Space All rooms ensute All rooms and living area fitted with AC Balconies BQ Fitted Kitchen Service Charge----N2,000,000 all Inclusive ... Serviced. Renovated. C Of O. Street Lights. Swimming Pool. Parking Space. Gym. Water Treatment. Boys Quater. Child Care. Drainage System. Survey. 24 Hours Security. Church Nearby. Big Compound. Restaurants Nearby. Security. All Room Ensuit. Cctv Cameras. Elevator. Supermarket Nearby. Mosques Nearby. Security Doors. ...",lekki,1,1,1,1,lekki4,2500000.0,3500000.0,3000000.0,4,39,7,4300000
600,  agungi lekki lagos,9,5,4,5,"4 Bedroom Fully Detached Duplex at Agungi, Lekki for rent Asking price at N3.5m Caution 10% of the rent Legal 5% Agency 10% ... Cheap. Dry. New. Big Compound. Pop Ceiling. Security. All Room Ensuit. Parking Space. Water Treatment. ...",lekki,0,0,0,1,lekki5,3500000.0,5000000.0,4000000.0,1,48,9,3500000
601,  off admiralty road lekki. lekki phase 1 lekki lagos,7,4,3,4,"Tastefully finished luxury 3 bedroom flat with a room servant quarter. Located off Admiralty road lekki phase 1. Features include swimming pool, gym, ample parking space, all rooms ensuite and fitted with AC, balcony, fully ... Serviced. Cheap. Dry. New. C Of O. Street Lights. Swimming Pool. Water Treatment. Boys Quater. Drainage System. Survey. 24 Hours Security. Big Compound. Security. All Room Ensuit. Cctv Cameras. 24 Hours Electricity. Supermarket Nearby. Security Doors. ...",lekki,1,1,1,1,lekki4,2500000.0,3500000.0,3000000.0,4,39,7,4300000
602,  lekki phase 1 lekki lagos,7,4,3,4,"Well finished 3 bedroom flat with a room bq located off Admiralty road Lekki phase one. Features include stand by generator, 3 in compound, water treatment plant,CCTV, all rooms ensuite, spacious living areas,balcony, 24/7 security ... Serviced. Cheap. Dry. Street Lights. Big Compound. Security. All Room Ensuit. Water Treatment. Security Doors. Boys Quater. Drainage System. Survey. 24 Hours Security. ...",lekki,1,1,1,1,lekki4,2500000.0,3500000.0,3000000.0,4,39,7,3500000
603,  ologolo lekki lagos,9,5,4,5,"4 Bedroom Semi-Detached Duplex at Ocean Breeze estate, Ologolo For rent at N2.8m ... Cheap. Dry. New. Big Compound. Pop Ceiling. Security. All Room Ensuit. Parking Space. Water Treatment. Security Doors. ...",lekki,0,0,0,1,lekki5,3500000.0,5000000.0,4000000.0,1,48,9,3500000
604,  orchid lekki phase 2 lekki lagos,9,5,4,5,"4 Bedroom Detached Duplex For Rent Location: 2nd Toll Gate, Lekki, Lagos?????? Price: 4.5m Features: - All Rooms Ensuite - New - Fully Fitted Kitchen - CCTV Cameras - Indoor Speakers - 1 Boyâ€™s Quarter - Water Heaters - Walk-in Shower â€¢â€¢â€¢â€¢â€¢â€¢â€¢â€¢â€¢â€¢â€¢â€¢â€¢â€¢â€¢â€¢â€¢â€¢â€¢â€¢â€¢â€¢â€¢â€¢â€¢â€¢â€¢â€¢â€¢â€¢â€¢â€¢â€¢â€¢â€¢â€¢â€¢â€¢â€¢â€¢â€¢â€¢â€¢â€¢â€¢â€¢â€¢â€¢â€¢ ?? 08133355522 ?? info@ramosoflagosrealty.com â€¢ â€¢ #ramosoflagos #ramosoflagosrealty #lekkirealtor ... New. Street Lights. Swimming Pool. Parking Space. Jacuzzi. Boys Quater. Governor's Consent. Drainage System. 24 Hours Security. Pop Ceiling. Security. All Room Ensuit. Cctv Cameras. Security Doors. ...",lekki,1,0,1,1,lekki5,3500000.0,5000000.0,4000000.0,3,48,9,4500000
605,  providence lekki phase 1 lekki lagos,4,2,2,2,"Fully Serviced 3 rooms office space Features include; Parking space Stand by Generator Easily Accessible Location Portable water 24/7 security guard Service Charge----N400,000 exclusive of Power ... Serviced. Renovated. Security. Cctv Cameras. Water Treatment. 24 Hours Security. ...",lekki,1,1,1,1,lekki2,1500000.0,2000000.0,1700000.0,4,34,6,2800000
606,  hakkem dickson lekki phase 1 lekki lagos,7,4,3,4,"Well Finished 3 bedroom Terrace with BQ Features Include: Swimming Pool 2 Living area 24/7 Security guard Ample parking space Guest Toilet Fitted Kitchen BQ Portable Water You provide your own Generator Service charge----N500,000 ... New. Street Lights. Swimming Pool. Big Compound. Children Play Ground. All Room Ensuit. Water Treatment. Boys Quater. Drainage System. 24 Hours Security. ...",lekki,1,1,1,1,lekki4,2500000.0,3500000.0,3000000.0,4,39,7,3500000
607,  ikate ikate lekki lagos,9,5,4,5,Super luxury 4 bedroom terrace in Ikate-LekkiÂ Â  Star features include: Large swimming pool 4 car parking spaces 3 large balconies 2 spacious living rooms Fitted kitchen All bathrooms ensuite Peaceful and luxury ambiance Private garage Outdoor porch 24/7 electricity Rent: N5m Service charge: N3m ... Serviced. New. Swimming Pool. All Room Ensuit. 24 Hours Electricity. Gym. Water Treatment. 24 Hours Security. ...,lekki,1,1,1,1,lekki5,3500000.0,5000000.0,4000000.0,4,48,9,5000000
608,  lekki phase 1 lekki lagos,9,5,4,5,Luxury and Fully Serviced 4 Bedroom Terrace - Lekki Phase 1 Features: Swimming pool Gym house LoungeÂ  area Ample parking Serene neighborhoodÂ ambiance All bedrooms ensuite 24/7 electricity/ power 2 spacious living rooms Fully fitted kitchen wit storage Ensuite maid's quarters Large master bedroom with private study Surround sound ... Serviced. Swimming Pool. Security. All Room Ensuit. Parking Space. Gym. Water Treatment. ...,lekki,1,1,1,1,lekki5,3500000.0,5000000.0,4000000.0,4,48,9,5600000
609,  off omorihnre johnson lekki phase 1 lekki lagos,7,4,3,4,"Well Finished 3 bedroom Self Serviced Flat With BQ Features Include; All rooms Ensuite All rooms fitted with AC Guest Toilet BQ 24/7 security guard Prepaid meter Portable water Payment for Common Utility Per Annum is N200,000 ... Renovated. Dry. C Of O. Street Lights. Big Compound. All Room Ensuit. Parking Space. Supermarket Nearby. Water Treatment. Boys Quater. 24 Hours Security. ...",lekki,0,0,0,1,lekki4,2500000.0,3500000.0,3000000.0,1,39,7,2800000
610,  zone b nicon town nicon town lekki lagos,11,6,5,6,"LETTING: A NEWLY BUILT AND TASTEFULLY FINISHED 5-BEDROOM DETACHED HOUSE WITH 2-ROOMS SERVANT QUARTER AT ZONE B, NICON TOWN ESTATE, LEKKI. FEATURES: â€¢ ??All rooms ensuite with a guest toilet in the living room downstairs. â€¢ ??All rooms ... New. ...",lekki,1,1,0,1,lekki6,5500000.0,6200000.0,6200000.0,3,54,10,6200000
611,  idado lekki lagos,7,4,3,4,3 bedroom maisonette in Lekki Features include: Fully serviced maisonette Ample parking spaces All bedroom ensuite 2 floor apartment Large kitchen High ceilings Full contemporary architecture Price: N45m ... All Room Ensuit. Parking Space. Water Treatment. Boys Quater. 24 Hours Security. ...,lekki,1,1,1,1,lekki4,2500000.0,3500000.0,3000000.0,4,39,7,4300000
612,  lekki phase 1 lekki lagos,3,2,1,2,"Tastefully finished service one bedroom flat in lekki phase one Features include; stand by generator, 24/7 security guard ample parking space, portable water, fitted kitchen,fitted AC. Rent 1.8m per annum service charge 500k exclusive of ... Serviced. Dry. Street Lights. Big Compound. Security. All Room Ensuit. Supermarket Nearby. Water Treatment. Security Doors. Survey. 24 Hours Security. ...",lekki,1,0,0,1,lekki2,1500000.0,2000000.0,1700000.0,2,34,6,1800000
613,  idado lekki lagos,9,5,4,5,"4 Bedroom Semi Detached Duplex at Idado, Lekki For Rent at N4.5m ... Dry. New. Big Compound. Pop Ceiling. Security. All Room Ensuit. Parking Space. Jacuzzi. Water Treatment. Security Doors. ...",lekki,1,0,1,1,lekki5,3500000.0,5000000.0,4000000.0,3,48,9,4500000
614,  osapa lekki lagos,9,5,4,5,4 Bedroom Terraced Duplex at Osapa For rent at N3.2m ... Cheap. Dry. Big Compound. Security. All Room Ensuit. Parking Space. Water Treatment. ...,lekki,0,0,0,1,lekki5,3500000.0,5000000.0,4000000.0,1,48,9,3500000
615,  lekki county homes ikota lekki lagos,11,6,5,6,"For Sale 5 Bedroom Detached Duplex with bq Location : Lekki County Homes. Lekki, Lagos. Price : 90 Million Naira ________________________________ Features 1. All rooms ensuite 2. Two living rooms 3. Fitted kitchen 4.Bq 5 Inbuilt Sound System 6. Closet 9. CCTV 10. POP Ceiling 11. Spacious Rooms 12. Spacious ... New. Street Lights. Security. All Room Ensuit. Cctv Cameras. Parking Space. Jacuzzi. Water Treatment. Boys Quater. Governor's Consent. Drainage System. 24 Hours Security. ...",lekki,1,1,0,1,lekki6,5500000.0,6200000.0,6200000.0,3,54,10,6200000
616,"  immediately after shoprite, sangotedo, lekki, lagos crown estate ajah lagos",9,5,4,5,"4 bedroom Semi Detached Duplex House for rent Immediately After Shoprite, Sangotedo, Lekki, Lagos Crown Estate Ajah Lagos ... Renovated. Street Lights. Pop Ceiling. Security. All Room Ensuit. Boys Quater. ...",lekki,0,0,0,1,lekki5,3500000.0,5000000.0,4000000.0,1,48,9,3500000
617,  off rahman adeboyejo lekki phase 1 lekki lagos,11,6,5,6,TASTEFULLY NEWLY BUILT 5 BEDROOM HOUSE WITH 2 ROOM SERVANT QUARTER FEATURES INCLUDE; SWIMMING POOL GYM SOLAR PANEL AND INVERTER CENTRAL SOUND SYSTEM HUMAN SENSOR LIGHTING EFFECT 4 SEAT HOME CINEMA BALCONIES AMPLE PARKING SPACE WATER TREATMENT PLANT CCTV CAMERAS ARTIFICIAL GRASS STUDY/HOME LIBRARY GUEST TOILET BULLET PROOF SECURITY DOORS ... Dry. New. Street Lights. Swimming Pool. Parking Space. Jacuzzi. Gym. Water Treatment. Boys Quater. Child Care. Survey. 24 Hours Security. Big Compound. Children Play Ground. Security. All Room Ensuit. Cctv Cameras. Supermarket Nearby. Mosques Nearby. Security Doors. ...,lekki,1,1,0,1,lekki6,5500000.0,6200000.0,6200000.0,3,54,10,6200000
618,  chevron lekki lagos,9,5,4,5,"Luxury, Sophisticated and Fully serviced 4 bedroom terrace Location: Chevron Star features include: Personal garage All bedrooms ensuite Beautiful ambience Large balconies Contemporary architecture Serene location Swimming pool Gym Rent: N4.5m Service charge: N45k per ... Serviced. Swimming Pool. All Room Ensuit. Parking Space. ...",lekki,1,0,1,1,lekki5,3500000.0,5000000.0,4000000.0,3,48,9,4500000
619,  ologolo lekki lagos,9,5,4,5,"4 Bedroom Semi-Detached Duplex at Ologolo, Lekki For rent at N2.5m ... Cheap. Dry. Big Compound. Pop Ceiling. Security. All Room Ensuit. Parking Space. Water Treatment. Security Doors. ...",lekki,0,0,0,1,lekki5,3500000.0,5000000.0,4000000.0,1,48,9,3500000
620,  lekki phase 1 lekki lagos,15,8,7,8,7bedroom fully detached duplex with 2rooms bq within Lekki-phase-1 Rent: N8m Agency: 10p Legal: 5p ... Renovated. Dry. Big Compound. Security. All Room Ensuit. Parking Space. Water Treatment. Security Doors. 24 Hours Security. ...,lekki,1,1,0,1,lekki8,7000000.0,7000000.0,7000000.0,3,59,10,7000000
621,  agungi lekki lagos,9,5,4,5,"4 Bedroom Detached Duplex at Agungi, Lekki For rent at N2.3m ... Cheap. Dry. New. Big Compound. Security. All Room Ensuit. Parking Space. ...",lekki,0,0,0,1,lekki5,3500000.0,5000000.0,4000000.0,1,48,9,3500000
622,  oral estate lekki lagos,9,5,4,5,4 bedroom semi detached duplex for sale By Lekki Second Toll Gate?????? Price: 3.5m Features: - All Ensuite - CCTV Cameras - Security - Stamp Concrete Floor - Interlocking - Jacuzzi - 1 Boyâ€™s Quarter - In-house sound systems - Water Treatment - Fitted Kitchen ... New. Street Lights. Pop Ceiling. Security. All Room Ensuit. Cctv Cameras. Parking Space. Jacuzzi. Water Treatment. Security Doors. Boys Quater. Governor's Consent. 24 Hours Security. ...,lekki,0,0,0,1,lekki5,3500000.0,5000000.0,4000000.0,1,48,9,3500000
623,  idado lekki lagos,5,3,2,3,"Serviced 2 Bedroom Duplex at Idado, Lekki For rent at N2.5m SC at N300k ... Serviced. Dry. Big Compound. Pop Ceiling. Security. All Room Ensuit. Parking Space. Water Treatment. Security Doors. ...",lekki,1,1,0,1,lekki3,2000000.0,2500000.0,2500000.0,3,38,7,2500000
624,  lekki county home lekki phase 2 lekki lagos,9,5,4,5,4 bedroom Semi Detached Duplex House for rent Lekki County Home Lekki Phase 2 Lekki Lagos ... New. Pop Ceiling. Security. All Room Ensuit. Cctv Cameras. Parking Space. Jacuzzi. Water Treatment. Boys Quater. Governor's Consent. Drainage System. 24 Hours Security. ...,lekki,0,0,0,1,lekki5,3500000.0,5000000.0,4000000.0,1,48,9,3500000
625,"  within cooplag estate, along orchid hotel road chevron lekki lagos",11,6,5,6,"5 bedroom Detached Duplex House for rent Within Cooplag Estate, Along Orchid Hotel Road chevron Lekki Lagos ... New. Street Lights. Pop Ceiling. Security. All Room Ensuit. 24 Hours Electricity. Boys Quater. 24 Hours Security. ...",lekki,0,0,0,0,lekki6,5500000.0,6200000.0,6200000.0,0,54,10,4700000
626,  safecourt apartments next to spar ikate lekki lagos,7,4,3,4,"Serviced 3bedroom Luxury flat 4th floor with elevator, attached maid's room at Safecourt Apartments next to SPAR, Ikate Elegushi. Rent - 3m, S/C - 600k/annum. ... Serviced. ...",lekki,1,0,0,1,lekki4,2500000.0,3500000.0,3000000.0,2,39,7,3000000
627,  lekki phase 1 lekki lagos,11,6,5,6,Lekki Phase 1 Lagos?????? 5 bedroom detached duplex with 2 bqs for rent Features: - All Rooms Ensuite - 24hrs Security - 2 Boyâ€™s Quarter - Big Compound - Solar Panels - CCTV Cameras - Bathtub - Smoke Detectors - Cinema - Fully Fitted Kitchen - Air Conditioners - ... New. C Of O. Street Lights. Swimming Pool. Office Supplies. Parking Space. Gym. Water Treatment. Boys Quater. Drainage System. Big Compound. Pop Ceiling. Security. All Room Ensuit. Cctv Cameras. Security Doors. ...,lekki,1,1,0,1,lekki6,5500000.0,6200000.0,6200000.0,3,54,10,6200000
628,  chevron lekki lagos,9,5,4,5,4 bedroom semi detached duplex for rent Opposite Chevron ?????? Price: 3.5m Features: - All Rooms Ensuite - New - Carport - Interlocking - Security - 1 Boyâ€™s Quarter - Pop Ceiling - CCTV Cameras - In-house Speakers - Fully Fitted Kitchen - Jacuzzi ... Serviced. New. Street Lights. Swimming Pool. Jacuzzi. Gym. Water Treatment. Boys Quater. Governor's Consent. Drainage System. Survey. 24 Hours Security. Pop Ceiling. Security. All Room Ensuit. Cctv Cameras. 24 Hours Electricity. ...,lekki,0,0,0,1,lekki5,3500000.0,5000000.0,4000000.0,1,48,9,3500000
629,"  off dsc street ,lekki right. lekki phase 1 lekki lagos",5,3,2,3,"Tastefully finished 2 bedroom penthouse with a room boys quarter located in Lekki Phase 1,off DSC street. Features include security post, a room boys quarter ,all room en suite, water treatment plant ,CCTV ,fully fitted ... Serviced. Cheap. Dry. C Of O. Street Lights. Swimming Pool. Parking Space. Water Treatment. Boys Quater. Drainage System. Survey. 24 Hours Security. Big Compound. Pop Ceiling. Children Play Ground. Restaurants Nearby. Security. All Room Ensuit. Cctv Cameras. Supermarket Nearby. Security Doors. ...",lekki,1,1,1,1,lekki3,2000000.0,2500000.0,2500000.0,4,38,7,3000000
630,"  off dsc, lekki right. lekki phase 1 lekki lagos",5,3,2,3,"Tastefully finished 2 bedroom penthouse with a room Servant quarter located in Lekki Phase 1, Features include security post, a room servant quarter ,all room en suite, water treatment plant ,CCTV ,fully fitted kitchen with ... Serviced. Dry. New. C Of O. Street Lights. Water Treatment. Boys Quater. Drainage System. Survey. 24 Hours Security. Big Compound. Pop Ceiling. Restaurants Nearby. Security. All Room Ensuit. Cctv Cameras. Supermarket Nearby. Security Doors. ...",lekki,1,1,0,1,lekki3,2000000.0,2500000.0,2500000.0,3,38,7,2500000
631,  lekki phase 1 lekki lagos,7,4,3,4,3 Bedroom Terraced Duplex with a BQ within Lekki Phase 1 For Rent at N3.5m Service charge at N250k ... ...,lekki,1,1,1,1,lekki4,2500000.0,3500000.0,3000000.0,4,39,7,3500000
632,  osapa london lekki lagos,9,5,4,5,4 Bedroom duplex at Osapa for Rent at N3.7m ... Cheap. Dry. New. Big Compound. Pop Ceiling. Security. All Room Ensuit. Parking Space. Water Treatment. Security Doors. ...,lekki,0,0,0,1,lekki5,3500000.0,5000000.0,4000000.0,1,48,9,3700000
633,  ikate lekki lagos,11,6,5,6,5 Bedroom Fully Detached Duplex at Ikate For rent at N6m ... Cheap. Dry. New. Big Compound. Pop Ceiling. Security. All Room Ensuit. Parking Space. Security Doors. ...,lekki,0,0,0,1,lekki6,5500000.0,6200000.0,6200000.0,1,54,10,6000000
634,  ikate lekki lagos,11,6,5,6,Newly Built 5 Bedroom Terraced Duplex at Ikate For rent at N4m SC at N500k per year ... Serviced. Cheap. Dry. New. Big Compound. Pop Ceiling. Security. All Room Ensuit. Parking Space. Jacuzzi. Security Doors. ...,lekki,0,0,0,0,lekki6,5500000.0,6200000.0,6200000.0,0,54,10,4700000
635,  off white sand school road. lekki phase 1 lekki lagos,7,4,3,4,Well finished 3 bedroom flat with Located in lekki phase one right side off white sand school road. Self serviced with 24/7 security guard. Rent is 3m per annum ... Cheap. Dry. Street Lights. Swimming Pool. Big Compound. Security. All Room Ensuit. Supermarket Nearby. Water Treatment. Security Doors. Boys Quater. Drainage System. Survey. 24 Hours Security. ...,lekki,0,0,0,1,lekki4,2500000.0,3500000.0,3000000.0,1,39,7,2800000
636,  lekki phase 1 lekki lagos,9,5,4,5,"Tastefully finished luxury 4 bedroom non serviced Terrace house with a room servant quarter located in lekki phase one. Features include, ample parking space, portable water, spacious kitchen with , 24/7 security guard. Rent ... Serviced. Cheap. Dry. C Of O. Street Lights. Water Treatment. Boys Quater. Survey. 24 Hours Security. Big Compound. Pop Ceiling. Security. All Room Ensuit. Cctv Cameras. Supermarket Nearby. Security Doors. ...",lekki,1,0,0,1,lekki5,3500000.0,5000000.0,4000000.0,2,48,9,4000000
637,  lekki phase 1 lekki lagos,5,3,2,3,"TO LET - *SERVICED FLAT* 2 units of 2 bedroom flat 4 units of 3 bedroom flat Facilities; Generator, security , air conditioning units, fitted kitchen Location; Lekki scheme 1 RHS Rent ; N3million & N3.5 ... Serviced. Cheap. Dry. New. Street Lights. Big Compound. Pop Ceiling. Security. All Room Ensuit. Parking Space. Water Treatment. Security Doors. Boys Quater. Survey. 24 Hours Security. ...",lekki,1,1,1,1,lekki3,2000000.0,2500000.0,2500000.0,4,38,7,3000000
638,  lafiaji lekki lagos,9,5,4,5,"4 Bedroom Terraced Duplex on Orchid road, Lekki For rent at N2.5m Agency at 10% Legal at 10% Caution : N200k Estate Fee : N30k (payable monthly to the estate which covers for sewage , water , security , lawma ... Cheap. Dry. New. Big Compound. Pop Ceiling. Security. All Room Ensuit. Parking Space. Water Treatment. Security Doors. 24 Hours Security. ...",lekki,0,0,0,1,lekki5,3500000.0,5000000.0,4000000.0,1,48,9,3500000
639,  - lekki phase 1 lekki lagos,9,5,4,5,Serviced 4 Bedroom Semi detached HouseÂ with 2 Bqs in Lekki Phase 1 Features: Ample Parking Space Serene Environment Eco Building System 24hours Security Fully serviced facility Large compound Constant Power Supply via a dedicated Transformer ... ...,lekki,1,1,1,1,lekki5,3500000.0,5000000.0,4000000.0,4,48,9,5500000
640,"  lekki phase 1, lekki lekki phase 1 lekki lagos",6,3,3,3,"Well maintained lavishly finished 12 units of 3 bedrooms with maids quarter and swimming pool for letting at lekki phase 1, Lagos state Nigeria ... Serviced. Renovated. Furnished. Street Lights. Front Desk Service. Swimming Pool. Parking Space. Gym. Water Treatment. Boys Quater. Drainage System. 24 Hours Security. Big Compound. Pop Ceiling. Children Play Ground. Restaurants Nearby. Security. All Room Ensuit. Cctv Cameras. 24 Hours Electricity. Supermarket Nearby. Security Doors. ...",lekki,1,1,1,1,lekki3,2000000.0,2500000.0,2500000.0,4,38,7,3500000
641,  chevron alternative road chevron lekki lagos state nigeria chevron lekki lagos,8,4,4,4,Brand new tastefully well finished 4 bedroom terrace duplex with BQ for sale at Chevron Alternative road Chevron lekki Lagos state Nigeria Features include CCTV camera Fully fitted kitchen All rooms ensuite Ample parking space ... Serviced. Cheap. Dry. New. Street Lights. Parking Space. Water Treatment. Boys Quater. Drainage System. 24 Hours Security. Church Nearby. Big Compound. Pop Ceiling. Restaurants Nearby. Security. All Room Ensuit. Cctv Cameras. 24 Hours Electricity. Supermarket Nearby. Mosques Nearby. Security Doors. ...,lekki,1,0,0,1,lekki4,2500000.0,3500000.0,3000000.0,2,39,7,3000000
642,  professor kumi st lekki phase 1 lekki lagos,8,4,4,4,"Well Finished 4 bedroom Terrace with BQ Features Include: Swimming Pool, Portable Water, Ample Parking space, 2 stand By generator, BQ, 24/7 Security guard, 2 living area, balcony,fitted kitchen, Green area, Kids play area,all rooms fitted with ... Serviced. Renovated. Swimming Pool. Big Compound. Children Play Ground. Security. Cctv Cameras. Parking Space. Supermarket Nearby. Water Treatment. Security Doors. Boys Quater. Drainage System. 24 Hours Security. ...",lekki,1,1,1,1,lekki4,2500000.0,3500000.0,3000000.0,4,39,7,4300000
643,  chevron lekki lagos,11,6,5,6,5 Bedroom Fully Detached Duplex with Special features at Chevron For Rent at N5.5m ... Dry. New. Swimming Pool. Big Compound. Pop Ceiling. Security. All Room Ensuit. Parking Space. 24 Hours Electricity. Jacuzzi. Gym. Water Treatment. Security Doors. 24 Hours Security. ...,lekki,0,0,0,1,lekki6,5500000.0,6200000.0,6200000.0,1,54,10,5500000
644,  off admiralty way lekki phase 1 lekki lagos,5,3,2,3,Luxury 2 bedroom apartment plus a guest toilet in a resisdential Neighbour hood in lekki phase 1 Water treatment Security Individual entrance gate Pop finishing Private parking Rent 2.5m Service charge 480 thousand ... Renovated. New. Water Treatment. Security Doors. Security. Pop Ceiling. Big Compound. All Room Ensuit. Parking Space. 24 Hours Security. ...,lekki,1,1,0,1,lekki3,2000000.0,2500000.0,2500000.0,3,38,7,2500000
645,  lekki right ikate lekki lagos,7,4,3,4,Spacious. Fitted kitchen. Wardrobe.neatly finished Bath. Compound can take up to 10cars.and just2 in a compound ... ...,lekki,1,1,1,1,lekki4,2500000.0,3500000.0,3000000.0,4,39,7,3500000
646,"  safe court estate, ikate lekki lagos",7,4,3,4," Features: *Excellent condition *Beautiful and safe Environment * water-tight security with CTTV cameras all over the surroundings. * Security armed and unarmed guards *Swimming Pool *Gym, close to Nicon Town, SPAR House on the Rocks, 4th round about. Deedi ... Serviced. Dry. Renovated. Drainage System. Security Doors. Pop Ceiling. Street Lights. Big Compound. All Room Ensuit. Supermarket Nearby. Parking Space. 24 Hours Electricity. 24 Hours Security. Gym. Boys Quater. Water Treatment. Elevator. Security. Swimming Pool. ...",lekki,1,0,0,1,lekki4,2500000.0,3500000.0,3000000.0,2,39,7,3000000
647,  agungi agungi lekki lagos,7,4,3,4,New built 3 bedroom flat apartment with a BQ with central generator. ... Serviced. Dry. New. Drainage System. Boys Quater. Water Treatment. Security Doors. Security. Pop Ceiling. Street Lights. Big Compound. All Room Ensuit. Parking Space. 24 Hours Electricity. 24 Hours Security. ...,lekki,0,0,0,1,lekki4,2500000.0,3500000.0,3000000.0,1,39,7,2500000
648,  eletu osapa london lekki lagos,11,6,5,6,"Beautiful modern 5bedroom detached house with boy's quarter, solar, gate man house at Osapa London , Lekki Rent #4,500,000 ... Cheap. Dry. Renovated. New. Boys Quater. Water Treatment. Security Doors. Security. Pop Ceiling. Parking Space. 24 Hours Security. ...",lekki,0,0,0,0,lekki6,5500000.0,6200000.0,6200000.0,0,54,10,4700000
649,  ilasan ilasan lekki lagos,5,3,2,3,"Newly built luxurious 2bedroom flat with 3toilet 2bath at Ilasan, Lekki, Lagos. Rent #1,700,000 Service charge #170,000 ... Dry. New. Drainage System. Water Treatment. Security Doors. Security. Pop Ceiling. Big Compound. All Room Ensuit. Parking Space. ...",lekki,0,0,0,0,lekki3,2000000.0,2500000.0,2500000.0,0,38,7,1700000
650,  safe court estate ikate lekki lagos,7,4,3,4,"Beautiful serviced 3bedroom apartment with a room boy's quarter at safe court estate, donate with 24hours power supply, clean and serene environment Rent #3,000,000 ... Cheap. Serviced. Dry. Renovated. Drainage System. Security Doors. Pop Ceiling. Street Lights. Cctv Cameras. All Room Ensuit. Supermarket Nearby. Parking Space. 24 Hours Electricity. 24 Hours Security. Boys Quater. Water Treatment. Children Play Ground. Security. ...",lekki,1,0,0,1,lekki4,2500000.0,3500000.0,3000000.0,2,39,7,3000000
651,  lekki paradise chevron lekki lagos,7,4,3,4,"Beautiful and new testafully finished 3bedroom terrace house with a room boy's quarter and a sit out, in a secured and serene estate / environment . Features : Secured and serene estate / environment 24hours security 24hours electricity supply Treated ... Serviced. Dry. New. Drainage System. Security Doors. Pop Ceiling. Street Lights. Big Compound. All Room Ensuit. Supermarket Nearby. Parking Space. 24 Hours Electricity. 24 Hours Security. Boys Quater. Water Treatment. Children Play Ground. Security. ...",lekki,1,1,1,1,lekki4,2500000.0,3500000.0,3000000.0,4,39,7,3500000
652,  close to shoprite jakande lekki lagos,9,5,4,5,-- Massive Newly Built 4 Bedroom semidetached Duplex. -- 10 Units available for rent -- with Living room & Family Lounge -- With A room Boy's Quarter -- All rooms are en suit + visitor toilet -- Spacious rooms & ... Serviced. New. Drainage System. Street Lights. Big Compound. All Room Ensuit. Parking Space. 24 Hours Electricity. 24 Hours Security. Gym. Boys Quater. Water Treatment. Children Play Ground. Security. Printing Service. Swimming Pool. ...,lekki,1,0,0,1,lekki5,3500000.0,5000000.0,4000000.0,2,48,9,4000000
653,  lekki phase 2 lekki lagos,7,4,3,4,"FEATURES: - All Bedrooms En suite with Water Heaters - Fully Fitted Kitchen with Cabinets - Marble Tiles - Wardrobes - P.O.P ceiling - Dining - Serene Environment , 24 hours power supply, Ample Parking ... Serviced. Furnished. New. Water Treatment. Security Doors. Child Care. Security. Pop Ceiling. Street Lights. Big Compound. All Room Ensuit. Parking Space. 24 Hours Electricity. 24 Hours Security. ...",lekki,0,0,0,0,lekki4,2500000.0,3500000.0,3000000.0,0,39,7,2300000
654,  lekki phase 1 lekki phase 1 lekki lagos,11,6,5,6, Fully detached 5 Beds with 2 rooms BQ * A/Cs installed in all the rooms * Comes with 50kva generator and swimming pool * Suitable for Commercial purpose as itâ€™s situated in a commercial area Rent: 7m net Legal: 5% Agenct: ... Dry. Furnished. Drainage System. Security Doors. Pop Ceiling. Street Lights. Big Compound. All Room Ensuit. Supermarket Nearby. Parking Space. 24 Hours Security. Boys Quater. Water Treatment. Security. Swimming Pool. Jacuzzi. Restaurants Nearby. ...,lekki,1,1,0,1,lekki6,5500000.0,6200000.0,6200000.0,3,54,10,6200000
655,  orchid road chevron lekki lagos,7,4,3,4,FEATURES: - All Bedrooms En suite with Water Heaters - Fully Fitted Kitchen with Cabinets - Marble Tiles - Wardrobes - P.O.P ceiling - Dining - Serene Environment - 24 Hours Light -Ample Parking Space. ... New. Water Treatment. Security Doors. Pop Ceiling. Street Lights. Swimming Pool. Big Compound. All Room Ensuit. Supermarket Nearby. Parking Space. 24 Hours Electricity. 24 Hours Security. ...,lekki,0,0,0,1,lekki4,2500000.0,3500000.0,3000000.0,1,39,7,2500000
656,  ikate lekki lagos,5,3,2,3,2 Bedroom flat with Fitted AC for rent @ Lekki - Ikate Rent: *NGN 2.3m* Service Charge: 500k (excluding power) Caution: 100k Agency: 10% Legal: 10% ... Water Treatment. Security. Pop Ceiling. Big Compound. All Room Ensuit. Parking Space. 24 Hours Security. ...,lekki,0,0,0,1,lekki3,2000000.0,2500000.0,2500000.0,1,38,7,2300000
657,  off admiralty way lekki phase 1 lekki lagos,11,6,5,6,Ultra modern 5 bedroom all rooms ensuite terrace duplex with a room bq Remote Generator set Bore hole Water cooperation connection Cctv camera Automatic change over Concrete stamped floor Acrylic fitted kitchen Microwave and cooker ... Serviced. New. Drainage System. Security Doors. Pop Ceiling. Street Lights. Big Compound. Cctv Cameras. All Room Ensuit. Supermarket Nearby. Parking Space. 24 Hours Electricity. 24 Hours Security. Water Treatment. Ocean View. Security. Swimming Pool. Restaurants Nearby. ...,lekki,1,1,0,1,lekki6,5500000.0,6200000.0,6200000.0,3,54,10,6200000
658,  eletu osapa london lekki lagos,7,4,3,4,"Beautiful tastefully finished 3bedroom flat , upper flat, two in a compound , all room en-suite with guest toilet ... Dry. Drainage System. Water Treatment. Security Doors. Security. Pop Ceiling. All Room Ensuit. Parking Space. ...",lekki,0,0,0,1,lekki4,2500000.0,3500000.0,3000000.0,1,39,7,2500000
659,  ikota villa ikota lekki lagos,7,4,3,4,3bedroom flat to let -Rent: 1.4M -Agency: 10% -Legal: 10% -Location: Ikota Villa -Self Service -No caution ... Cheap. Dry. Renovated. Drainage System. Water Treatment. Security Doors. Security. Pop Ceiling. All Room Ensuit. Parking Space. ...,lekki,0,0,0,0,lekki4,2500000.0,3500000.0,3000000.0,0,39,7,2000000
660,"  pinnock beach estate, osapa london lekki lagos",9,5,4,5,"Fully service 4 bedroom detached duplex with a room BQ with 24 hours light for rent at pinnock Beach Estate Rent:4.5m Service charge:1,450,000 yearly , it covers light, security, waste disposal, cleaning of the common area and ... Serviced. Dry. Drainage System. Security Doors. Pop Ceiling. Street Lights. Big Compound. All Room Ensuit. Supermarket Nearby. Parking Space. 24 Hours Electricity. 24 Hours Security. Boys Quater. Water Treatment. Security. Jacuzzi. ...",lekki,1,0,1,1,lekki5,3500000.0,5000000.0,4000000.0,3,48,9,4500000
661,  idado idado lekki lagos,7,4,3,4,This property is a beautiful and well maintained serviced 3 bedroom flat with 18hrs power guaranteed. ... Serviced. Dry. Drainage System. Security Doors. Pop Ceiling. Street Lights. Big Compound. Cctv Cameras. All Room Ensuit. Parking Space. 24 Hours Electricity. 24 Hours Security. Water Treatment. Security. Church Nearby. ...,lekki,0,0,0,0,lekki4,2500000.0,3500000.0,3000000.0,0,39,7,2000000
662,"  eletu street, jakande jakande lekki lagos",3,2,1,2,"Service one bedroom flat flats with ample packing space, good security, clean water,serene neighborhood etc ... Serviced. New. Water Treatment. Street Lights. Supermarket Nearby. 24 Hours Electricity. 24 Hours Security. ...",lekki,0,0,0,1,lekki2,1500000.0,2000000.0,1700000.0,1,34,6,1500000
663,  chevron lekki lagos,9,5,4,5,"FEATURES: - All Bedrooms En suite with Water Heaters - Fully Fitted Kitchen with Cabinets - Marble Tiles - Wardrobes - Serene Environment - Ample Parking Space, Self Compound ... New. Boys Quater. Water Treatment. Security Doors. Security. Pop Ceiling. C Of O. Street Lights. Big Compound. All Room Ensuit. Supermarket Nearby. Parking Space. ...",lekki,1,0,1,1,lekki5,3500000.0,5000000.0,4000000.0,3,48,9,4500000
664,  admiralty home estate igbo efon lekki lagos,9,5,4,5,"Beautiful spacious 4bedroom semi detached house with 2rooms boy's quarter in a secured estate, admiralty home estate Rent #2,200,000 ... Cheap. Dry. Renovated. Drainage System. Boys Quater. Water Treatment. Security Doors. Security. Pop Ceiling. Street Lights. Big Compound. All Room Ensuit. Supermarket Nearby. Parking Space. 24 Hours Security. ...",lekki,0,0,0,1,lekki5,3500000.0,5000000.0,4000000.0,1,48,9,3500000
665,  allan allan balogun street osapa london lekki lagos,8,4,4,4,Tastefully built 4bedroom duplex with a room boys quarter all room ensuite in a serene neighborhood and maximum security ... New. ...,lekki,1,0,0,1,lekki4,2500000.0,3500000.0,3000000.0,2,39,7,3000000
666,  lekki county ikota lekki lagos,2,1,1,1,"This is a standard and spacious selfcon in a serene and gated estate along Lekki County, Ikota. This selfcon comes with its own two door wardrobe, beautiful pop design, kitchen, toilet and bathroom. ... Dry. New. Drainage System. Water Treatment. Security Doors. Security. Pop Ceiling. All Room Ensuit. 24 Hours Security. ...",lekki,0,0,0,0,lekki1,800000.0,1300000.0,1169999.9999999988,0,21,4,650000
667,  orchid road victoria crest estate ikota lekki lagos,10,5,5,5,Lovely Estate Interlock road Workable to d express road Big compound and interlock Environment Pop finishing Big palour and dining space Big kitchen with store & lovely cabinet Big rooms with jacuzzi bathtub All rooms ensuit Big wardrobes Water heater Study rooms Nice compound Personal ... Cheap. New. Security Doors. Security. Pop Ceiling. Big Compound. All Room Ensuit. Jacuzzi. Parking Space. Fast Internet. 24 Hours Electricity. 24 Hours Security. ...,lekki,0,0,0,1,lekki5,3500000.0,5000000.0,4000000.0,1,48,9,3500000
668,  orchid chevron lekki lagos,9,5,4,5,FEATURES: - All Bedrooms En suite with Water Heaters - Fully Fitted Kitchen with Cabinets - Marble Tiles - Wardrobes - P.O.P ceiling - Dining - Serene Environment - 24 Hours Light - Ample Parking ... Serviced. New. Drainage System. Security Doors. Pop Ceiling. Street Lights. Big Compound. Cctv Cameras. All Room Ensuit. Supermarket Nearby. Parking Space. 24 Hours Electricity. 24 Hours Security. Water Treatment. Survey. Security. Swimming Pool. ...,lekki,0,0,0,1,lekki5,3500000.0,5000000.0,4000000.0,1,48,9,3500000
669,  off admiralty way lekki phase 1 lekki lagos,7,4,3,4,Property Description FOR RENT Lekki phase 1 Lagos 3 bedroom all rooms ensuite terrace duplex plus a room bq Features - All Rooms Ensuite - 24hrs Security -Generator -Garden area - Boyâ€™s Quarter - Big Compound - CCTV ... Serviced. Furnished. New. Drainage System. Security Doors. Pop Ceiling. Street Lights. Big Compound. Cctv Cameras. All Room Ensuit. Supermarket Nearby. Parking Space. 24 Hours Electricity. 24 Hours Security. Boys Quater. Water Treatment. Children Play Ground. Security. ...,lekki,1,1,1,1,lekki4,2500000.0,3500000.0,3000000.0,4,39,7,4300000
670,  off admiralty way lekki phase 1 lekki lagos,7,4,3,4,"Executive three (3) bedroom all en-suite apartment with a room service quarters to let in a nice environment . Location: Lekki phase 1, Lagos Rent: #2.5 million Service Charge: #600k Service generator Fitted kitchen Oven Cooker Water heater Parking ... Serviced. Renovated. Drainage System. Water Treatment. Security Doors. Child Care. Security. Pop Ceiling. Street Lights. Big Compound. Cctv Cameras. All Room Ensuit. Parking Space. 24 Hours Security. ...",lekki,0,0,0,1,lekki4,2500000.0,3500000.0,3000000.0,1,39,7,2500000
671,  . lekki phase 1 lekki lagos,10,5,5,5,A standard 4 bedroom duplex @ lekki ph 1 new house all room ensult with bq pop celling price 3.5 million ... New. Boys Quater. ...,lekki,0,0,0,1,lekki5,3500000.0,5000000.0,4000000.0,1,48,9,3500000
672,  off admiralty way lekki phase 1 lekki lagos,4,2,2,2,2-Bedroom BQ Office Space For Rent @ Lekki Phase 1 - Off Admiralty Way Rent: *NGN 1 m* Service Charge: NGN 10k Monthly Agency: 10% Legal: 10% ... ...,lekki,0,0,0,0,lekki2,1500000.0,2000000.0,1700000.0,0,34,6,1000000
673,"  abijo gra, lekki, lagos abijo ajah lagos",14,6,8,6,* This a fantastic house * Its a 7 bedroom detached duplex * It has very spacious rooms * Has 2 sitting rooms * Has all the rooms ensuite * Has beautiful wardrobes fitted in all the rooms * Has a ... Serviced. Boys Quater. Big Compound. ...,lekki,0,0,0,0,lekki6,5500000.0,6200000.0,6200000.0,0,54,10,4700000
674,  igbo efon lekki lagos,7,4,3,4,"Luxury 3 bedroom flat with excellent facilities Rent 1.7m Agency 170k Legal 170k Maintenance 200k Caution 100k Total: N2, 340, 000 ... ...",lekki,0,0,0,0,lekki4,2500000.0,3500000.0,3000000.0,0,39,7,2000000
675,  chisco road ikate lekki lagos,7,4,3,4,"3 Bedroom apartment with a well fitted kitchen for rent in Ikate. Spacious compound with well treated Â water, all the rooms-en suite,Â Large and well fitted Cabinet, Fully equipped Kitchen with Cooker, Smoke expeller and a ... ...",lekki,0,0,0,0,lekki4,2500000.0,3500000.0,3000000.0,0,39,7,2300000
676,  lekki lekki phase 1 lekki lagos,7,4,3,4,Tasteful 3 bedroom terrace all rooms ensuite with a well fitted kitchen plus a room bq *POP finishing *Water Treatment *Security Doors *Well Fitted kitchen *Generator *Modern Design PRICE: 4.5 Million Service Charge: 600 Thousand ... ...,lekki,1,1,1,1,lekki4,2500000.0,3500000.0,3000000.0,4,39,7,4300000
677,  lekki right lekki phase 1 lekki lagos,11,6,5,6,An ultra modern 5 bedroom detached duplex all rooms ensuite with a room bq Ac piping generator house with a pre paid meter Parking space Water treatment plant Fitted kitchen Oven and cooker Fitted bathrooms ... New. Drainage System. Security Doors. Pop Ceiling. Street Lights. Big Compound. Cctv Cameras. All Room Ensuit. Supermarket Nearby. Parking Space. 24 Hours Security. Water Treatment. Children Play Ground. Security. Restaurants Nearby. ...,lekki,0,0,0,1,lekki6,5500000.0,6200000.0,6200000.0,1,54,10,6000000
678,  chevron lekki lagos,11,6,5,6,A nice 5 Bedroom Detached House which situates in a serene estate in Lekki. This building is well accessible with tarred roads and all amenities are in place to give you a comfortable business experience. ... Cheap. Dry. New. Drainage System. Boys Quater. Security Doors. Security. Pop Ceiling. Street Lights. Big Compound. Cctv Cameras. All Room Ensuit. Supermarket Nearby. Parking Space. ...,lekki,0,0,0,0,lekki6,5500000.0,6200000.0,6200000.0,0,54,10,4700000
679,  ologolo ologolo lekki lagos,9,5,4,5,"This is a beautiful and well planned 4 bed semi detached duplex and a Bq. Rent: 3m Service Charge: 150k ( septic tank, cleaning & guard) Refundable Caution - 200k Legal- 5% Agency- 10%. ... Cheap. Serviced. Dry. Furnished. New. Drainage System. Boys Quater. Water Treatment. Security Doors. Security. Pop Ceiling. Big Compound. All Room Ensuit. Parking Space. 24 Hours Electricity. 24 Hours Security. ...",lekki,0,0,0,1,lekki5,3500000.0,5000000.0,4000000.0,1,48,9,3500000
680,  agungi agungi lekki lagos,7,4,3,4,Self Service 3 Bedroom flat with 1 room BQ ... Dry. Renovated. Drainage System. Boys Quater. Water Treatment. Security Doors. Security. Pop Ceiling. Street Lights. All Room Ensuit. Parking Space. 24 Hours Security. ...,lekki,0,0,0,1,lekki4,2500000.0,3500000.0,3000000.0,1,39,7,2500000
681,"  eleganza bus stop, orchid road. ikota lekki lagos",7,4,3,4,"Newly built tastefully finished serviced 3bedroom terrace house in a mini estate at off orchid road Lekki, Lagos. Features: -Spacious bedroom, living room and kitchen -Fitted kitchen - 3car park - quality materials used -24hours security - 20/24hours electricity supply - Good ... Cheap. Serviced. Dry. New. Drainage System. Security Doors. Pop Ceiling. Street Lights. Big Compound. Cctv Cameras. All Room Ensuit. Supermarket Nearby. Parking Space. 24 Hours Electricity. 24 Hours Security. Water Treatment. Security. Swimming Pool. ...",lekki,0,0,0,1,lekki4,2500000.0,3500000.0,3000000.0,1,39,7,2500000
682,  ikate lekki lagos,2,1,1,1,"1 bedroom mini flat for rent at Ikate Elegushi Lekki - Lagos Rent: N700,000 APRO GLOBAL REAL ESTATES Web:info@aproglobalestate. http://com.ng. Tel: 01-7620139 Mobile: 080-51-595-336,080-29-481-639 070-63-822-217, 070-82-974-088 ... Security. Supermarket Nearby. Restaurants Nearby. ...",lekki,0,0,0,0,lekki1,800000.0,1300000.0,1169999.9999999988,0,21,4,700000
683,  lekki phase 1 lekki lagos,9,5,4,5,Exclusively Furnished 4-Bedroom Duplex + BQ For Rent @ Lekki Phase 1 - Off Emma Abimbola Rent: *NGN 4.5m* Caution: 200k Agency: 10% Legal: 10% Facilities: Standby Generator Security Personnel All Rooms Ensuite Fully Furnished (Pay & Pack in) Fitted Kitchen Fitted ... Furnished. Boys Quater. Security. Pop Ceiling. Street Lights. All Room Ensuit. Supermarket Nearby. Parking Space. 24 Hours Security. ...,lekki,1,0,1,1,lekki5,3500000.0,5000000.0,4000000.0,3,48,9,4500000
684,  off admiralty way lekki phase 1 lekki lagos,5,3,2,3,FOR RENT Lekki phase 1 Lagos 2 bedroom all rooms ensuite apartment Features: - All Rooms Ensuite - 24hrs Security - Big Compound - CCTV Cameras - Bathtub - Smoke Detectors - Security house - ... Renovated. Drainage System. Water Treatment. Security Doors. Security. Pop Ceiling. Big Compound. Cctv Cameras. All Room Ensuit. Supermarket Nearby. Jacuzzi. Parking Space. 24 Hours Security. ...,lekki,0,0,0,1,lekki3,2000000.0,2500000.0,2500000.0,1,38,7,2000000
685,  - chevron lekki lagos,8,4,4,4,Fully serviced and brand new 4 bedroom semi detached duplex with a room boys quarter for rent at chevron Rent 4m Agency 10% Legal 10% Caution 200k Service charge is yet to be fixed. ... New. Boys Quater. Big Compound. All Room Ensuit. Parking Space. 24 Hours Electricity. 24 Hours Security. ...,lekki,1,1,1,1,lekki4,2500000.0,3500000.0,3000000.0,4,39,7,4000000
686,  oral estate lekki phase 2 lekki lagos,5,3,2,3,FEATURES: - All Bedrooms En suite with Water Heaters - Fully Fitted Kitchen with Cabinets - Marble Tiles - Wardrobes - P.O.P ceiling - Dining - Serene Environment -Ample Parking Space. ... Drainage System. Water Treatment. Security Doors. Security. Pop Ceiling. Street Lights. Big Compound. All Room Ensuit. Parking Space. ...,lekki,0,0,0,0,lekki3,2000000.0,2500000.0,2500000.0,0,38,7,1600000
687,  oral estate oral estate lekki lagos,3,2,1,2,This is a superbly finished and newly built mini flat with guest toilet in a serene neighborhood of Oral Estate. ... Serviced. Dry. Furnished. New. Drainage System. Water Treatment. Security Doors. Governor's Consent. Security. Pop Ceiling. Street Lights. Cctv Cameras. All Room Ensuit. Parking Space. 24 Hours Electricity. 24 Hours Security. ...,lekki,0,0,0,1,lekki2,1500000.0,2000000.0,1700000.0,1,34,6,1500000
688,  chevron lekki lagos,2,1,1,1,"Selfcon Appartment (Shared Kitchen, Shared Parlour) for rent @ Lekki - Chevron Rent. *N650k* Agency. 10% Legal. 10% ... ...",lekki,0,0,0,0,lekki1,800000.0,1300000.0,1169999.9999999988,0,21,4,650000
689,  chevron lekki lagos,11,6,5,6,A nice 5 Bedroom Detached House with a BQ which situates in a serene environment in Lekki. This building is well accessible with tarred roads and all amenities are in place to give you a ... Cheap. Dry. New. Drainage System. Boys Quater. Security Doors. Security. Pop Ceiling. Street Lights. Cctv Cameras. All Room Ensuit. Supermarket Nearby. Parking Space. 24 Hours Electricity. Restaurants Nearby. ...,lekki,0,0,0,0,lekki6,5500000.0,6200000.0,6200000.0,0,54,10,4700000
690,  ... ikate lekki lagos,9,5,4,5,4-Bedroom Townhouse With BQ For Rent @ Lekki - Ikate Rent: *NGN 3.5m* Service Charge: NGN 500k (excluding Generator) Caution: NGN 200k Agency: 10% Legal: 10% ... Boys Quater. Water Treatment. Pop Ceiling. All Room Ensuit. Parking Space. ...,lekki,0,0,0,1,lekki5,3500000.0,5000000.0,4000000.0,1,48,9,3500000
691,  chevron lekki lagos,9,5,4,5,FEATURES: - All Bedrooms En suite with Water Heaters - Fully Fitted Kitchen with Cabinets - Marble Tiles - Wardrobes - P.O.P ceiling - Dining - Serene Environment -Ample Parking Space. ... Boys Quater. Water Treatment. Security Doors. Security. Pop Ceiling. Street Lights. Big Compound. Cctv Cameras. All Room Ensuit. Parking Space. ...,lekki,0,0,0,1,lekki5,3500000.0,5000000.0,4000000.0,1,48,9,3500000
692,  ikate lekki lagos,5,3,2,3,FEATURES: - All Bedrooms En suite with Water Heaters - Fully Fitted Kitchen with Cabinets - Marble Tiles - Wardrobes - P.O.P ceiling - Dining - Serene Environment -Ample Parking Space. ... Serviced. New. Water Treatment. Security Doors. Security. Pop Ceiling. Street Lights. Big Compound. Cctv Cameras. All Room Ensuit. Parking Space. ...,lekki,1,1,0,1,lekki3,2000000.0,2500000.0,2500000.0,3,38,7,2500000
693,  orchid road lekki phase 2 lekki lagos,5,3,2,3,"FEATURES: - All Bedrooms En suite with Water Heaters - Fully Fitted Kitchen with Cabinets - Marble Tiles - Wardrobes - P.O.P ceiling - Dining - Serene Environment , 24 hours power supply, Ample Parking ... Serviced. New. Security Doors. Pop Ceiling. Street Lights. Big Compound. Cctv Cameras. All Room Ensuit. Supermarket Nearby. Parking Space. 24 Hours Electricity. 24 Hours Security. Water Treatment. Security. Swimming Pool. ...",lekki,1,1,0,1,lekki3,2000000.0,2500000.0,2500000.0,3,38,7,2500000
694,  lekki phase 1 lekki phase 1 lekki lagos,7,4,3,4,"Luxury three bedroom apartment located in a serene and secured environment in Lekki with eye-catching features such as tiled rooms, neatly painted rooms, good access roads, and spacious rooms. Lekki is easily accessible due to ... New. Drainage System. Boys Quater. Water Treatment. Security Doors. Security. Pop Ceiling. Street Lights. Big Compound. Cctv Cameras. All Room Ensuit. Parking Space. 24 Hours Security. ...",lekki,0,0,0,1,lekki4,2500000.0,3500000.0,3000000.0,1,39,7,2500000
695,  ikate-lekki ikate lekki lagos,9,6,3,6,"Fully serviced office space in Ikate, Lekki. Close to Nike Art Gallery Space: 210sqm Rent: #10.5m (#50k/sqm) Service: #4.5m Legal: 5% Agency: 10% Services include: *Generator *Water *Security *Cleaning *bar/ugoch* ... Serviced. Dry. New. Drainage System. Security Doors. Pop Ceiling. C Of O. Street Lights. Office Supplies. Big Compound. Cctv Cameras. All Room Ensuit. Supermarket Nearby. Parking Space. Fast Internet. 24 Hours Electricity. 24 Hours Security. Boys Quater. Water Treatment. Elevator. Survey. Children Play Ground. Free Coffee. Mosques Nearby. Printing Service. Church Nearby. Restaurants Nearby. ...",lekki,1,1,0,1,lekki6,5500000.0,6200000.0,6200000.0,3,54,10,6200000
696,  off admiralty way lekki phase 1 lekki lagos,5,3,2,3,FOR RENT Lekki phase 1 Lagos 2 bedroom all rooms ensuite duplex Features: - All Rooms Ensuite - 24hrs Security -24 hrs Power - Big Compound - Generator - CCTV Cameras - Bathtub - Smoke ... Serviced. Renovated. Drainage System. Security Doors. Child Care. Pop Ceiling. Street Lights. Big Compound. Cctv Cameras. All Room Ensuit. Supermarket Nearby. Parking Space. 24 Hours Electricity. 24 Hours Security. Water Treatment. Children Play Ground. ...,lekki,0,0,0,1,lekki3,2000000.0,2500000.0,2500000.0,1,38,7,2000000
697,"  bourdillon court, chevron drive chevron lekki lagos",9,5,4,5,"Property Description Serviced 4 bedroom semi-detached duplex with BQ for sale @ bourdillion court estate Chevron drive, Lekki. all room en-suite with visitors toilet , big living room with dinning area , family lounge on ... Serviced. Dry. Drainage System. Security Doors. Pop Ceiling. Street Lights. Big Compound. All Room Ensuit. Supermarket Nearby. Parking Space. 24 Hours Electricity. 24 Hours Security. Boys Quater. Water Treatment. Survey. Security. Swimming Pool. ...",lekki,1,0,0,1,lekki5,3500000.0,5000000.0,4000000.0,2,48,9,4000000
698,"  cadogan estate, osapa london lekki lagos",7,4,3,4,"FOR RENT: Fully serviced 3bedroom penthouse at Cadogan Estate Lekki. FEATURES: - En suite - 24hours power - Balcony - Penthouse - Children play ground - Elevator - Highly secured Service charge is N40,500 monthly ... Serviced. Dry. Drainage System. Security Doors. Pop Ceiling. Street Lights. Big Compound. Cctv Cameras. All Room Ensuit. Parking Space. 24 Hours Electricity. 24 Hours Security. Boys Quater. Water Treatment. Elevator. Security. Swimming Pool. ...",lekki,1,1,1,1,lekki4,2500000.0,3500000.0,3000000.0,4,39,7,3800000
699,  eletu osapa london lekki lagos,7,4,3,4,"Beautifully designed 3bedroom flat with 3toilet 4bath, first floor flat, clean water, serene and secured environment, Osapa London estate. Rent #1,800,000 Caution #100,000 Agency 10% #180,000 Legal 5% #90,000 Service charge #300,000 ... Cheap. Dry. Renovated. Drainage System. Water Treatment. Security Doors. Security. Pop Ceiling. Cctv Cameras. All Room Ensuit. Parking Space. 24 Hours Security. ...",lekki,0,0,0,0,lekki4,2500000.0,3500000.0,3000000.0,0,39,7,2000000
700,  lekki lekki phase 1 lekki lagos,5,3,2,3,"Serviced beautiful 2bedroom apartment with a study at michael olawale cole,Lekki 1, lagos. Rent #3,500,000 Service charge #2,500,00 ... Serviced. Dry. Drainage System. Security Doors. Pop Ceiling. Street Lights. Cctv Cameras. All Room Ensuit. Parking Space. 24 Hours Electricity. 24 Hours Security. Boys Quater. Water Treatment. Children Play Ground. Security. Swimming Pool. ...",lekki,1,1,1,1,lekki3,2000000.0,2500000.0,2500000.0,4,38,7,3500000
701,  ilasan ilasan lekki lagos,7,4,3,4,"Newly built luxurious 3bedroom flat, all room en-suite with guest toilet,spacious compound, secure and serene environment of ilasan, Lekki Lagos Rent #2,000,000 Secure charge #200,000 ... Dry. New. Drainage System. Water Treatment. Security Doors. Security. Pop Ceiling. Big Compound. All Room Ensuit. Parking Space. ...",lekki,0,0,0,0,lekki4,2500000.0,3500000.0,3000000.0,0,39,7,2000000
702,  ikate lekki lagos,2,1,1,1,"Selfcon Appartment (shared kitchen, shared parlour) for rent @ Lekki - Ikate Rent: *NGN 650k* Agency 10% Legal 10% ... Pop Ceiling. Big Compound. All Room Ensuit. ...",lekki,0,0,0,0,lekki1,800000.0,1300000.0,1169999.9999999988,0,21,4,650000
703,  lekki paradise chevron lekki lagos,9,5,4,5,"Newly built beautiful 4bedroom terrace house in an estate with 24hours electricity power supply, 24hours security, clean and serene environment/estate, clean and treated water supply . Rent #3,000,000 Service charge 300,000 Power is pay as you go ... Cheap. Serviced. Dry. New. Drainage System. Security Doors. Pop Ceiling. Street Lights. Big Compound. Cctv Cameras. All Room Ensuit. Supermarket Nearby. Parking Space. 24 Hours Electricity. 24 Hours Security. Water Treatment. Children Play Ground. Security. ...",lekki,0,0,0,1,lekki5,3500000.0,5000000.0,4000000.0,1,48,9,3500000
704,  muritala eletu osapa london lekki lagos,7,4,3,4,"Beautifully built tastefully finished 3bedroom apartment (middle floor) at muritala eletu Osapa london estate, Lekki, Lagos. Rent :#1,800,000 Service charge #300,000 Caution #100,000 Agency #180,000 Legal #90,000 ... Cheap. Dry. Renovated. Drainage System. Water Treatment. Security Doors. Security. Pop Ceiling. All Room Ensuit. Parking Space. 24 Hours Security. ...",lekki,0,0,0,0,lekki4,2500000.0,3500000.0,3000000.0,0,39,7,2000000
705,  ikate lekki lagos,10,5,5,5,"Exquisitely finished and Massive 5 Bedroom Fully Detached Duplex for Rent at Ikate, Lekki Features: Secluded Compound All Rooms En-Suite Fully Fitted Kitchen Laundry and Store Spacious Rooms Water Heater Ample Car Space Security Gate House Generator Spot Water Pumping Machine Water Treatment Plant 1 ... Serviced. New. Boys Quater. Big Compound. All Room Ensuit. Parking Space. 24 Hours Electricity. 24 Hours Security. ...",lekki,1,1,1,1,lekki5,3500000.0,5000000.0,4000000.0,4,48,9,5600000
706,  eletu osapa london lekki lagos,5,3,2,3,Beautiful luxurious tastefully finished 2bedroom apartment. Rent #2m ... Drainage System. Water Treatment. Security Doors. Security. Pop Ceiling. Big Compound. All Room Ensuit. Parking Space. 24 Hours Security. ...,lekki,0,0,0,1,lekki3,2000000.0,2500000.0,2500000.0,1,38,7,2000000
707,  whitesands street lekki phase 1 lekki lagos,9,5,4,5,Experience the best living experience with this well maintained 4 Bedroom Terraced House which situates in a serene part of Lekki. This building is well accessible with tarred roads and all amenities are in place ... Cheap. Serviced. Dry. New. Drainage System. Security Doors. Pop Ceiling. Street Lights. Big Compound. Cctv Cameras. All Room Ensuit. Supermarket Nearby. Parking Space. 24 Hours Electricity. 24 Hours Security. Boys Quater. Water Treatment. Security. Restaurants Nearby. ...,lekki,1,1,1,1,lekki5,3500000.0,5000000.0,4000000.0,4,48,9,5500000
708,  lekki phase 1 lekki lagos,2,1,1,1,Miniflat Apartment With Open-Plan Kitchen For Rent @ Lekki Phase 1 Rent: *NGN 1 m* Service Charge: NGN 250k Annually Agency: 10% Legal: 10% ... Renovated. ...,lekki,0,0,0,1,lekki1,800000.0,1300000.0,1169999.9999999988,1,21,4,1000000
709,"  occen bay estate off ,ochid road ikota ikota lekki lagos",5,3,2,3,Fully serviced 2bedroom flat with 24hours power supply ... Serviced. New. Ocean View. Pop Ceiling. Street Lights. Big Compound. All Room Ensuit. Parking Space. 24 Hours Electricity. 24 Hours Security. ...,lekki,0,0,0,1,lekki3,2000000.0,2500000.0,2500000.0,1,38,7,2000000
710,  agungi lekki lagos,7,4,3,4,"3 bedrooms flat for rent at Agungi Lekki - Lagos Rent: N1.2 Million Naira Kindly call the phone numbers below for more info; APRO GLOBAL REAL ESTATES Web:info@aproglobalestate. com.ng. Tel: 01-7620139 Mobile: 080-51-595-336,080-29-481-639 070-63-822-217, 070-82-974-088 ... Security. Supermarket Nearby. Parking Space. Restaurants Nearby. ...",lekki,0,0,0,0,lekki4,2500000.0,3500000.0,3000000.0,0,39,7,2000000
711,"  eleganza gardens, vgc lekki lagos",5,3,2,3,NOW LETTING!! We have 2 Bedroom luxury flat in a paved estate facing VGC. *Details:* ** Directly Opposite V.G.C ** Serene Environment with Greens ** Spacious Rooms and Living Room ** nice plumbing with water heater including kitchen ** Sizable Kitchen ** ... Serviced. Dry. Renovated. Drainage System. Water Treatment. Security. Big Compound. All Room Ensuit. Parking Space. 24 Hours Security. ...,lekki,0,0,0,0,lekki3,2000000.0,2500000.0,2500000.0,0,38,7,1400000
712,  ikota villa estate ikota lekki lagos,5,3,2,3,"Newly built serviced 2bedroom apartment at ikota villa estate, Lekki Rent #1,500,000 Service charge #670,000 including diesel ... Cheap. Serviced. Dry. New. Water Treatment. Security Doors. Security. Pop Ceiling. Big Compound. All Room Ensuit. Parking Space. 24 Hours Security. ...",lekki,0,0,0,0,lekki3,2000000.0,2500000.0,2500000.0,0,38,7,1500000
713,  vgc vgc lekki lagos,9,5,4,5,"Beautifully designed luxurious 4bedroom terrace duplex with a room bq water front at VGC,Lekki Lagos. Rent #3.5m Sales option of #380m ... Serviced. Dry. New. Drainage System. Security Doors. Child Care. Pop Ceiling. Street Lights. Big Compound. Cctv Cameras. All Room Ensuit. Parking Space. 24 Hours Security. Boys Quater. Water Treatment. Children Play Ground. Swimming Pool. ...",lekki,0,0,0,1,lekki5,3500000.0,5000000.0,4000000.0,1,48,9,3500000
714,  osapa london lekki lagos,11,6,5,6,FEATURES: - All Bedrooms En suite with Water Heaters - Fully Fitted Kitchen with Cabinets - Marble Tiles - Wardrobes - P.O.P ceiling - Dining - Serene Environment Ample Parking Space. ... New. Drainage System. Boys Quater. Water Treatment. Security Doors. Security. Pop Ceiling. Street Lights. Big Compound. Cctv Cameras. All Room Ensuit. Parking Space. ...,lekki,0,0,0,0,lekki6,5500000.0,6200000.0,6200000.0,0,54,10,4700000
715,  lekki phase 2 lekki lagos,5,3,2,3,"FEATURES: - All Bedrooms En suite with Water Heaters - Fully Fitted Kitchen with Cabinets - Marble Tiles - Wardrobes - P.O.P ceiling - Dining - Serene Environment -Ample Parking Space, Standby Generator ... Serviced. New. Drainage System. Water Treatment. Security Doors. Security. Pop Ceiling. Street Lights. Big Compound. Cctv Cameras. All Room Ensuit. Supermarket Nearby. Parking Space. 24 Hours Security. ...",lekki,0,0,0,0,lekki3,2000000.0,2500000.0,2500000.0,0,38,7,1600000
716,  chevy view chevron lekki lagos,2,1,1,1,BQ Apartment (No kitchen) For rent @ Lekki - Chevron - Chevy View Rent: *NGN 350k* Caution fee: 30k Agency: 10% Legal: 10% ... Boys Quater. All Room Ensuit. ...,lekki,0,0,0,0,lekki1,800000.0,1300000.0,1169999.9999999988,0,21,4,400000
717,  chevron lekki lagos,9,5,4,5,FEATURES: - All Bedrooms En suite with Water Heaters - Fully Fitted Kitchen with Cabinets - Marble Tiles - Wardrobes - P.O.P ceiling - Dining - Serene Environment -Ample Parking Space. ... Boys Quater. Water Treatment. Security Doors. Security. Pop Ceiling. Street Lights. Big Compound. Cctv Cameras. All Room Ensuit. Parking Space. ...,lekki,0,0,0,1,lekki5,3500000.0,5000000.0,4000000.0,1,48,9,3500000
718,"  ikota villa estate, megamound ikota lekki lagos",8,4,4,4,"FEATURES: - All Bedrooms En suite with Water Heaters - Fully Fitted Kitchen with Cabinets - Marble Tiles - Wardrobes - P.O.P ceiling - Dining - Serene Environment - Ample Parking Space, Self Compound ... New. Drainage System. Water Treatment. Security Doors. Security. Street Lights. Big Compound. All Room Ensuit. Parking Space. ...",lekki,0,0,0,1,lekki4,2500000.0,3500000.0,3000000.0,1,39,7,2500000
719,  lekki paradise chevron lekki lagos,9,5,4,5,"Newly built luxurious serviced 4bedroom bungalow in a serene and secured estate, Lekki paradise, chevron, Lekki, Lagos. Rent #5m ... Serviced. New. Security Doors. Pop Ceiling. Street Lights. Big Compound. All Room Ensuit. Supermarket Nearby. Parking Space. 24 Hours Electricity. 24 Hours Security. Boys Quater. Water Treatment. Children Play Ground. Security. ...",lekki,1,1,1,1,lekki5,3500000.0,5000000.0,4000000.0,4,48,9,5000000
720, ikota gra ikota lekki lagos,7,4,3,4,nice 3 bedroom flat (upstairs) Rent 1.5m Agency 150 Legal 150 Maintenance 150 Caution 100 ... ...,lekki,0,0,0,0,lekki4,2500000.0,3500000.0,3000000.0,0,39,7,2000000
721,  off admiralty way lekki phase 1 lekki lagos,5,3,2,3,FOR RENT Lekki phase 1 Lagos 2 bedroom all rooms ensuite apartment plus a guest toilet (penthouse) Features: - All Rooms Ensuite - 24hrs Security - Big Compound -Fire alarm - Generator space - CCTV Cameras ... Serviced. Renovated. Drainage System. Boys Quater. Water Treatment. Security Doors. Security. Pop Ceiling. Street Lights. Big Compound. All Room Ensuit. Parking Space. 24 Hours Security. ...,lekki,1,1,1,1,lekki3,2000000.0,2500000.0,2500000.0,4,38,7,2800000
722,"  5street estate,agungi agungi lekki lagos",8,4,4,4,Tastefully built service 4bedroom duplex with a room boys quarter all room ensuite in a serene neighborhood and maximum security ... New. ...,lekki,1,0,0,1,lekki4,2500000.0,3500000.0,3000000.0,2,39,7,3000000
723,  off admiralty way lekki phase 1 lekki lagos,4,2,2,2,"Spacious two bedroom flat, with guest toilet, also comes with a wardrope and a modern kitchen cabinet. available for lease in a secure area, inside Lekki phase 1. RENT: 2.2m. Service charge: 1m per annum ... Serviced. Renovated. Water Treatment. Security Doors. Security. Pop Ceiling. Street Lights. Swimming Pool. All Room Ensuit. Parking Space. 24 Hours Electricity. 24 Hours Security. ...",lekki,1,1,1,1,lekki2,1500000.0,2000000.0,1700000.0,4,34,6,2200000
724,  off admiralty way lekki phase 1 lekki lagos,7,4,3,4,A Tasteful 3 bedroom aprtment Â with a well fitted kitchenÂ and room bq *POP ceiling and a well screeded wall *Gated Compound *Ample Parking Space *close to imaxÂ  *Lawn *Secured area PRICE:2.5 MillionÂ  SERVICE CHARGE: 450 Thousand ... ...,lekki,0,0,0,1,lekki4,2500000.0,3500000.0,3000000.0,1,39,7,2500000
725,  close to prime water estate ikate lekki lagos,7,4,3,4,"Beautifully designed very spacious 3bedroom flat with 4toilet 3bath , 2 unit in a compound, easy accessible, secured. Self service apartment Rent #2,500,000 ... Cheap. Dry. Renovated. Water Treatment. Security Doors. Security. Pop Ceiling. Big Compound. All Room Ensuit. Parking Space. ...",lekki,0,0,0,1,lekki4,2500000.0,3500000.0,3000000.0,1,39,7,2500000
726,  pinnock beach estate osapa london lekki lagos,7,4,3,4,"Beautifully furnished 3bedroom apartment at pinnock beach estate , Lekki, lagos. Rent #60,000/day ... Serviced. Dry. New. Drainage System. Security Doors. Pop Ceiling. Street Lights. Big Compound. All Room Ensuit. Supermarket Nearby. Parking Space. 24 Hours Electricity. 24 Hours Security. Boys Quater. Water Treatment. Security. Swimming Pool. Restaurants Nearby. ...",lekki,0,0,0,0,lekki4,2500000.0,3500000.0,3000000.0,0,39,7,2000000
727,  bishop's court ikate lekki lagos,9,5,4,5,4bedroom Terrace duplex with BQ in Ikate Rent 3m Legal 150k Agency 300k Service 500k ... Serviced. New. Drainage System. Security Doors. Pop Ceiling. Street Lights. Big Compound. Cctv Cameras. All Room Ensuit. Supermarket Nearby. Parking Space. 24 Hours Security. Boys Quater. Water Treatment. Front Desk Service. Security. Mosques Nearby. Church Nearby. Jacuzzi. Restaurants Nearby. ...,lekki,0,0,0,1,lekki5,3500000.0,5000000.0,4000000.0,1,48,9,3500000
728,  ikota villa estate ikota lekki lagos,9,5,4,5,Newly built tastefully finished 4bedroom Duplex with a boy's quarter behind mega chicken Rent 3.5m ... Dry. New. Drainage System. Boys Quater. Water Treatment. Security Doors. Security. Pop Ceiling. Big Compound. All Room Ensuit. Parking Space. ...,lekki,0,0,0,1,lekki5,3500000.0,5000000.0,4000000.0,1,48,9,3500000
729,"  osapa, osapa london lekki lagos",9,5,4,5,Property To Let!!! -- 4 Bedroom Terrace Duplex + 1 Room BQ -- House on 2 floors -- All rooms are en suite + visitors toilet -- P O P ceiling and nice wardrobe ... Cheap. Serviced. Renovated. Drainage System. Pop Ceiling. Big Compound. All Room Ensuit. Supermarket Nearby. Parking Space. 24 Hours Security. Gym. Boys Quater. Water Treatment. Children Play Ground. Security. Swimming Pool. ...,lekki,0,0,0,1,lekki5,3500000.0,5000000.0,4000000.0,1,48,9,3500000
730,"  richmond gate estate, ikate lekki lagos",9,5,4,5,"Its a 4 bedroom townhouse with 24 hours light for rent at Richmond gate estate ikate Rent:5m Service charge:841,000 annually Light (pay as you go) ... Serviced. New. Drainage System. Security Doors. Pop Ceiling. Street Lights. Big Compound. Cctv Cameras. All Room Ensuit. Parking Space. 24 Hours Electricity. 24 Hours Security. Boys Quater. Water Treatment. Children Play Ground. Security. Church Nearby. ...",lekki,1,1,1,1,lekki5,3500000.0,5000000.0,4000000.0,4,48,9,5000000
731,  lekki lekki phase 1 lekki lagos,9,5,4,5,Spacious 4 bedroom terrace duplex suitable for office use in a strategically positioned location in Lekki phase 1 with central generator. ... Serviced. Dry. New. Drainage System. Water Treatment. Security Doors. Security. Pop Ceiling. Street Lights. Big Compound. Cctv Cameras. All Room Ensuit. Parking Space. 24 Hours Electricity. 24 Hours Security. ...,lekki,1,0,0,1,lekki5,3500000.0,5000000.0,4000000.0,2,48,9,4000000
732,  lekki phase 1 lekki lagos,5,3,2,3,"This is a 2 bedroom flat for rent off Admiralty way, upstairs Lekki Phase 1 Lagos Rent: N1.7m asking APRO GLOBAL REAL ESTATES Web:info@aproglobalestate. com.ng. Tel: 01-7620139 Mobile: 080-51-595-336,080-29-481-639 070-63-822-217, 070-82-974-088 ... Security. Supermarket Nearby. Restaurants Nearby. ...",lekki,0,0,0,0,lekki3,2000000.0,2500000.0,2500000.0,0,38,7,1700000
733,  off kusenla ikate lekki lagos,8,4,4,4,This mint service brand new cozy apartment is safely located in a gated private estate free from flooding......make out time to inspect today ... Cheap. Serviced. Dry. New. Drainage System. Security Doors. Governor's Consent. Pop Ceiling. Street Lights. Big Compound. All Room Ensuit. Supermarket Nearby. Parking Space. 24 Hours Electricity. 24 Hours Security. Boys Quater. Survey. Security. Swimming Pool. Church Nearby. Restaurants Nearby. ...,lekki,1,1,1,1,lekki4,2500000.0,3500000.0,3000000.0,4,39,7,4300000
734,  pinnock beach luxury estate osapa london lekki lagos,14,7,7,7,"This brand new well built spacious cozy home is all you need in a luxury estate like Pinnock......comes with 2rooms bq and large parking space, well finish bathrooms etc ... Dry. New. Drainage System. Security Doors. Pop Ceiling. Street Lights. Big Compound. Cctv Cameras. All Room Ensuit. Supermarket Nearby. Parking Space. 24 Hours Security. Boys Quater. Water Treatment. Children Play Ground. Security. ...",lekki,0,0,0,1,lekki7,6000000.0,6800000.0,6529999.999999999,1,56,10,6500000
735,  ikota ikota lekki lagos,5,3,2,3,"Fully Serviced 2 Bedroom Flat in Ikota, Lekki, Lagos. Rent: 1.6m Service charge: 650k ( Covers Diesel for the year ) Features: ??New ??All Rooms Ensuite ??CCTV Cameras ??Fitted Kitchen ??24 hours light ??Fitted ACs ??Inverter ??Gas Cooker ... Serviced. Dry. Furnished. New. Drainage System. Security Doors. Pop Ceiling. Street Lights. Big Compound. Cctv Cameras. All Room Ensuit. Supermarket Nearby. Parking Space. 24 Hours Electricity. 24 Hours Security. Water Treatment. Security. Restaurants Nearby. ...",lekki,0,0,0,0,lekki3,2000000.0,2500000.0,2500000.0,0,38,7,1600000
736,  oral estate oral estate lekki lagos,5,3,2,3,This is a superbly finished and newly built 2 bedroom flat in a serene neighborhood of Oral Estate. ... Serviced. Dry. New. Drainage System. Water Treatment. Security Doors. Security. Pop Ceiling. C Of O. All Room Ensuit. Parking Space. 24 Hours Electricity. 24 Hours Security. ...,lekki,0,0,0,0,lekki3,2000000.0,2500000.0,2500000.0,0,38,7,1800000
737,  off admiralty way lekki phase 1 lekki lagos,9,5,4,5,Luxury 4 bedroom all rooms ensuite terrace duplex with a room bq *Swimming pool *Generator house *Gym * Inverter battery backup *Bore hole *Water cooperation connection *Cctv camera *Automatic change over *Concrete stamped floor *Acrylic fitted kitchen ... Furnished. New. Drainage System. Security Doors. Pop Ceiling. Street Lights. Big Compound. Cctv Cameras. All Room Ensuit. Supermarket Nearby. Parking Space. 24 Hours Security. Gym. Boys Quater. Water Treatment. Security. Swimming Pool. ...,lekki,1,1,1,1,lekki5,3500000.0,5000000.0,4000000.0,4,48,9,5600000
738,  eletu osapa london lekki lagos,7,4,3,4,"Beautifully designed neat 3bedroom apartment (upper floor) at Osapa London, by shoprite room, Lekki Lagos. Rent #1,700,000 Service charge #200,000 Caution #100,000 ... Cheap. Dry. Renovated. Drainage System. Water Treatment. Security Doors. Security. Pop Ceiling. Big Compound. All Room Ensuit. Parking Space. 24 Hours Security. ...",lekki,0,0,0,0,lekki4,2500000.0,3500000.0,3000000.0,0,39,7,2000000
739,  ... lekki phase 1 lekki lagos,2,1,1,1,MiniFlat With Open Plan Kitchen For Rent @ Lekki Phase 1 - Off Emma Abimbola Rent: *NGN 1.4 m* Service Charge: NGN 250k Agency: 10% Legal: 10% ... ...,lekki,1,1,1,1,lekki1,800000.0,1300000.0,1169999.9999999988,4,21,4,1400000
740,"  pinnock beach estate, osapa london lekki lagos",11,6,5,6,5 bedroom semi detach duplex with a room BQ for rent at pinnock Beach Estate Rent 7m ... Serviced. Dry. New. Drainage System. Security Doors. Pop Ceiling. Street Lights. Big Compound. All Room Ensuit. Supermarket Nearby. Parking Space. 24 Hours Electricity. 24 Hours Security. Boys Quater. Water Treatment. Security. Jacuzzi. ...,lekki,1,1,0,1,lekki6,5500000.0,6200000.0,6200000.0,3,54,10,6200000
741,  lekki paradise chevron lekki lagos,7,4,3,4,"Newly built beautiful modern serviced 3bedroom flat with 3toilet 4bath, 24hours electricity,24hours security, clean and serene environment. Rent #2,500,000 Service charge #240,000 ... Cheap. Serviced. Dry. New. Drainage System. Security Doors. Pop Ceiling. Street Lights. Big Compound. Cctv Cameras. All Room Ensuit. Parking Space. 24 Hours Electricity. 24 Hours Security. Water Treatment. Children Play Ground. Security. ...",lekki,0,0,0,1,lekki4,2500000.0,3500000.0,3000000.0,1,39,7,2500000
742,  chevy view chevron lekki lagos,2,1,1,1,BQ Apartment (No kitchen) For rent @ Lekki - Chevron - Chevy View Rent: *NGN 350k* Caution fee: 30k Agency: 10% Legal: 10% ... Boys Quater. All Room Ensuit. ...,lekki,0,0,0,0,lekki1,800000.0,1300000.0,1169999.9999999988,0,21,4,400000
743,  ikota villa estate ikota lekki lagos,2,1,1,1,"NEW LETTING... A studio apartment on ground floor. *Details:* A bedroom with wardrobe, separate kitchen and bath/toilet. Rent: 500k* 1yr =500k Agency fee 10%=50k Legal fee 10%= 50k Sc : 60k yearly Total package = N660k Location: Ikota Villa Estate, Lekki Expressway, Lagos. ... Renovated. Water Treatment. Security. Parking Space. ...",lekki,0,0,0,0,lekki1,800000.0,1300000.0,1169999.9999999988,0,21,4,500000
744,  bera estate off chevron drive chevron lekki lagos,9,5,4,5,Luxury 4 Bedroom Semi Detached House located in Bera Estate off Chevron Drive Lekki Lagos. FEATURES: â€“ Well interlocked compound â€“ Beautiful Chandeliers â€“ All rooms en-suite â€“ Guest toilet â€“ Two sitting rooms (Ground and first floor) â€“ Spacious master bedroom ... New. Water Treatment. Security Doors. Security. Pop Ceiling. Street Lights. Big Compound. All Room Ensuit. Parking Space. 24 Hours Security. ...,lekki,0,0,0,1,lekki5,3500000.0,5000000.0,4000000.0,1,48,9,3500000
745,  ikota lekki lagos,5,3,2,3,Newly Built 2-Bedroom Flat For Rent @ Lekki - Ikota Rent: *NGN 1.7m* Service Charge: NGN 200k Caution: NGN 100k Legal: 10% Agency: 10% ... New. Pop Ceiling. All Room Ensuit. ...,lekki,0,0,0,0,lekki3,2000000.0,2500000.0,2500000.0,0,38,7,1700000
746,  off admiralty way lekki phase 1 lekki lagos,9,5,4,5,FOR RENT. Lekki Phase 1 Lagos 4 bedroom terrace duplex with a bq for rent Features: - All Rooms Ensuite - 24hrs Security - Boyâ€™s Quarter - Big Compound - Solar Panels - CCTV Cameras - Bathtub - Smoke Detectors - Fully Fitted Kitchen - Air Conditioners - ... Serviced. Renovated. New. Drainage System. Security Doors. Child Care. Pop Ceiling. Street Lights. Big Compound. Cctv Cameras. All Room Ensuit. Parking Space. 24 Hours Electricity. 24 Hours Security. Gym. Boys Quater. Water Treatment. Security. Swimming Pool. ...,lekki,1,1,1,1,lekki5,3500000.0,5000000.0,4000000.0,4,48,9,5500000
747,  orchid road oral estate lekki lagos,9,5,4,5,"4 BEDROOM DETACHED DUPLEX FOR RENT! Location: Orchid, Lekki, Lagos Price: 5M per annum - Features: - New - All Rooms Ensuite - Carport - CCTV Cameras - Fully Fitted Kitchen - Stamped Concrete Floor - Sound System - Security House -Swimming Pool - 1 BQ ... Dry. New. Drainage System. Security Doors. Pop Ceiling. Street Lights. Big Compound. Cctv Cameras. All Room Ensuit. Parking Space. 24 Hours Security. Boys Quater. Water Treatment. Security. Swimming Pool. ...",lekki,1,1,1,1,lekki5,3500000.0,5000000.0,4000000.0,4,48,9,5000000
748,  ilasan lekki lagos,5,3,2,3,Spacious 2-Bedroom Apartment For Rent @ Lekki - ILasan Rent: *NGN 1.5m* Service Charge: NGN 150k Caution: 50k Agency: 10% Legal: 5% ... All Room Ensuit. ...,lekki,0,0,0,0,lekki3,2000000.0,2500000.0,2500000.0,0,38,7,1500000
749,"  chevyview estate, chevron lekki lagos",7,4,3,4,"Newly renovated 3 bedroom flat (2 in a compound, Upstairs) Service charge 300k Rent 1.9m ... Renovated. Water Treatment. Security Doors. Security. Pop Ceiling. Street Lights. Big Compound. All Room Ensuit. 24 Hours Security. ...",lekki,0,0,0,0,lekki4,2500000.0,3500000.0,3000000.0,0,39,7,2000000
750,  ikota lekki lagos,9,5,4,5,FEATURES: - All Bedrooms En suite with Water Heaters - Fully Fitted Kitchen with Cabinets - Marble Tiles - Wardrobes - P.O.P ceiling - Dining - Serene Environment -Ample Parking Space. ... New. Drainage System. Water Treatment. Security Doors. Security. Pop Ceiling. Street Lights. Big Compound. All Room Ensuit. Parking Space. ...,lekki,0,0,0,1,lekki5,3500000.0,5000000.0,4000000.0,1,48,9,3500000
751,  off admiralty way lekki phase 1 lekki lagos,3,2,1,2,FOR RENT Lekki phase 1 Lagos 1 bedroom all rooms ensuite apartment Features: - All Rooms Ensuite - 24hrs Security - Big Compound - CCTV Cameras - Bathtub - Smoke Detectors - Security house ... Serviced. Renovated. Drainage System. Security Doors. Pop Ceiling. Street Lights. Big Compound. Cctv Cameras. All Room Ensuit. Supermarket Nearby. Parking Space. 24 Hours Security. Boys Quater. Water Treatment. Children Play Ground. Security. Swimming Pool. ...,lekki,0,0,0,1,lekki2,1500000.0,2000000.0,1700000.0,1,34,6,1500000
752,"  eleganza garden, opposite vgc vgc lekki lagos",7,3,4,3,"LETTING!! We have 4 Bedroom duplex with Boy's Quarter, on it own self compound, which can park up to four cars in a paved estate facing VGC. *Details:* ** Directly Opposite V.G.C ** Serene Environment with Greens ** ... Cheap. Serviced. Renovated. Drainage System. Boys Quater. Water Treatment. Security. Big Compound. All Room Ensuit. Jacuzzi. Parking Space. 24 Hours Security. ...",lekki,1,1,0,1,lekki3,2000000.0,2500000.0,2500000.0,3,38,7,2500000
753,  osapa london lekki lagos,5,3,2,3,Fully service 2 bedroom flat with 24 hours light for rent at osapa Rent:2.5m Service charge:750k Diesel:750k ... Serviced. Dry. New. Drainage System. Security Doors. Pop Ceiling. Street Lights. Big Compound. Cctv Cameras. All Room Ensuit. Parking Space. 24 Hours Electricity. 24 Hours Security. Gym. Water Treatment. Security. Swimming Pool. ...,lekki,1,1,0,1,lekki3,2000000.0,2500000.0,2500000.0,3,38,7,2500000
754,"  eleganza gardens, vgc lekki lagos",3,2,1,2,- A newly built mini flat available for rent - nice finishing - security door - room ensuit plus visitors toilet - good power and water supply - 24 hours security - Paved Estate facing Express. - Rent: N1.1m per year ... Serviced. New. Drainage System. Water Treatment. Security Doors. Security. Pop Ceiling. Big Compound. All Room Ensuit. Parking Space. 24 Hours Security. ...,lekki,0,0,0,0,lekki2,1500000.0,2000000.0,1700000.0,0,34,6,1100000
755,"  cromwell estate, chevron lekki lagos",7,4,3,4,"Fully serviced 3bedroom flat at Cromwell estate, Chevron drive. (1st floor) 2.8m -fully serviced with stable electricity -watertight security -pool -green areas -treated water -drainages -tarred road network ... Serviced. Boys Quater. Water Treatment. Security. Swimming Pool. Big Compound. All Room Ensuit. Parking Space. 24 Hours Electricity. 24 Hours Security. ...",lekki,0,0,0,1,lekki4,2500000.0,3500000.0,3000000.0,1,39,7,2800000
756,  behind prime water gardens ikate lekki lagos,7,4,3,4,Luxury 3 bedroom apartment with a well fitted kitchen Generator connection Bore hole Water cooperation connection Automatic change over Concrete stamped floor Acrylic fitted kitchen Ac connection Green area Water stantion Pandora sit out Delineated ... Renovated. Security Doors. Pop Ceiling. Street Lights. Big Compound. All Room Ensuit. Supermarket Nearby. Parking Space. 24 Hours Security. Water Treatment. Ocean View. Survey. Security. Swimming Pool. ...,lekki,0,0,0,0,lekki4,2500000.0,3500000.0,3000000.0,0,39,7,2200000
757,"  updc estate, lekki phase 1 lekki lagos",7,4,3,4,"Serviced and spacious 3 bedroom bungalow at UPDC estate with 1 room bq. Features include: *24hrs power *Swimming pool *watertight security *tarred road network *good drainages *children playground *green areas *ACs pre-installed in living room, all bedrooms & kitchen ... Serviced. Dry. Drainage System. Security Doors. Pop Ceiling. Street Lights. Big Compound. Cctv Cameras. All Room Ensuit. Supermarket Nearby. Parking Space. 24 Hours Electricity. 24 Hours Security. Boys Quater. Water Treatment. Security. Swimming Pool. ...",lekki,1,1,1,1,lekki4,2500000.0,3500000.0,3000000.0,4,39,7,4300000
758,  mega chicken ikota lekki lagos,9,5,4,5," Features: - All Rooms Ensuite - 1 BQ - Fitted Kitchen - Stamp Concrete Floor - Pop Ceiling - Water Heater - Balcony -Water treatment plant -Parking Space -Jacuzzi Self Serviced. No caution fee, pay and park in! ... Cheap. Serviced. Dry. New. Drainage System. Security Doors. Pop Ceiling. Street Lights. Big Compound. All Room Ensuit. Supermarket Nearby. Parking Space. 24 Hours Security. Boys Quater. Water Treatment. Security. Jacuzzi. ...",lekki,0,0,0,1,lekki5,3500000.0,5000000.0,4000000.0,1,48,9,3500000
759,  bridge gate estate agungi lekki lagos,9,5,4,5,"Beautifully designed and tastefully finished modern 4bedroom detached house with a maid room, security house, big compound for enough parking and a study room at bridge gate estate Agungi , Lekki , Lagos. Rent #3m ... Cheap. Serviced. Dry. Renovated. Drainage System. Boys Quater. Water Treatment. Security Doors. Pop Ceiling. Big Compound. All Room Ensuit. Parking Space. 24 Hours Security. Restaurants Nearby. ...",lekki,0,0,0,1,lekki5,3500000.0,5000000.0,4000000.0,1,48,9,3500000
760,  orchid road chevron lekki lagos,9,5,4,5,FEATURES: - All Bedrooms En suite with Water Heaters - Fully Fitted Kitchen with Cabinets - Marble Tiles - Wardrobes - P.O.P ceiling - Dining - Security - Excellent road network - Serene Environment - ... Serviced. New. Drainage System. Security Doors. Pop Ceiling. Street Lights. Big Compound. Cctv Cameras. All Room Ensuit. Parking Space. 24 Hours Security. Boys Quater. Water Treatment. Children Play Ground. Security. ...,lekki,0,0,0,1,lekki5,3500000.0,5000000.0,4000000.0,1,48,9,3500000
761,  idado lekki lagos,11,6,5,6,FEATURES: - All Bedrooms En suite with Water Heaters - Fully Fitted Kitchen with Cabinets - Marble Tiles - Wardrobes - P.O.P ceiling - Dining - Serene Environment Ample Parking Space. ... New. Boys Quater. Water Treatment. Security Doors. Security. Pop Ceiling. Street Lights. Big Compound. Cctv Cameras. Parking Space. ...,lekki,0,0,0,0,lekki6,5500000.0,6200000.0,6200000.0,0,54,10,4700000
762,  ologolo lekki lagos,5,3,2,3,FOR RENT Ologolo Lagos 2 bedroom all rooms ensuite apartment Features: - All Rooms Ensuite - 24hrs Security - Big Compound - Generator - CCTV Cameras - Bathtub - Smoke Detectors - Security house - ... New. Drainage System. Security Doors. Pop Ceiling. Street Lights. Big Compound. Cctv Cameras. All Room Ensuit. Supermarket Nearby. Parking Space. 24 Hours Security. Boys Quater. Water Treatment. Security. ...,lekki,0,0,0,1,lekki3,2000000.0,2500000.0,2500000.0,1,38,7,2000000
763,  lekki right side lekki phase 1 lekki lagos,7,4,3,4,Property Description FOR RENT Lekki phase 1 (Right side) Lagos 3 bedroom all rooms ensuite semi detached duplex Features: - All Rooms Ensuite - 24hrs estate security - Big Compound - Generator wiring - ... Renovated. Drainage System. Security Doors. Child Care. Pop Ceiling. Street Lights. Big Compound. All Room Ensuit. Supermarket Nearby. Parking Space. 24 Hours Security. Boys Quater. Water Treatment. Security. Restaurants Nearby. ...,lekki,1,0,0,1,lekki4,2500000.0,3500000.0,3000000.0,2,39,7,3200000
764,  pinnock beach estate osapa london lekki lagos,12,6,6,6,Mint standard cozy detached house in a high brow luxury residential estate for lease ... Cheap. Dry. Renovated. Water Treatment. Security Doors. Pop Ceiling. Street Lights. 24 Hours Security. ...,lekki,1,1,0,1,lekki6,5500000.0,6200000.0,6200000.0,3,54,10,6200000
765,  romay garden estate ilasan lekki lagos,9,5,4,5,"Serviced 4 bedroom terrace duplex with 24hrs light at Romay Garden estate, beside World Oil filling station. Features: *Ample parking *Watertight security *24hrs power *gym *CCTV *Central sewage system *Covered drains *Green area *Lawn Tennis court *Water treatment plant ... Serviced. Security Doors. Pop Ceiling. Street Lights. Big Compound. Cctv Cameras. All Room Ensuit. Parking Space. 24 Hours Electricity. 24 Hours Security. Gym. Boys Quater. Water Treatment. Survey. Security. ...",lekki,0,0,0,1,lekki5,3500000.0,5000000.0,4000000.0,1,48,9,3500000
766,  megamound estate ikota lekki lagos,9,5,4,5,"AVAILABLE FOR RENT IN MEGAMOUND ESTATE, LEKKI COUNTY, IKOTA VILLA ESTATE * 4 Bedroom semi detached duplex * self compound * all rooms are ensuite + visitors toilet * duplex + a room BQ * 2 ... Drainage System. Boys Quater. Water Treatment. Security. Pop Ceiling. Street Lights. Big Compound. All Room Ensuit. Supermarket Nearby. Parking Space. 24 Hours Electricity. 24 Hours Security. ...",lekki,0,0,0,1,lekki5,3500000.0,5000000.0,4000000.0,1,48,9,3500000
767,"  safe court apartments, ikate lekki lagos",7,4,3,4,Description WELL FINISHED 3 BEDROOM FLAT WITH A ROOM BQ FEATURES INCLUDE ALL ROOMS ENSUITE FITTED KITCHEN GUEST TOILET BALCONY LARGE LIVING AREA SPACE SWIMMING POOL GYM FACILITY MANAGEMENT OFFICE AMPLE PARKING SPACE WATER TREATMENT PLANT 24/7 SECURITY 24/7 POWER DEDICATED ELEVATOR BASKETBALL COURT VISITORS PARKING LOT ELEVATOR Neighborhood: Spar Supermarket Service charge 700k ... Serviced. Dry. Drainage System. Security Doors. Pop Ceiling. Street Lights. Big Compound. Cctv Cameras. All Room Ensuit. Parking Space. 24 Hours Electricity. 24 Hours Security. Gym. Boys Quater. Water Treatment. Elevator. Security. Swimming Pool. ...,lekki,1,1,1,1,lekki4,2500000.0,3500000.0,3000000.0,4,39,7,3500000
768,"  bourdillon court, chevron lekki lagos",7,4,3,4,"Fully service 3 bedroom flat with 24 hours light with a room BQ for rent at bourdillon Cort Chevron drive Chevron Rent:3m Agency:300,000 Legal:300,000 Service charge:37,125 monthly Cation fee:200,000 ... Serviced. Dry. Boys Quater. Water Treatment. Security Doors. Elevator. Security. Pop Ceiling. Street Lights. Big Compound. All Room Ensuit. Parking Space. 24 Hours Electricity. 24 Hours Security. ...",lekki,1,0,0,1,lekki4,2500000.0,3500000.0,3000000.0,2,39,7,3000000
769,  ikota lekki lagos,7,4,3,4,FEATURES: - All Bedrooms En suite with Water Heaters - Fully Fitted Kitchen with Cabinets - Marble Tiles - Wardrobes - P.O.P ceiling - Dining - Serene Environment -Ample Parking Space. ... New. Water Treatment. Security Doors. Security. Pop Ceiling. Big Compound. All Room Ensuit. Parking Space. ...,lekki,0,0,0,0,lekki4,2500000.0,3500000.0,3000000.0,0,39,7,2000000
770," tom ogboi street,off freedom way lekki phase 1 lekki phase 1 lekki lagos",7,4,3,4,"Serviced estate with a good tared road,security ... Dry. Serviced. New. Swimming Pool. 24 Hours Electricity. Drainage System. Children Play Ground. Security. Restaurants Nearby. Supermarket Nearby. Water Treatment. Church Nearby. Big Compound. 24 Hours Security. Mosques Nearby. Parking Space. All Room Ensuit. Pop Ceiling. ...",lekki,1,0,0,1,lekki4,2500000.0,3500000.0,3000000.0,2,39,7,3000000
771, off freedom way lekki phase 1 lekki phase 1 lekki lagos,11,6,5,6,Serviced 5 bedroom duplex (terrace) ... Dry. Serviced. New. Security. Boys Quater. All Room Ensuit. 24 Hours Electricity. Drainage System. Restaurants Nearby. Pop Ceiling. Mosques Nearby. Swimming Pool. Big Compound. Parking Space. 24 Hours Security. Church Nearby. Water Treatment. Children Play Ground. Supermarket Nearby. ...,lekki,0,0,0,0,lekki6,5500000.0,6200000.0,6200000.0,0,54,10,5000000
772,  lekki phase 1 lekki lagos,8,4,4,4,3 bedroom Flat / Apartment for rent Lekki Phase 1 Lekki Lagos ... Serviced. Elevator. 24 Hours Security. Pop Ceiling. Boys Quater. 24 Hours Electricity. ...,lekki,1,1,1,1,lekki4,2500000.0,3500000.0,3000000.0,4,39,7,3500000
773,  olofin street off admiralty road. lekki phase 1 lekki lagos,3,2,1,2,1 bedroom mini flat Mini flat Flat / Apartment for rent olofin street off Admiralty road. Lekki Phase 1 Lekki Lagos ... ...,lekki,1,0,0,1,lekki2,1500000.0,2000000.0,1700000.0,2,34,6,1700000
774,  chile mba close behinde zenith bank. osapa london lekki lagos,9,5,4,5,4 bedroom Terraced Duplex House for rent Chile MBA close behinde Zenith bank. Osapa london Lekki Lagos ... Serviced. Cheap. Furnished. Dry. New. C Of O. Excision. Children Play Ground. Jacuzzi. Street Lights. Security Doors. All Room Ensuit. Fast Internet. Pop Ceiling. Boys Quater. Big Compound. Drainage System. 24 Hours Electricity. Church Nearby. Survey. Water Treatment. Gym. Supermarket Nearby. Security. 24 Hours Security. ...,lekki,1,0,0,1,lekki5,3500000.0,5000000.0,4000000.0,2,48,9,4000000
775,  oladimeji alo lekki phase 1 lekki lagos,2,1,1,1,1 bedroom mini flat Mini flat Flat / Apartment for rent Oladimeji alo Lekki Phase 1 Lekki Lagos ... Renovated. ...,lekki,1,0,0,1,lekki1,800000.0,1300000.0,1169999.9999999988,2,21,4,1200000
776,  ikate lekki lagos,3,2,1,2,It has modern equipment and serviced ... Serviced. Furnished. New. All Room Ensuit. 24 Hours Security. Big Compound. 24 Hours Electricity. ...,lekki,0,0,0,1,lekki2,1500000.0,2000000.0,1700000.0,1,34,6,1500000
777,  oral estate lekki lagos,7,4,3,4,It is all ensuite with modern equipment ... Serviced. New. Water Treatment. All Room Ensuit. 24 Hours Security. Big Compound. 24 Hours Electricity. ...,lekki,0,0,0,0,lekki4,2500000.0,3500000.0,3000000.0,0,39,7,2000000
778,  orchid road ikota lekki lagos,9,5,4,5,"Clean 4bedroom duplex (semi detached). It has a good parking space with clean environment, not flooded during rainy season and good water system. The rooms are all ensuite. Kitchen is well fitted and large. Rent - N3m Agency 10% Agreement ... New. Parking Space. Jacuzzi. Security. All Room Ensuit. Pop Ceiling. ...",lekki,0,0,0,1,lekki5,3500000.0,5000000.0,4000000.0,1,48,9,3500000
779, off freedom way lekki phase 1 lekki lagos,9,5,4,5,The duplex is a gated apartment and fully serviced ... Serviced. Dry. New. Children Play Ground. Parking Space. All Room Ensuit. Pop Ceiling. Restaurants Nearby. Big Compound. Drainage System. 24 Hours Electricity. Mosques Nearby. Church Nearby. Water Treatment. Swimming Pool. Supermarket Nearby. Security. 24 Hours Security. ...,lekki,1,0,0,1,lekki5,3500000.0,5000000.0,4000000.0,2,48,9,4000000
780,  off admiralty road lekki phase 1 lekki phase 1 lekki lagos,5,3,2,3,2 bedroom Flat / Apartment for rent Off Admiralty road lekki phase 1 Lekki Phase 1 Lekki Lagos ... Serviced. Renovated. Parking Space. Street Lights. Swimming Pool. Security. Security Doors. All Room Ensuit. 24 Hours Security. Pop Ceiling. Restaurants Nearby. Big Compound. 24 Hours Electricity. ...,lekki,0,0,0,1,lekki3,2000000.0,2500000.0,2500000.0,1,38,7,2400000
781,  oral zone 1 lekki garden ikate lekki lagos,7,4,3,4,3 bedroom Flat / Apartment for rent Oral zone 1 lekki garden Ikate Lekki Lagos ... Serviced. Cheap. New. Children Play Ground. Street Lights. Security Doors. All Room Ensuit. Pop Ceiling. Big Compound. Drainage System. 24 Hours Electricity. Church Nearby. Survey. Water Treatment. Supermarket Nearby. Security. 24 Hours Security. ...,lekki,1,0,0,1,lekki4,2500000.0,3500000.0,3000000.0,2,39,7,3000000
782,  oral estate lekki lagos,3,2,1,2,It has mordern equipment and serviced ... Serviced. Furnished. New. All Room Ensuit. 24 Hours Security. Big Compound. 24 Hours Electricity. ...,lekki,0,0,0,1,lekki2,1500000.0,2000000.0,1700000.0,1,34,6,1500000
783,  chisco off world oil fueling station. ilasan lekki lagos,7,4,3,4,3bedroom flat for rent at Ilasa road Ilasan Lekki Lagos ... New. Parking Space. Water Treatment. Pop Ceiling. Street Lights. Security. Big Compound. Security Doors. ...,lekki,0,0,0,0,lekki4,2500000.0,3500000.0,3000000.0,0,39,7,2200000
784,  off admiralty way lekki phase 1 lekki lagos,9,4,5,4,Located in a serene environment An ante room on the ground floor and a guest toilet The ground floor living room is very spacious and can be partitioned. All rooms en-suite It can parking up to 25 cars Located in ... Parking Space. Security. ...,lekki,1,1,1,1,lekki4,2500000.0,3500000.0,3000000.0,4,39,7,4300000
785,"  safecourt estate, ikate-elegushi, lagos. ikate lekki lagos",7,4,3,4,"Luxury 3 Bedroom Flat + Bq in Safecourt Estate, Ikate, Lekki. FEATURES INCLUDE ALL ROOMS ENSUITE POP FITTED KITCHEN GUEST TOILET BALCONY LARGE LIVING AREA SPACE Large Kitchen and Bedrooms SWIMMING POOL GYM FACILITY MANAGEMENT OFFICE AMPLE PARKING SPACE WATER TREATMENT PLANT 24/7 SECURITY 24/7 POWER DEDICATED ELEVATOR ESTATE WELL MAINTAINED WITH ... ...",lekki,1,0,0,1,lekki4,2500000.0,3500000.0,3000000.0,2,39,7,3000000
786,  jakande lekki lagos,9,5,4,5,"A 4 Bedroom Detached Duplex, with a Service Quarters per unit. Located at Jakande, Lekki. Coupled with Intelligent and Welcoming Aesthetic Design to create the Perfect Backdrop for Modern Lifestyle. FEATURES & AMENITIES â€¢ Beautifully Landscaped Outdoor â€¢ Modern Fitted ... ...",lekki,1,1,1,1,lekki5,3500000.0,5000000.0,4000000.0,4,48,9,5600000
787,  lekki phase 1 lekki lagos,11,6,5,6,"A 5 bedroom detached duplex, with a service quarters Off Admiralty way, Lekki Phase 1. For commercial or residential (It is a mixed-use property). All rooms en-suite. Rooms and living area are properly spaced and well lit. Internal & ... ...",lekki,1,1,0,1,lekki6,5500000.0,6200000.0,6200000.0,3,54,10,6200000
788,"  chevron,lekki expressway lekki lagos",9,5,4,5,"4 bedroom semi terrace duplex, with a service quarters Located in a properly maintained estate Properly spaced rooms and living area Well lit surrounding, with a garden that spans from the front to the back of ... 24 Hours Electricity. 24 Hours Security. Swimming Pool. ...",lekki,0,0,0,1,lekki5,3500000.0,5000000.0,4000000.0,1,48,9,3500000
789,  off admiralty way lekki phase 1 lekki lagos,9,5,4,5,"4 bedroom terrace with a pool Located in a serene environment, inside Lekki Phase 1. Also easily accessible Good use of space and design Spans on 3 floors. All rooms are en-suite including the quarters. Spacious living room (2 living rooms) Dining ... ...",lekki,1,0,1,1,lekki5,3500000.0,5000000.0,4000000.0,3,48,9,4500000
790,  off admiralty way lekki phase 1 lekki lagos,9,5,4,5,"4 bedroom terrace, with a service quarters per unit Located in a serene environment, inside Lekki Phase 1. Also easily accessible Good use of space and design All rooms are en-suite including the quarters. Spacious living room (2 living rooms) Dining ... ...",lekki,1,1,1,1,lekki5,3500000.0,5000000.0,4000000.0,4,48,9,5600000
791,  bosola durosinmi etti drive lekki phase 1 lekki lagos,11,6,5,6,"A 5 bedroom detached duplex (with a separate guest room) Spacious rooms Properly lit areas. All rooms en-suite Ample parking space , located in a serene area. Suitable for commercial or residential Facilities: A Swimming pool ... Swimming Pool. ...",lekki,0,0,0,1,lekki6,5500000.0,6200000.0,6200000.0,1,54,10,6000000
792,  off admiralty way lekki phase 1 lekki lagos,9,5,4,5,A 4 bedroom detached duple All rooms en-suite A dining area and guest toilet on the ground floor Clean water supply (borehole and lagos state) Has a 2 bedroom Service quarters (All rooms en-suite) Ample parking space (internal and ... ...,lekki,1,1,1,1,lekki5,3500000.0,5000000.0,4000000.0,4,48,9,5600000
793,  west ends estates ikota lekki lagos,9,5,4,5,"Spacious 4 Bedroom semi Detached Duplex with a room BQ available for lease at Westends estate, Ikota,Lekki. Rent:N2.5m Agreement :10% Agency:10% Caution deposit :N200K ... New. Renovated. Big Compound. Parking Space. Pop Ceiling. Street Lights. 24 Hours Security. Security Doors. Drainage System. All Room Ensuit. Water Treatment. Restaurants Nearby. ...",lekki,0,0,0,1,lekki5,3500000.0,5000000.0,4000000.0,1,48,9,3500000
794,  off bisola durotimi etti lekki phase 1 lekki lagos,7,4,3,4,in a cozy enviroment ... ...,lekki,0,0,0,1,lekki4,2500000.0,3500000.0,3000000.0,1,39,7,2500000
795,  admiralty way lekki phase 1 lekki lagos,7,4,3,4,"Luxury 3 bedroom terrace, with a service quarters Newly built Located in a serene area Spans on 2 floors. All rooms are en-suite including the quarters. Spacious living room and bedrooms Dining area Fitted Kitchen All rooms are well lit. Facilities: Security 24hrs ... 24 Hours Electricity. 24 Hours Security. Cctv Cameras. ...",lekki,1,1,1,1,lekki4,2500000.0,3500000.0,3000000.0,4,39,7,4300000
796,  lekki phase 1 lekki lagos,11,6,5,6,5 Bedroom Detached Duplex with BQ + Air Conditioners + Swimming Pool + 50kva Generator Rent: N7m x 2yrs Net Caution Deposit: N250k Location: Lekki Phase 1 ... Big Compound. Boys Quater. Water Treatment. ...,lekki,1,1,0,1,lekki6,5500000.0,6200000.0,6200000.0,3,54,10,6200000
797,  ikota lekki lagos,11,6,5,6,Luxury 4Bed duplex Rent: 2.5m SC: 500k Brokers fee: 10% Agency: 10% Caution deposit: 200k A touch of class ... New. Serviced. Parking Space. Pop Ceiling. 24 Hours Security. Water Treatment. ...,lekki,0,0,0,0,lekki6,5500000.0,6200000.0,6200000.0,0,54,10,4700000
798,  cadogan estate jakande lekki lagos,7,4,3,4,"3 bedroom apartment, in a fully serviced estate. All rooms en-suite Fully secured Ample parking Service Charge - 40,000 per month Facilities: -24 hrs power -Water -Security ... 24 Hours Electricity. 24 Hours Security. Water Treatment. ...",lekki,1,0,0,1,lekki4,2500000.0,3500000.0,3000000.0,2,39,7,3000000
799,  lekki county homes lekki lagos,9,5,4,5,"Features New All Ensuite 1 Tenant Only Stamp Concrete Floor Car Port Fitted Kitchen Washing Machine Refrigerator Water Heater Boy's Quarter Spacious Car Park Self Serviced Value - N6,000,000 Estate Agency - N600,000 Legal Fee - N300,000 Refundable Caution Deposit - N200,000 Total Payment - N7,100,000 To Inspect and Rent This 4 ... New. Big Compound. Pop Ceiling. Boys Quater. All Room Ensuit. ...",lekki,1,1,1,1,lekki5,3500000.0,5000000.0,4000000.0,4,48,9,5600000
800,  megamound estate ikota lekki lagos,9,5,4,5,A 4 bedroom semidetached duplex with a service quarters Finished with quality products (tiles and fittings) Proper use of space in all rooms and open areas Spacious rooms and living area Massive Master's bedroom 2 living rooms ... New. Serviced. 24 Hours Electricity. Drainage System. Boys Quater. Security. Water Treatment. Big Compound. Parking Space. Pop Ceiling. 24 Hours Security. Security Doors. Child Care. All Room Ensuit. Cctv Cameras. Jacuzzi. ...,lekki,0,0,0,1,lekki5,3500000.0,5000000.0,4000000.0,1,48,9,3500000
801,  ikota villa estate lekki lagos,9,5,4,5,"A newly built 4 bedroom detached duplex In a serene estate , located at ikota, lekki. Well aired rooms and surroundings Spacious rooms, and kitchen Easily accessible, with a good road network. All rooms ensuite ... ...",lekki,0,0,0,1,lekki5,3500000.0,5000000.0,4000000.0,1,48,9,3500000
802,  ikate lekki lagos,13,7,6,7,Massive and luxury 5bed duplex Rent : 6m Agency: 600k Agreement: 5% ... New. Dry. Big Compound. 24 Hours Security. Boys Quater. All Room Ensuit. Water Treatment. Cctv Cameras. ...,lekki,0,0,0,1,lekki7,6000000.0,6800000.0,6529999.999999999,1,56,10,6000000
803,  lekki phase 1 lekki lagos,8,4,4,4,"Very decent 3bedroom apartment, in a serene environment with a mini estate; 24hrs light POP finish Furnished kitchen Parking Space and lot more Rent: ?4.5m including light and service charge Agency : 10% Legal: 10% ... Cheap. Serviced. Furnished. Big Compound. Parking Space. 24 Hours Electricity. Pop Ceiling. 24 Hours Security. Governor's Consent. All Room Ensuit. Water Treatment. ...",lekki,1,1,1,1,lekki4,2500000.0,3500000.0,3000000.0,4,39,7,3500000
804,  lekki phase 1 lekki lagos,2,1,1,1,"Fun Facts A decent size Mini flat Average sized living room and bedroom for a 1 bedroom Standard Bathroom Fitting Kitchen Backyard and1 parking space Fitted with wardrobes and security doors. Facilities: Water Treatment Security Nb: The service charge is N100,000 P.A (for ... Security. Water Treatment. ...",lekki,1,1,1,1,lekki1,800000.0,1300000.0,1169999.9999999988,4,21,4,1400000
805,  lekki phase 1 lekki lagos,7,4,3,4,A furnished 3 bedroom terrace With a service quarters All rooms en-suite A guest toilet and 2 living rooms Ample parking space Well spaced and with good use of natural light. Fully furnished and serviced. Fully fitted kitchen. ... ...,lekki,1,1,1,1,lekki4,2500000.0,3500000.0,3000000.0,4,39,7,4300000
806,"  chevron road,lekki expressway chevron lekki lagos",9,5,4,5,"It is an Exquisite and Exotic brand new Semi-detached 4 Bedroom Terraced Duplex, with a very spacious BQ in a conveniently magnificent atmosphere in Lekki. Located in the highly respected and much-talked about Chevron Drive, with ... ...",lekki,0,0,0,1,lekki5,3500000.0,5000000.0,4000000.0,1,48,9,3500000
807,  off admiralty way lekki phase 1 lekki lagos,9,5,4,5,"A newly built 4 bedroom terrace, with a service quarters. All rooms en-suite 2 living rooms and a private loft Each unit has a net usable area of 310sqm each A fully fitted kitchen and ample storage space. Awe inspiring ... New. Gym. Parking Space. 24 Hours Electricity. Security. Swimming Pool. Water Treatment. ...",lekki,1,1,1,1,lekki5,3500000.0,5000000.0,4000000.0,4,48,9,5600000
808,  lekki phase 1 lekki lagos,11,6,5,6,"A 5 Bedroom fully detached Duplex With 2 rooms service quarters (comes with a toilet, bathroom and kitchen) spans on two floors Two living rooms (on the ground and first floor) All rooms en-suite A very spacious masters bedroom A dining ... Parking Space. All Room Ensuit. ...",lekki,1,1,0,1,lekki6,5500000.0,6200000.0,6200000.0,3,54,10,6200000
809,  off fola osibo road lekki phase 1 lekki lagos,7,4,3,4,3 bedroom terrace All rooms en-suite Spacious masters bedroom Very spacious living room Easily accessible In a serene environment Nb: Can be mixed use also ... ...,lekki,1,0,0,1,lekki4,2500000.0,3500000.0,3000000.0,2,39,7,3000000
810,  osapa london lekki lagos,10,5,5,5,Serviced 3bed apartment Rent:2.3m SC:300k ... New. Serviced. Parking Space. Pop Ceiling. 24 Hours Security. Boys Quater. All Room Ensuit. Water Treatment. ...,lekki,0,0,0,1,lekki5,3500000.0,5000000.0,4000000.0,1,48,9,3500000
811,  off fola osibo lekki phase 1 lekki lagos,3,2,1,2,An office space on the ground floor of a 4 bedroom duplex. Consisting of: - A room ensuite - 2 open spaces (A spacious living room & a converted dining area) - A store - A guest toilet - Parking space Communal ... Serviced. Big Compound. Parking Space. Pop Ceiling. Supermarket Nearby. 24 Hours Security. Security Doors. Front Desk Service. Drainage System. Fast Internet. All Room Ensuit. Security. Water Treatment. ...,lekki,1,1,1,1,lekki2,1500000.0,2000000.0,1700000.0,4,34,6,3000000
812,  orchid road lekki lagos,9,5,4,5,"4 Bedroom Detached Duplex located at Orchid Rd,Lekki. Price :N4 Million(p/a) ________________________________ Features 1. All rooms ensuite 2. Family Lounge 3. Stamped Concrete 4. Fitted kitchen 5. Spacious Rooms 7. POP Ceiling 8. Closet 9. CCTV 10. Bq And much ... New. Big Compound. Excision. 24 Hours Electricity. Pop Ceiling. Printing Service. Drainage System. Church Nearby. All Room Ensuit. Water Treatment. Cctv Cameras. ...",lekki,1,0,0,1,lekki5,3500000.0,5000000.0,4000000.0,2,48,9,4000000
813,  off admiralty way lekki phase 1 lekki lagos,9,5,4,5,4 Bedroom semi detached Duplex on three floors Two living rooms (on the ground and first floor) A penthouse on the 2nd floor All rooms en-suite A dining area and guest toilet on the ground floor Clean ... ...,lekki,1,1,1,1,lekki5,3500000.0,5000000.0,4000000.0,4,48,9,5500000
814,  off admirality way lekki phase 1 lekki lagos,9,5,4,5,"A 4 bedroom terrace, with a room service quarters All rooms ensuite Guest toilet on the ground floor and living area 2 living areas (a private room on the upper floor) Well maintained Facilities: 24hrs power Swimming Pool Gym Outside Terrace for ... Gym. 24 Hours Electricity. 24 Hours Security. Swimming Pool. ...",lekki,1,1,1,1,lekki5,3500000.0,5000000.0,4000000.0,4,48,9,5000000
815,  iroko awe elegushi lekki ilasan lekki lagos,2,1,1,1,"*Available for Letting at Agape Apartments Ilasan Iroko Awe Elegushi Lekki* *One Executive Miniflat room and parlour with two baths/toilets and one kitchen Price: 700k legal 70k, agency 70k, Service charge; 360k Non refundable maintenance fee 50k, *Service charge ... Serviced. Renovated. Pop Ceiling. All Room Ensuit. Parking Space. Security. ...",lekki,0,0,0,0,lekki1,800000.0,1300000.0,1169999.9999999988,0,21,4,700000
816,  orchid hotel road. lekki phase 2 lekki lagos,10,5,5,5,"Fully serviced estate with amenities like swimming pool, gym,children play area,astroturf, cctv cameras and electric fence wire,uniform outfit security, and mobile police in the most serene and beautiful ambience ... Serviced. Dry. New. Parking Space. Fast Internet. 24 Hours Security. Swimming Pool. Security. Security Doors. Big Compound. Restaurants Nearby. Supermarket Nearby. All Room Ensuit. Gym. 24 Hours Electricity. Water Treatment. Pop Ceiling. Street Lights. ...",lekki,0,0,0,1,lekki5,3500000.0,5000000.0,4000000.0,1,48,9,3500000
817,  osapa london lekki osapa london lekki lagos,7,4,3,4,Tastefully finished 3BEDROOM Apartments all rooms ensuite with fitted kitchen cabinets and spacious compound with wardrobes and a room Boys Quarter Price; 2.5m per annum LOCATION: osapa LONDON lekki Lagos ... Serviced. Boys Quater. Security. All Room Ensuit. Big Compound. Parking Space. Pop Ceiling. ...,lekki,0,0,0,1,lekki4,2500000.0,3500000.0,3000000.0,1,39,7,2500000
818,  ikota villa estate by mega chicken ikota lekki lagos,7,4,3,4,Tastefully finished brand new 3BEDROOM Apartments all rooms ensuite with fitted kitchen cabinets and wardrobes spacious compound with a room Boys Quarter Price: 2million per annum Service charge: 750k per annum inclusive of diesel deposits ... Serviced. New. Boys Quater. Security. All Room Ensuit. Big Compound. Parking Space. 24 Hours Electricity. Pop Ceiling. 24 Hours Security. ...,lekki,0,0,0,0,lekki4,2500000.0,3500000.0,3000000.0,0,39,7,2000000
819,  lekki conservative road ikota before 2nd toll gate chevron lekki lagos,9,5,4,5,4bedroom terrace duplex with all rooms ensuite + Fitted kitchen + Luxury sanitary wares + 3car park for each unit + 24hours electricity backed up with central generator + Industrial central water system + Security with call at ... Serviced. New. Cheap. Jacuzzi. Security. All Room Ensuit. Big Compound. Security Doors. Parking Space. Pop Ceiling. Printing Service. ...,lekki,0,0,0,1,lekki5,3500000.0,5000000.0,4000000.0,1,48,9,3500000
820,  igbo efon lekki lagos,5,3,2,3,Three bedroom flat with BQ in Igboefon for rent. It's self serviced and there are only six units in the fenced and gated compound. Upstairs flat available. ... Boys Quater. Security. Supermarket Nearby. Restaurants Nearby. Parking Space. Pop Ceiling. ...,lekki,0,0,0,0,lekki3,2000000.0,2500000.0,2500000.0,0,38,7,1500000
821,"  horizon 11,by meadow hall way ikate elegushi lekki ikate lekki lagos",7,4,3,4,LOCATION: horizon 11 ikate Elegushi via Meadow Hall way. 3 Bedroom Apartment in a Fully Serviced Estate known as Horizon 11. The apartment comes with Ac's in all the rooms and the kitchen is fitted. It is also ... Serviced. Jacuzzi. Security. All Room Ensuit. Big Compound. Parking Space. Pop Ceiling. ...,lekki,0,0,0,1,lekki4,2500000.0,3500000.0,3000000.0,1,39,7,2750000
822,  fairview estate orchid hotel road chevron drive lekki lekki lagos,9,5,4,5,"Fully Serviced 4 Bedroom Terrace duplex LOCATION:Fairview Court at Coleman Nwafor close off Orchid hotel road,Chevron toll gate.lekki for rent @ N2.8 Million per annum ( Maintenance fees @ N35 k monthly and Nepa/ diesel ... Serviced. Dry. Security. All Room Ensuit. Big Compound. Parking Space. Pop Ceiling. ...",lekki,0,0,0,1,lekki5,3500000.0,5000000.0,4000000.0,1,48,9,3500000
823,  alpha beach road new road (sea view estate) chevron lekki lagos,7,4,3,4,Luxury 3bed flat all rooms ensuite with fitted kitchen cabinets and wardrobes Exquisitely finished LOCATION; alpha beach road (sea view estate) New road opposite chevy view estate Price:1.7M per annum 600k service charge Agency: 10% Legal : 5% Service ... Serviced. Security. All Room Ensuit. Big Compound. Parking Space. Pop Ceiling. ...,lekki,0,0,0,0,lekki4,2500000.0,3500000.0,3000000.0,0,39,7,2000000
824,  off admiralty way lekki phase 1 lekki lagos,5,3,2,3,Serviced 2bedroom flats all rooms ensuite Price: 3.5m net per annum Service charge:40k monthly LOCATION: off admiralty way lekki PHASE one ... Serviced. Security. All Room Ensuit. Big Compound. Parking Space. Pop Ceiling. ...,lekki,1,1,1,1,lekki3,2000000.0,2500000.0,2500000.0,4,38,7,3500000
825,  van daniel road by eleganza bustop chevron lekki lagos,2,1,1,1,Newly renovated Miniflat (room and parlour self contained) NOTES PLS Price:550k per annum Rent for miniflat: 500k Legal fee: 50k Agency: 50k caution: 30k maintenance: 30k EKDC: 10k Total: 670k LOCATION: Van Daniel road by Eleganza bustop chevron lekki ... Renovated. Jacuzzi. Security. Big Compound. Parking Space. ...,lekki,0,0,0,0,lekki1,800000.0,1300000.0,1169999.9999999988,0,21,4,500000
826,  greenville estate agungi lekki lagos,2,1,1,1,Renovated room Self Contain LOCATION:Greenville Estate Agungi Lekki Lagos Price: 400k Agency:40k Legal:40k Caution:50k Service charge:100k Total package: 630k ... ...,lekki,0,0,0,0,lekki1,800000.0,1300000.0,1169999.9999999988,0,21,4,400000
827,  rose rock estate orchid road chevron drive lekki chevron lekki lagos,9,5,4,5,Tastefully finished 4bedroom terrace duplex with a BQ in a mini Estate Price; 3.2m per annum Sale options 40m LOCATION: *Rose Rock Estate off orchid road 2nd toll gate Chevron DRIVE lekki Lagos* ... Jacuzzi. Boys Quater. Security. All Room Ensuit. Big Compound. Parking Space. Pop Ceiling. ...,lekki,0,0,0,1,lekki5,3500000.0,5000000.0,4000000.0,1,48,9,3500000
828,  close to victory park estate osapa london osapa london lekki lagos,7,4,3,4,Newly Built 3 bedroom Terraced Duplex with a room Boys Quarter LOCATION: close to VICTORY park Estate Osapa london Lekki Lagos Price: 2.5m per annum ... New. Boys Quater. Security. All Room Ensuit. Big Compound. Parking Space. Pop Ceiling. ...,lekki,0,0,0,1,lekki4,2500000.0,3500000.0,3000000.0,1,39,7,2500000
829,  directly on spg road opposite argungi lekki ologolo lekki lagos,7,4,3,4,Tastefully finished Luxury 3bedroom.apartment all rooms ensuite with fitted kitchen cabinets and spacious compound LOCATION: directly on Spg road Opposite Argungi lekki For rent Rent 1.7m Agency 10% Legal 10% Caution 100k Maintenance fee 150k ... Security. All Room Ensuit. Big Compound. Parking Space. Pop Ceiling. ...,lekki,0,0,0,0,lekki4,2500000.0,3500000.0,3000000.0,0,39,7,2000000
830,  chevy view estate off chevron drive chevron lekki lagos,7,4,3,4,Fantastic 3bedroom apartment in a cerene neighbourhood with mordern facilities ... Serviced. Cheap. Renovated. Security. All Room Ensuit. Big Compound. Supermarket Nearby. Restaurants Nearby. Security Doors. Parking Space. Pop Ceiling. 24 Hours Security. Drainage System. Water Treatment. Church Nearby. ...,lekki,0,0,0,0,lekki4,2500000.0,3500000.0,3000000.0,0,39,7,2000000
831,  off road 12 lekki phase one lekki phase 1 lekki lagos,3,2,1,2,"Â  Â  Â  Â  Â  Â  Â  Â  Â  Â  Â  Â  Â  Serviced Studio Apartment Â  Â  Â  Â  Â ****Corporate ppl only*** 1. Serviced Studio apartmentÂ  @ yeye olofin street, lekki 1 Off road 12. Â  Â  R- 850k Â  Â  ... Serviced. Security. All Room Ensuit. Parking Space. Pop Ceiling. Printing Service. ...",lekki,0,0,0,0,lekki2,1500000.0,2000000.0,1700000.0,0,34,6,900000
832,  lekki phase 1 lekki lagos,7,4,3,4,Very nice and spacious 3bedrm terrace duplex with a room Boys Quarter Price: 3m per annum LOCATION: lekki PHASE one Lagos Nigeria ... Jacuzzi. Boys Quater. Security. All Room Ensuit. Big Compound. Parking Space. Pop Ceiling. ...,lekki,1,0,0,1,lekki4,2500000.0,3500000.0,3000000.0,2,39,7,3000000
833,  idado lekki lagos,5,3,2,3,"Self Serviced 2 Bedroom Flat Location : idado , Chevron Rent:1.5M Features : Fully interlocked premises fitted kitchen Security Inverter All rooms en suites Treated water supply Spacious living room Rent: 1.5M Caution:100k Self serviced Agency n legal ... New. Security. All Room Ensuit. Big Compound. Parking Space. Pop Ceiling. ...",lekki,0,0,0,0,lekki3,2000000.0,2500000.0,2500000.0,0,38,7,1500000
834,  environment agungi lekki lagos,2,1,1,1,Nice and well Self con Share apartment available in a Serene and Secured Environment in Agungi Lekki Lagos. Features: Standard room; Serene and cozy environment; fence and gated compound; good road network; good accessibility and ... ...,lekki,0,0,0,0,lekki1,800000.0,1300000.0,1169999.9999999988,0,21,4,500000
835,  alpha beach road chevron drive lekki chevron lekki lagos,5,3,2,3,"Executive 2bedroom semi detached duplex all rooms ensuite, 2 lovely sitting rooms with a room self-contained B/Q; high quality materials, garden, very large car park, interlock floor, fenced and gated compound, no other tenant in ... Boys Quater. Security. All Room Ensuit. Big Compound. Parking Space. Pop Ceiling. ...",lekki,0,0,0,0,lekki3,2000000.0,2500000.0,2500000.0,0,38,7,1500000
836,"  alpha beach road, new road chevron drive lekki chevron lekki lagos",7,4,3,4,"Distressed lettings Executive 3bedroom semi detached duplex all rooms ensuite, 2 lovely sitting rooms, high quality materials, garden, very large car park, interlock floor, fenced and gated compound, only 2 apartments (the duplex and a b/q) ... Jacuzzi. Boys Quater. Security. All Room Ensuit. Big Compound. Parking Space. Pop Ceiling. ...",lekki,0,0,0,0,lekki4,2500000.0,3500000.0,3000000.0,0,39,7,2400000
837,  ... osapa london lekki lagos,5,3,2,3,?? ?? ?? ?? ?? ?? ?? ?? ?? ?? !!! TO LET !!! Tastefully finished 2 bedroom flat Fully serviced apartment Rent - 1.7M Service charge - 500K Legal fee - 5% Agent fee - ... Serviced. Security. All Room Ensuit. Parking Space. Pop Ceiling. ...,lekki,0,0,0,0,lekki3,2000000.0,2500000.0,2500000.0,0,38,7,1700000
838,  in an estate by second toll gate oral estate lekki lagos,6,3,3,3,Newly built four bedroom semi detached estate by second toll gate. 8 units in the spacious premises. Each unit has it's own water tank and pumping machine. Ample parking space and enough grounds for children ... Serviced. New. All Room Ensuit. Big Compound. Supermarket Nearby. Restaurants Nearby. Security Doors. Parking Space. Pop Ceiling. 24 Hours Security. ...,lekki,0,0,0,1,lekki3,2000000.0,2500000.0,2500000.0,1,38,7,2000000
839,  buena vista estate orchid road chevron drive lekki lagos chevron lekki lagos,9,5,4,5,"To let: Newly built Smart 4Bedroom Semi-Detached With A BQ PRICE : N3.5m Caution Fee : N200k Location: Buena Vista Estate by Chevron Toll Gate by Orchid hotel Road, Lekki Lagos. Full Switchless Smart Home In The House - ... Serviced. New. Jacuzzi. Boys Quater. Security. All Room Ensuit. Big Compound. Security Doors. Parking Space. Pop Ceiling. 24 Hours Security. Street Lights. ...",lekki,0,0,0,1,lekki5,3500000.0,5000000.0,4000000.0,1,48,9,3500000
840,  bogije ibeju lekki lagos,5,3,2,3,"New and spacious Two bedroom Flat in a serene estate in Bogije, close to the express. All rooms ensuite with wardrobes. It has ample parking space, prepaid meter, kitchen cabinet, store and mini dining ... New. Dry. Security. All Room Ensuit. Big Compound. Supermarket Nearby. Restaurants Nearby. Security Doors. Parking Space. Pop Ceiling. Children Play Ground. 24 Hours Security. Drainage System. Water Treatment. ...",lekki,0,0,0,0,lekki3,2000000.0,2500000.0,2500000.0,0,38,7,1000000
841, new creation street 2nd round about by pinnacle petrol station lekki phase 1 lekki lagos,3,2,1,2,"Fantastic and spacious 1bedroom Apartment serviced Apartment LOCATION: New Creation Street, by 2nd roundabout pinnacle. Rent: 1.6m Agency:160k Agreement:160k Caution fee: 100k Service Charge:400k includes diesel deposits/gen ... Serviced. Security. All Room Ensuit. Parking Space. Pop Ceiling. 24 Hours Security. ...",lekki,0,0,0,1,lekki2,1500000.0,2000000.0,1700000.0,1,34,6,1600000
842,  esther adeleke lekki phase 1 lekki lagos,7,4,3,4,"Clean 3bedrm flat all rooms ensuite on 1st floor wit bq a LOCATION:Esther Adeleke Street, Lekki phase One. Price:N2.6m Self serviced ... Jacuzzi. Boys Quater. Security. All Room Ensuit. Parking Space. Pop Ceiling. ...",lekki,0,0,0,1,lekki4,2500000.0,3500000.0,3000000.0,1,39,7,2600000
843,  lekki phase 1 lekki lagos,9,5,4,5,Very nice and spacious 4bedroom terrace duplex LOCATION: Lekki PHASE one Lagos Price: 3.5million ... Security. All Room Ensuit. Big Compound. Parking Space. Pop Ceiling. Printing Service. ...,lekki,0,0,0,1,lekki5,3500000.0,5000000.0,4000000.0,1,48,9,3500000
844,  around dominoes pizza agungi lekki lagos,2,1,1,1,Nice and Standard Mini Flat available in a Serene and Secured Estate in Agungi Lekki Lagos. Features: Spacious Standard room; Serene and cozy environment; fence gated compound; good road network; good accessibility ... Security. Big Compound. Restaurants Nearby. Security Doors. Parking Space. Pop Ceiling. 24 Hours Security. ...,lekki,0,0,0,1,lekki1,800000.0,1300000.0,1169999.9999999988,1,21,4,1000000
845, .. lekki phase 1 lekki lagos,3,2,1,2,"Newly built mini flat within the heart of lekki 1. Only three tenants in a compound. Pop ceiling, guest toilet, master en-suite , robust water treatment plant; LED POP lighting all through. Each apartment has own pre ... New. Security. All Room Ensuit. Parking Space. Pop Ceiling. ...",lekki,1,0,0,1,lekki2,1500000.0,2000000.0,1700000.0,2,34,6,1700000
846,  chevron alternative routes lekki chevron lekki lagos,8,4,4,4,Neat and nice 3bedroom flat Very nice and large 3bedroom flats all rooms ensuite with fitted kitchen cabinets and wardrobes LOCATION:chevron alternative routes down stair very big and nice PRICE;1.8m cooperate and good client NEEDED service charge ... Jacuzzi. Security. All Room Ensuit. Parking Space. Pop Ceiling. ...,lekki,0,0,0,0,lekki4,2500000.0,3500000.0,3000000.0,0,39,7,2000000
847,  in an estate osapa london osapa london lekki lagos,7,4,3,4, Luxury 3bedroom Apartments LOCATION to let inside osapa london estate. Rent 3m Legal fees 10% Agency fees 10% Caution fees 200k ... New. Security. All Room Ensuit. Big Compound. Parking Space. Pop Ceiling. ...,lekki,1,0,0,1,lekki4,2500000.0,3500000.0,3000000.0,2,39,7,3000000
848,  grand view estate argungi lekki agungi lekki lagos,9,5,4,5,"4bedroom terrace duplex with swimming pool, gym and central gen LOCATION: grand view estate agungi before the bridge Price; 2.7m. service charge is 57k monthly, Generator schedule time: Week day is 7pm to 7am weekend is 20 hours ... Serviced. Jacuzzi. Boys Quater. Security. All Room Ensuit. Big Compound. Gym. Security Doors. Parking Space. Swimming Pool. Pop Ceiling. 24 Hours Security. ...",lekki,0,0,0,1,lekki5,3500000.0,5000000.0,4000000.0,1,48,9,3500000
849,  u3 estate by petrocam filling station lekki right lekki phase 1 lekki lagos,5,3,2,3, Spacious self service 2bedroom (upstairs) LOCATION:U3 Estate by Petrocam filing station LEKKI right. Renting Price = #2.3M ... Security. All Room Ensuit. Parking Space. Pop Ceiling. ...,lekki,0,0,0,1,lekki3,2000000.0,2500000.0,2500000.0,1,38,7,2300000
850,  by marwa bustop (just immediately after lekki phase 1) lekki phase 1 lekki lagos,2,1,1,1,"Well finished, furnished and serviced office space LOCATION: lekki by marwa bustop (just immediately after lekki PHASE 1) A bustop after lekki PHASE 1 very serene and secured environment with 24 hours guard and security, standby elevator, ... Serviced. Furnished. Security. Big Compound. Parking Space. 24 Hours Electricity. Pop Ceiling. 24 Hours Security. ...",lekki,0,0,0,0,lekki1,800000.0,1300000.0,1169999.9999999988,0,21,4,400000
851,  safecourts estate ikate ikate lekki lagos,8,5,3,5,"Luxury tastefully finished 3BEDROOM flats all rooms ensuite with fitted kitchen cabinets and fitted wardrobes comes with a room Boys Quarter Note: THIS IS RECENTLY RENOVATED ,WHICH IS ONE OF THE BEST Apartment in THE ... Serviced. Renovated. Jacuzzi. Boys Quater. Security. All Room Ensuit. Gym. Restaurants Nearby. Parking Space. 24 Hours Electricity. Pop Ceiling. 24 Hours Security. ...",lekki,0,0,0,1,lekki5,3500000.0,5000000.0,4000000.0,1,48,9,3500000
852,  the address home jakande lekki jakande lekki lagos,9,5,4,5,"Well maintained and serviced 4 bedroom semi detached house with BQ, swimming pool, gym, club house, children's play ground, etc. Rent: #5.5m per annum net. Service charge: 786,0000 per annum LOCATION: THE ADDRESS ... Serviced. Boys Quater. Cctv Cameras. Big Compound. Security Doors. 24 Hours Security. Street Lights. Jacuzzi. Security. All Room Ensuit. Parking Space. 24 Hours Electricity. Pop Ceiling. Children Play Ground. ...",lekki,1,1,1,1,lekki5,3500000.0,5000000.0,4000000.0,4,48,9,5500000
853,  prime water garden ikate lekki lagos,7,4,3,4,Newly Built Serviced and Furnished 3bedrm Apartment Price: 3.5m Service charge;500k LOCATION: prime water view Garden 2 ikate lekki We also have not furnished and serviced 3bedrm flats flats brand new with bq Price:3m Service charge:500k Same LOCATION ... Serviced. New. Furnished. Jacuzzi. Security. All Room Ensuit. Big Compound. Parking Space. Pop Ceiling. 24 Hours Security. ...,lekki,1,1,1,1,lekki4,2500000.0,3500000.0,3000000.0,4,39,7,3500000
854,  by abraham adesanya estate lekki gardens estate ajah lagos,7,4,3,4, Very nice superb 3 bedroom terrace duplex all rooms ensuite LOCATION:Lekki Gardens phase 2 by Abraham adesanya Price :1.6m Not new ... Jacuzzi. Security. All Room Ensuit. Big Compound. Parking Space. Pop Ceiling. ...,lekki,0,0,0,0,lekki4,2500000.0,3500000.0,3000000.0,0,39,7,2000000
855,  close to domino pizza agungi lekki lagos,3,2,1,2,A room and palor spacious mini flat Location agungi Price :900k Per annum upstairs Down flat:850k ... New. All Room Ensuit. Security. Parking Space. Pop Ceiling. ...,lekki,0,0,0,0,lekki2,1500000.0,2000000.0,1700000.0,0,34,6,900000
856,  igbo efon lekki igbo efon lekki lagos,3,2,1,2,Available for Rent 2Bedroom flat (ground floor) with 2toilet and 1bath LOCATION: igbo-Efon Lekki Prospective tenant should be gainfully employed. Rent 1m Agency 100k Legal 50k Caution Deposit 100k ... Parking Space. Big Compound. Security. ...,lekki,0,0,0,0,lekki2,1500000.0,2000000.0,1700000.0,0,34,6,1000000
857,  off durosinmi etti lekki phase 1 lekki lagos,11,6,5,6,Fantastic 5 bedroom fully detached duplex with bq LOCATION:off Durosinmi etti Lekki phase 1 Price:4.5m per anum. ... Jacuzzi. Parking Space. All Room Ensuit. Security. Pop Ceiling. Big Compound. ...,lekki,0,0,0,0,lekki6,5500000.0,6200000.0,6200000.0,0,54,10,4700000
858,  prime water view estate 2 ikate elegushi lekki lagos ikate lekki lagos,9,5,4,5," AVAILABLE FOR LEASE AT PRIME WATER VIEW ESTATE, PHASE II, IKATE LAGOS. Vacant, Tastefully Renovated, Fully Serviced and Luxuriously Finished 4 Bedroom Penthouse in a Spacious and Serene Environment with 2 Large ... Serviced. Renovated. Security Doors. Printing Service. Boys Quater. 24 Hours Security. Swimming Pool. Gym. Big Compound. Pop Ceiling. Street Lights. All Room Ensuit. Jacuzzi. Security. Water Treatment. Parking Space. 24 Hours Electricity. ...",lekki,1,1,1,1,lekki5,3500000.0,5000000.0,4000000.0,4,48,9,5000000
859,  yeye olofin lekki phase one lekki phase 1 lekki lagos,3,2,1,2,Spacious 1bedroom Apartment ensuite with fitted kitchen cabinets spacious compound LOCATION:yeye olofin lekki phase 1 Down stairs 1.5m Utilities 300k ... Serviced. All Room Ensuit. Parking Space. Pop Ceiling. Big Compound. Security. ...,lekki,0,0,0,1,lekki2,1500000.0,2000000.0,1700000.0,1,34,6,1500000
860,  off freedom way lekki phase one lagos lekki phase 1 lekki lagos,3,2,1,2,"Very nice and spacious 1bedroom Apartment up and downstairs Location:off freedom way ,lekki phase 1 Price: 1m, 1.2m and 1.4m Utilities 300k each. ... Serviced. Parking Space. All Room Ensuit. Big Compound. Pop Ceiling. Security. Cctv Cameras. ...",lekki,0,0,0,0,lekki2,1500000.0,2000000.0,1700000.0,0,34,6,1400000
861,  off tf kuboye street lekki phase one lekki phase 1 lekki lagos,7,4,3,4,"TO LET - SERVICED FLAT Serviced 3 bedroom flat all room en-suite Facilities; Swimming pool ???? security , Off TF kuboye street Lekki Scheme 1 Rent N3million / year Sales; N60 million Service charge ... New. Serviced. 24 Hours Electricity. Parking Space. Security. All Room Ensuit. 24 Hours Security. Big Compound. Jacuzzi. Pop Ceiling. ...",lekki,1,0,0,1,lekki4,2500000.0,3500000.0,3000000.0,2,39,7,3000000
862,  amen estate eleko ibeju lekki eleko ibeju lekki lagos,3,2,1,2,Well maintained 1bedroom Apartment Miniflats ( bungalow) Price: 800k per annum LOCATION; Eleko ibeju lekki Lagos ... Street Lights. Security. All Room Ensuit. Parking Space. Pop Ceiling. ...,lekki,0,0,0,0,lekki2,1500000.0,2000000.0,1700000.0,0,34,6,900000
863, amen estate eleko ibeju lekki lagos,9,5,4,5, 4 bedroom fully detached duplex plus 1 room BQ at the back LOCATION:inside Amen Estate Price:N4.5m per annum ... Jacuzzi. 24 Hours Security. Street Lights. Big Compound. Parking Space. 24 Hours Electricity. All Room Ensuit. Security. Security Doors. Pop Ceiling. Boys Quater. ...,lekki,1,0,1,1,lekki5,3500000.0,5000000.0,4000000.0,3,48,9,4500000
864, ilasan lekki lagos,9,5,4,5,"It's a fully serviced estate that also has a swimming pool, 24hrs security e.t.c Rent 3million Utilities 750k Power 1million ( phcn and generator) Caution 200k Agency 10% Legal 5% ... Dry. New. Serviced. Big Compound. All Room Ensuit. Parking Space. Drainage System. 24 Hours Security. Security. Swimming Pool. Street Lights. Pop Ceiling. Cctv Cameras. Security Doors. Water Treatment. Boys Quater. ...",lekki,0,0,0,1,lekki5,3500000.0,5000000.0,4000000.0,1,48,9,3500000
865, chevron lekki lagos,11,6,5,6,5 bedroom Detached Duplex House for rent chevron Lekki Lagos ... New. ...,lekki,0,0,0,0,lekki6,5500000.0,6200000.0,6200000.0,0,54,10,4700000
866, chevron lekki lagos,9,5,4,5,4 bedroom House for rent chevron Lekki Lagos ... New. ...,lekki,0,0,0,1,lekki5,3500000.0,5000000.0,4000000.0,1,48,9,3500000
867, lekki phase 1 lekki lagos,9,5,4,5,Location: lekki phase 1 Price: 5 million Features: â€¢ All Ensuite â€¢ Stamp Concrete Floor â€¢ Kitchen store â€¢ Fully Fitted Kitchen â€¢ Bathtub â€¢ easily accessible For enquiries contact Michael on +234 810 020 3228 ... All Room Ensuit. Pop Ceiling. ...,lekki,1,1,1,1,lekki5,3500000.0,5000000.0,4000000.0,4,48,9,5000000
868, lekki phase 1 lekki lagos,11,6,5,6,A tastefully built 5 bedroom fully semi house for rent. Located in a wonderful environment suitable for bringing up kids. Location- Lekki phase 1 Price is 6.5m Features- â€¢ All rooms en-suite â€¢ 2living rooms â€¢ 1 room bq â€¢ ... All Room Ensuit. Parking Space. Pop Ceiling. Jacuzzi. Water Treatment. Boys Quater. ...,lekki,1,1,0,1,lekki6,5500000.0,6200000.0,6200000.0,3,54,10,6200000
869, osapa london lekki lagos,5,3,2,3,2 bedroom Flat / Apartment for rent Osapa london Lekki Lagos ... ...,lekki,0,0,0,0,lekki3,2000000.0,2500000.0,2500000.0,0,38,7,1700000
870, ikate lekki lagos,9,5,4,5,It's a single unit of 4bedroom duplex attached to blocks of flats. Rent 2.9mill Service fee 550k Caution 100k Tenants will contribute monthly for the purchase of diesel. Agency 10% Legal 10% ... New. Big Compound. Supermarket Nearby. All Room Ensuit. Parking Space. Pop Ceiling. Water Treatment. Security. ...,lekki,0,0,0,1,lekki5,3500000.0,5000000.0,4000000.0,1,48,9,3500000
871, agungi lekki lagos,9,5,4,5,"Spacious 4-Bedroom Semi-Detached House with BQ Rent: N3M Location: BERA Estate, Agungi/Chevron Features; Security Gatehouse, Prepaid Meter, Portable Water from a estate's Main Supply, Spacious Living Areas etc For enquiries, call 09093662343 ... New. All Room Ensuit. Children Play Ground. Water Treatment. ...",lekki,0,0,0,1,lekki5,3500000.0,5000000.0,4000000.0,1,48,9,3500000
872, ologolo lekki lagos,3,2,1,2,Note: It's on the ground floor and none of the rooms are ensuite Rent 1.5million ( negotiable) Service fee 400k ( inclusive of gas supply) Power #65/kilowatt Caution 100k Agency 10% Legal 5% ... Dry. Renovated. Serviced. Street Lights. Big Compound. Supermarket Nearby. Parking Space. Pop Ceiling. Drainage System. 24 Hours Security. Water Treatment. Security. ...,lekki,0,0,0,1,lekki2,1500000.0,2000000.0,1700000.0,1,34,6,1500000
873, ikota villa estate ikota lekki lagos,9,5,4,5,"Brand New 4-Bedroom Semi-Detached House with BQ Location: Ikota Villa Estate Rent: N3.5M Features; Borehole with Treatment Plant, All Rooms Ensuite, Fully Fitted kitchen, BQ etc For more enquiries, call 09093662343 ... New. All Room Ensuit. Parking Space. Pop Ceiling. Jacuzzi. Boys Quater. ...",lekki,0,0,0,1,lekki5,3500000.0,5000000.0,4000000.0,1,48,9,3500000
874, jakande lekki lagos,7,4,3,4,"Brand New 3-Bedroom Terrace House with 2-Room BQ; Location: Jakande, Lekki Price: N2.8M Features; 2 Units in a compound, Prepaid Meter, Self-Serviced, All Room Ensuite, 2-room BQ etc For more enquiries, call 09093662343 ... New. Swampy. All Room Ensuit. Parking Space. Boys Quater. ...",lekki,0,0,0,1,lekki4,2500000.0,3500000.0,3000000.0,1,39,7,2800000
875, lekki phase 1 lekki lagos,9,5,4,5,Nicely built five bedroom semi-detached house for rent located at lekki phase 1. Features: En-suite rooms Easily accessible Spacious rooms Price -6.5million Call for Michael at +234 810 020 3228 for more details and tour guide ... All Room Ensuit. Parking Space. Pop Ceiling. ...,lekki,1,1,1,1,lekki5,3500000.0,5000000.0,4000000.0,4,48,9,5600000
876, lekki phase 1 lekki lagos,7,4,3,4,"Newly built 3 Bedroom serviced apartment with BQ for Lease Location: Lekki Right Features: All rooms en-suite, Boys quarters, swimming pool, 24 hours electricity, 24 hours security, Spacious compound, Penthouse space Rent 3 million Service Charge: 1.5 million and ... New. 24 Hours Electricity. All Room Ensuit. Parking Space. Pop Ceiling. 24 Hours Security. Boys Quater. Swimming Pool. ...",lekki,1,0,0,1,lekki4,2500000.0,3500000.0,3000000.0,2,39,7,3000000
877, ikota lekki lagos,7,4,3,4,"It's a newly built apartment in a very serene estate in ikota ( back of mega chicken) with good roads and security. Rent 1.8 Million Naira Self serviced Caution 100,000 Naira Agency 10% Legal 10% ... Dry. New. Street Lights. Big Compound. Supermarket Nearby. All Room Ensuit. Parking Space. Pop Ceiling. 24 Hours Security. Security. ...",lekki,0,0,0,0,lekki4,2500000.0,3500000.0,3000000.0,0,39,7,2000000
878, lekki phase 1 lekki lagos,11,6,5,6,Newly built 5 Bedroom semi Detached Duplex with a BQ for rent Location: lekki phase 1 Price: 7.5million Features: â€¢ All Ensuite â€¢ Stamp Concrete Floor â€¢ Kitchen store â€¢ Fully Fitted Kitchen â€¢ Bathtub â€¢ easily accessible Swimming pool For enquiries contact Michael on +234 ... New. All Room Ensuit. Parking Space. Boys Quater. Swimming Pool. ...,lekki,1,1,0,1,lekki6,5500000.0,6200000.0,6200000.0,3,54,10,6200000
879, lekki phase 1 lekki lagos,9,5,4,5,Nicely built 4 Bedroom terrace with a BQ for rent Location: lekki phase 1 Price: 5million Features: â€¢ All Ensuite â€¢ Stamp Concrete Floor â€¢ Kitchen store â€¢ Fully Fitted Kitchen â€¢ Bathtub â€¢ easily accessible For enquiries contact Michael on +234 810 020 3228 ... All Room Ensuit. Parking Space. ...,lekki,1,1,1,1,lekki5,3500000.0,5000000.0,4000000.0,4,48,9,5000000
880, agungi lekki lagos,9,5,4,5,4 bedroom Detached Duplex House for rent Agungi Lekki Lagos ... ...,lekki,0,0,0,1,lekki5,3500000.0,5000000.0,4000000.0,1,48,9,3500000
881, osapa london lekki lagos,7,4,3,4,Rent 2million Caution 150k Maintenance fee 180k Agency 10% Legal 5% ... Renovated. Supermarket Nearby. All Room Ensuit. Pop Ceiling. Security Doors. Water Treatment. Security. ...,lekki,0,0,0,0,lekki4,2500000.0,3500000.0,3000000.0,0,39,7,2000000
882, idado lekki lagos,11,6,5,6,"5-Bedroom Fully-Detached House with BQ Rent: N3.5M Location: Idado, Lekki Features; Security Gatehouse, Borehole with Treatment Plant, Fitted Spacious Living Areas, All Rooms Ensuite etc For enquiries, call 09093662343 ... New. All Room Ensuit. Parking Space. Water Treatment. Boys Quater. ...",lekki,0,0,0,0,lekki6,5500000.0,6200000.0,6200000.0,0,54,10,4700000
883, ikate lekki lagos,5,3,2,3,Rent 2million ( 3 units of 2bedrooms still available but not for long) Service fee 450k Caution 100k Diesel contributions to be shared among the tenants monthly Agency 10% Legal 10% ... Dry. New. Big Compound. Supermarket Nearby. All Room Ensuit. Parking Space. Pop Ceiling. 24 Hours Security. Water Treatment. Security. ...,lekki,0,0,0,1,lekki3,2000000.0,2500000.0,2500000.0,1,38,7,2000000
884, ikota lekki lagos,9,5,4,5,"It's a fully serviced estate that has both 4bedroom terraces and semi detached duplexes for rent. Rent 3million Service fee inclusive of diesel fee, estate dues, security, water treatment, cleaning, waste disposal e.t.c costs #43000 monthly ... Dry. New. Serviced. Big Compound. 24 Hours Electricity. All Room Ensuit. Parking Space. Drainage System. 24 Hours Security. Restaurants Nearby. Security. Swimming Pool. Street Lights. Pop Ceiling. Cctv Cameras. Security Doors. Water Treatment. Boys Quater. ...",lekki,0,0,0,1,lekki5,3500000.0,5000000.0,4000000.0,1,48,9,3500000
885, ikate lekki lagos,5,3,2,3,Rent 2.5million Utilities bill 250k Caution 150k Agency 10% Legal 5% ... New. Big Compound. Supermarket Nearby. All Room Ensuit. Parking Space. Pop Ceiling. Security Doors. Water Treatment. Security. ...,lekki,1,1,0,1,lekki3,2000000.0,2500000.0,2500000.0,3,38,7,2500000
886, chevron lekki lagos,7,4,3,4,Brand New Serviced 3-Bedroom Flat with BQ for Rent (Ground Floor) Location: Chevron Rent: N3M Service Charge: N500K per annum ... Serviced. Supermarket Nearby. All Room Ensuit. Parking Space. Boys Quater. ...,lekki,1,0,0,1,lekki4,2500000.0,3500000.0,3000000.0,2,39,7,3000000
887, lekki phase 1 lekki lagos,3,2,1,2,"One bedroom rental price is 800,000. Service Charge 10%, Electricity Pay as you use, damages 10%... ... ...",lekki,0,0,0,0,lekki2,1500000.0,2000000.0,1700000.0,0,34,6,900000
888, idado lekki lagos,7,4,3,4,Note: what we have available is on the ground floor. Rent 2million Caution 100k Service fee inclusive of diesel fee 800k Agency 10% Legal 5% ... Serviced. Big Compound. Supermarket Nearby. All Room Ensuit. Parking Space. Pop Ceiling. Security Doors. Water Treatment. Boys Quater. Security. ...,lekki,0,0,0,0,lekki4,2500000.0,3500000.0,3000000.0,0,39,7,2000000
889, agungi lekki lagos,7,4,3,4,"It's located in a serene close, What we have available is on the ground floor. Rent 1.7million Caution 100k Agency 10% Legal 5% ... Dry. Renovated. Big Compound. Supermarket Nearby. All Room Ensuit. Parking Space. Pop Ceiling. Security Doors. Security. ...",lekki,0,0,0,0,lekki4,2500000.0,3500000.0,3000000.0,0,39,7,2000000
890, lekki phase 1 lekki lagos,7,4,3,4,3 bedroom Flat / Apartment for rent Lekki Phase 1 Lekki Lagos ... Big Compound. 24 Hours Electricity. All Room Ensuit. 24 Hours Security. ...,lekki,0,0,0,1,lekki4,2500000.0,3500000.0,3000000.0,1,39,7,2700000
891, lekki phase 1 lekki lagos,10,5,5,5,4 bedroom House for rent Lekki Phase 1 Lekki Lagos ... ...,lekki,1,1,1,1,lekki5,3500000.0,5000000.0,4000000.0,4,48,9,5000000
892, ikate lekki lagos,9,5,4,5,4 bedroom House for rent Ikate Lekki Lagos ... New. 24 Hours Electricity. ...,lekki,0,0,0,1,lekki5,3500000.0,5000000.0,4000000.0,1,48,9,3500000
893, lekki phase 1 lekki lagos,7,4,3,4,"For more information, pricing and private viewings, please contact: Freke: 09062511345 Daniel: 09093272547 hello@cwlagos Or send us a DM on Instagram @cwrelagos Twitter: @cwrelagos Facebook: @cwrelagos Email : hello@cwlagos.com Twitter: @cwrelagos Facebook: @cwrelagos Email : hello@cwlagos.com Website: www.cwlagos.com ... New. Big Compound. 24 Hours Electricity. All Room Ensuit. 24 Hours Security. C Of O. Water Treatment. Swimming Pool. ...",lekki,0,0,0,0,lekki4,2500000.0,3500000.0,3000000.0,0,39,7,2000000
894, lekki phase 1 lekki lagos,9,5,4,5,"Brand New 4-Bedroom Terrace House with a BQ Features: All rooms en-suite, Two living rooms, Fitted kitchen, Ample parking, CCTV, 24 hours, Fire Alarm system, Steady power supply with backup generators, 1 BQ Price: Rent 6,000,000 Service Charge: ... New. Serviced. All Room Ensuit. Parking Space. Cctv Cameras. Free Coffee. Boys Quater. ...",lekki,1,1,1,1,lekki5,3500000.0,5000000.0,4000000.0,4,48,9,5600000
895, ikota lekki lagos,9,5,4,5,"Beautifully built 4 bedroom terrace duplex Location: Ikota Features: All rooms en-suite, Fully fitted kitchen, CCTV Cameras, In-house speakers, Ample parking space, Serene environment. Price: Rent: 3 Million Sale: 35 Million Contact Chidi on +234 808 216 3583 for enquiries MORTGAGE ... New. All Room Ensuit. Parking Space. Cctv Cameras. ...",lekki,0,0,0,1,lekki5,3500000.0,5000000.0,4000000.0,1,48,9,3500000
896, lafiaji lekki lagos,7,4,3,4,"Brand New Serviced 3-Bedroom Terrace with BQ Location: Lafiaji, Lekki Rent: N2.5M SC: N650K Features; Swimming Pool, 24hours Power Supply, All Rooms Ensuite, Fitted kitchen, Borehole with Treatment Plant etc For more enquiries, call [redacted] ... New. All Room Ensuit. Parking Space. Pop Ceiling. Boys Quater. ...",lekki,0,0,0,1,lekki4,2500000.0,3500000.0,3000000.0,1,39,7,2500000
897, ikate lekki lagos,5,3,2,3,This is a lovely and portable 2bedroom flat for rent in a serene area of ikate Elegushi Lekki Lagos. Just two tenants in d compound. Rent 2million Caution 100k Self serviced Agency 10% Legal 5% ... Dry. Renovated. Cheap. Street Lights. Supermarket Nearby. All Room Ensuit. Parking Space. Pop Ceiling. Water Treatment. ...,lekki,0,0,0,1,lekki3,2000000.0,2500000.0,2500000.0,1,38,7,2000000
898, jakande lekki lagos,9,5,4,5,"Brand New Serviced 4-Bedroom House with BQ Location: Jakande Rent: N3.5M SC: N500K Features; Large Rooftop Terrace, Fitted Kitchen, All Rooms Ensuite, BQ, Family Lounge etc For more enquiries, call 09093662343 ... Serviced. All Room Ensuit. Parking Space. Boys Quater. ...",lekki,0,0,0,1,lekki5,3500000.0,5000000.0,4000000.0,1,48,9,3500000
899, ikota lekki lagos,7,4,3,4,"It's a Lovely and Decent 3 Bedroom Flat ( Back of Mega chicken Ikota) Rent 1.6 Million Naira Caution 100,000 Naira Agency 10% Legal 5 % ... Dry. Renovated. Street Lights. All Room Ensuit. Pop Ceiling. Drainage System. ...",lekki,0,0,0,0,lekki4,2500000.0,3500000.0,3000000.0,0,39,7,2000000
900, osapa london lekki lagos,8,4,4,4,"It can be rented without the bq at 2.5million If rented with the bq, it will cost 3million. Everything tenant comes with their own generator. ... Dry. Renovated. Street Lights. Big Compound. Supermarket Nearby. All Room Ensuit. Parking Space. Pop Ceiling. Security Doors. Water Treatment. Boys Quater. ...",lekki,1,0,0,1,lekki4,2500000.0,3500000.0,3000000.0,2,39,7,3000000
901, ikate lekki lagos,11,6,5,6,"Newly Built 5 bedroom detached duplex with 1 room BQ located in Ikate, Lagos Features -All rooms en-suite -Fully fitted kitchen with microwave, oven, gas cooker, heat extractor and refrigerator - Jacuzzi - Walk-in closet Price: 6 Million per year Call Bola ... New. Big Compound. All Room Ensuit. Pop Ceiling. Drainage System. 24 Hours Security. Jacuzzi. Security Doors. ...",lekki,0,0,0,1,lekki6,5500000.0,6200000.0,6200000.0,1,54,10,6000000
902, lafiaji lekki lagos,5,3,2,3,"Brand New Serviced 2-Bedroom Flat for Rent; Location: Lafiaji, Lekki Rent: N1.8M SC: N650K Features; Swimming Pool, 24hours Power Supply, All Rooms Ensuite, Fitted kitchen, Borehole with Treatment Plant etc For more enquiries, call [redacted] ... New. Parking Space. Pop Ceiling. All Room Ensuit. ...",lekki,0,0,0,0,lekki3,2000000.0,2500000.0,2500000.0,0,38,7,1800000
903, ikate lekki lagos,9,5,4,5,"Serviced 4 Bedroom Terraced Duplex Location: Ikate. Rent: N3,500,000.00 S/C: N650,000.00 Features: All rooms en-suite, Fitted kitchen, 18hrs light, Ample parking space, Spacious living areas, Serene and secured environment. Kindly contact Chidi on +234 808 216 3583 for more ... New. Serviced. All Room Ensuit. Parking Space. Pop Ceiling. ...",lekki,0,0,0,1,lekki5,3500000.0,5000000.0,4000000.0,1,48,9,3500000
904, idado lekki lagos,7,4,3,4,"Neat and serviced 3 bedroom flat Location: Idado, Lekki. Rent: N2,000,000.00 Service Charge: N900,000 P/A (Diesel inclusive) Generator running time - 18hrs Features: -All rooms en-suite. -Fitted kitchen -Ample parking space -Serene and secured environment -POP ceiling Kindly contact Chidi on [redacted] for more ... New. Serviced. Parking Space. Pop Ceiling. All Room Ensuit. ...",lekki,0,0,0,0,lekki4,2500000.0,3500000.0,3000000.0,0,39,7,2000000
905, ologolo lekki lagos,7,4,3,4,"3 Bedroom Flat at Ologolo, Lekki For rent at N1.5m caution at N150k ... Cheap. Dry. New. Big Compound. Pop Ceiling. Security. All Room Ensuit. Parking Space. Water Treatment. Security Doors. ...",lekki,0,0,0,0,lekki4,2500000.0,3500000.0,3000000.0,0,39,7,2000000
906, bera estate chevron lekki lagos,9,5,4,5,"4 Bedroom Semi Detached Duplex with BQ at Bera Estate, Chevron For rent at N3.5m ... Cheap. Dry. Big Compound. Pop Ceiling. Security. All Room Ensuit. Parking Space. Water Treatment. Security Doors. Boys Quater. 24 Hours Security. ...",lekki,0,0,0,1,lekki5,3500000.0,5000000.0,4000000.0,1,48,9,3500000
907, lekki phase 1 lekki lagos,3,2,1,2,Self Serviced Mini Flat within Lekki Phase 1 For rent at N1.3m ... Dry. Big Compound. Security. All Room Ensuit. Parking Space. Water Treatment. ...,lekki,0,0,0,0,lekki2,1500000.0,2000000.0,1700000.0,0,34,6,1300000
908, lekki phase 1 lekki lagos,3,2,1,2,Serviced Mini Flat within Lekki Phase 1 (For Corporate Workers only) Rent - N1.8m (Slightly Negotiable) Utilities - N300k Gen & Diesel - N38.1k monthly. Gen times 7pm to 7am. weekdays 12noon to 3pm. Weekends. ... Serviced. Dry. New. Big Compound. Security. All Room Ensuit. Parking Space. Water Treatment. Security Doors. 24 Hours Security. ...,lekki,1,0,0,1,lekki2,1500000.0,2000000.0,1700000.0,2,34,6,1800000
909, eru-ifa ikate lekki lagos,7,4,3,4,"NEWLY BUILT FULLY SERVICED 3 BEDROOM FLAT WITH A ROOM SERVANT QUARTER FEATURES INCLUDE: 2 STAND BY GENERATORS AMPLE PARKING SPACE ALL ROOMS ENSUITE AND FITTED WITH AC FULLY FITTED KITCHEN' BQ PORTABLE WATER, WATER TREATMENT PLANT SECURITY POST, 24/7 SECURITY GUARD SERVICE CHARGE ... Serviced. New. Street Lights. Big Compound. Security. All Room Ensuit. Parking Space. 24 Hours Electricity. Supermarket Nearby. Water Treatment. Security Doors. Boys Quater. 24 Hours Security. Church Nearby. ...",lekki,1,0,0,1,lekki4,2500000.0,3500000.0,3000000.0,2,39,7,3000000
910, lekki phase 1 lekki lagos,11,6,5,6,"5 Bedroom Detached Duplex in a Very Spacious Compound off Admiralty, Lekki Phase 1 For Rent at N6m ... Renovated. Cheap. Dry. Big Compound. Pop Ceiling. Security. All Room Ensuit. Parking Space. Water Treatment. Security Doors. ...",lekki,0,0,0,1,lekki6,5500000.0,6200000.0,6200000.0,1,54,10,6000000
911, orchid lafiaji lekki lekki lagos,9,5,4,5," lovely 4bedroom semi detach duplex with Bq for rent at lafiaji lekki the house is well finished with qaulity matarials , all room en suite with visitors toilet, very big living room with dinning area, fitted ... ...",lekki,0,0,0,1,lekki5,3500000.0,5000000.0,4000000.0,1,48,9,3500000
912, igbo efon lekki lagos,7,4,3,4,"3 Bedroom Flat at Igbo-Efon, Lekki For rent at N1.3m Caution at N100k ... Renovated. Cheap. Dry. Big Compound. Security. All Room Ensuit. Parking Space. ...",lekki,0,0,0,0,lekki4,2500000.0,3500000.0,3000000.0,0,39,7,2000000
913, lekki phase 1 lekki lagos,3,2,1,2,Mini Flat within Lekki Phase 1 For rent at N1.5m ... Cheap. Dry. Big Compound. Security. Parking Space. Water Treatment. ...,lekki,0,0,0,1,lekki2,1500000.0,2000000.0,1700000.0,1,34,6,1500000
914, lekki lekki phase 1 lekki lagos,8,4,4,4,"Brand new and beautiful 3 bedroom apartments For corporate tenants only Features: Large living room Fully fitted kitchen Manager's office Maids room Water treatment facility Generator house Gate house Large Parking area Bar Gym Swimming pool Rent: N3.5M per annum Service charge: N850k per annum Location: Marwa, Lekki (Ocean Side) ... Serviced. Cheap. Furnished. New. Swimming Pool. Security. Water Treatment. ...",lekki,1,1,1,1,lekki4,2500000.0,3500000.0,3000000.0,4,39,7,3500000
915," lekki phase 1,right lekki phase 1 lekki lagos",9,5,4,5,"Tastefully finished luxury 4 bedroom Terrace with bq. Located in Lekki phase one right side off white sand school road. Features include include; 24/7 power,CCTV cameras, ample parking space, 24/7 security guard, portable water, bq,3 ... Serviced. New. Big Compound. All Room Ensuit. 24 Hours Electricity. Water Treatment. Boys Quater. 24 Hours Security. ...",lekki,1,1,1,1,lekki5,3500000.0,5000000.0,4000000.0,4,48,9,5500000
916, lafiaji lekki lagos,9,5,4,5,Detail: Brand new 4bedroom terraced Duplex â€¢ All bedrooms en suit â€¢ Jacuzzi and modern-day bathroom and toilets accessories. â€¢ Word class standards tiles and lovely wardrobes â€¢ Standard security doors â€¢ Visitorâ€™s convenience â€¢ European standard wall socket and ... ...,lekki,0,0,0,1,lekki5,3500000.0,5000000.0,4000000.0,1,48,9,3500000
917, chevy view estate lekki chevron lekki lagos,9,5,4,5,"A Contemporary 4Bedroom semi detach duplex with bq Located in lovely area at chevy view estate lekki. The the semi detach duplex comes with a large sitting room with dinning area , all en suite ... ...",lekki,0,0,0,1,lekki5,3500000.0,5000000.0,4000000.0,1,48,9,3500000
918, lekki county homes lekki abule egba lagos,7,4,3,4," County Apartments is a home to dream of with first class luxury interior finishing and modern facilities. To make life really simple and pleasurable for you, weâ€™ve made our homes not just modern but smart. County ... ...",lekki,1,1,1,1,lekki4,2500000.0,3500000.0,3000000.0,4,39,7,4300000
919, chevron lekki chevron lekki lagos,9,5,4,5, Detail: Brand semi detached duplex â€¢ All bedrooms en suit â€¢ Jacuzzi and modern-day bathroom and toilets accessories. â€¢ Word class standards tiles and lovely wardrobes â€¢ Standard security doors â€¢ Visitorâ€™s convenience â€¢ European ... ...,lekki,0,0,0,1,lekki5,3500000.0,5000000.0,4000000.0,1,48,9,3500000
920, off durosimi etti street lekki phase 1 lekki lagos,7,4,3,4,"Well finished 3 bedroom flat with a room bq located off Durosimi Etti street Lekki phase one. Features include;high ceiling, fitted kitchen, balcony, laundry area,bq,all rooms ensuite and fitted with AC, back exit. Rent N3,500,000. ... Serviced. Cheap. Dry. C Of O. Street Lights. Water Treatment. Boys Quater. Drainage System. Survey. 24 Hours Security. Big Compound. Security. All Room Ensuit. 24 Hours Electricity. Supermarket Nearby. Security Doors. ...",lekki,1,1,1,1,lekki4,2500000.0,3500000.0,3000000.0,4,39,7,3500000
921, ologolo lekki lagos,5,3,2,3,"Beautifully Built 2 Bedroom Flat at Ologolo, Lekki For rent at N1.3m (slightly negotiable) SC at N360k ... Serviced. Renovated. Cheap. Dry. Big Compound. Pop Ceiling. Security. Parking Space. ...",lekki,0,0,0,0,lekki3,2000000.0,2500000.0,2500000.0,0,38,7,1300000
922, chevron chevron lekki lagos,7,4,3,4, THis is lovely 3bedroom flat for rent at bera estate chevron lekki Price: 1.7M Contact: 4Tee Pproperties 08138626902 07083675988 ... ...,lekki,0,0,0,0,lekki4,2500000.0,3500000.0,3000000.0,0,39,7,2000000
923, lekki phase 1 lekki lagos,7,4,3,4,Lovely 3 Bedroom Terraced Duplex with BQ at Lekki Phase 1 For rent at N3.7m SC at N500k (Exclusive of Gen/power) caution at N150k ... Serviced. Renovated. Cheap. Dry. Swimming Pool. Big Compound. Pop Ceiling. Restaurants Nearby. Security. All Room Ensuit. Parking Space. Water Treatment. Security Doors. 24 Hours Security. ...,lekki,1,1,1,1,lekki4,2500000.0,3500000.0,3000000.0,4,39,7,3700000
924, ajiran rd agungi lekki lagos,2,1,1,1,"2 Rooms office space along the Ajiran road, Agungi For rent at N1m SC about N40k (Undecided) ... Serviced. Renovated. Furnished. Dry. Big Compound. Security. All Room Ensuit. Parking Space. 24 Hours Electricity. 24 Hours Security. ...",lekki,0,0,0,1,lekki1,800000.0,1300000.0,1169999.9999999988,1,21,4,1000000
925, orchid lekki phase 2 lekki lagos,9,5,4,5,"4 Bedroom Detached Duplex For Rent Location: 2nd Toll Gate, Lekki, Lagos?????? Price: 4.5m Features: - All Rooms Ensuite - New - Fully Fitted Kitchen - CCTV Cameras - Indoor Speakers - 1 Boyâ€™s Quarter - Water Heaters - Walk-in Shower â€¢â€¢â€¢â€¢â€¢â€¢â€¢â€¢â€¢â€¢â€¢â€¢â€¢â€¢â€¢â€¢â€¢â€¢â€¢â€¢â€¢â€¢â€¢â€¢â€¢â€¢â€¢â€¢â€¢â€¢â€¢â€¢â€¢â€¢â€¢â€¢â€¢â€¢â€¢â€¢â€¢â€¢â€¢â€¢â€¢â€¢â€¢â€¢â€¢ ?? 08133355522 ?? info@ramosoflagosrealty.com ... New. Street Lights. Swimming Pool. Pop Ceiling. Security. All Room Ensuit. Cctv Cameras. Parking Space. Jacuzzi. Boys Quater. Governor's Consent. Drainage System. 24 Hours Security. ...",lekki,1,0,1,1,lekki5,3500000.0,5000000.0,4000000.0,3,48,9,4500000
926, off victoria arubieke. lekki phase 1 lekki lagos,2,1,1,1,"Well finished service one bedroom flat off Victoria Arubieke street Lekki phase one. Features include, swimming pool, stand by generator, 12hours generator power, ensuite room with fitted AC, 24/7 security guard ample parking space, portable ... Serviced. Cheap. Dry. Street Lights. Swimming Pool. Big Compound. Pop Ceiling. Security. All Room Ensuit. Supermarket Nearby. Fast Internet. Water Treatment. Drainage System. Survey. 24 Hours Security. ...",lekki,1,1,1,1,lekki1,800000.0,1300000.0,1169999.9999999988,4,21,4,1700000
927, fatai arubieke street lekki phase 1 lekki lagos,7,4,3,4,"Fully Serviced 3 bedroom flat with a room servant quarter located on Fatai Arubieke street Lekki phase one. Suitable for office use only. Rent N4,000,000 per annum service charge is N1,500,000 ... Serviced. Dry. C Of O. Street Lights. Big Compound. Restaurants Nearby. Security. All Room Ensuit. Water Treatment. Security Doors. Boys Quater. Survey. ...",lekki,1,1,1,1,lekki4,2500000.0,3500000.0,3000000.0,4,39,7,4000000
928, lekki phase 1 lekki lagos,9,5,4,5,Tastefully finished 4 bedroom Terrace with a room bq Located off ladipo latinwo lekki phase one. Features include 24/7 power 24/7 security guard Ample parking space Portable water CCTV cameras Fully fitted kitchen Fitted AC's Rent is ... Serviced. Cheap. Furnished. Dry. C Of O. Street Lights. Swimming Pool. Parking Space. Fast Internet. Water Treatment. Boys Quater. Drainage System. Survey. 24 Hours Security. Big Compound. Pop Ceiling. Security. All Room Ensuit. Cctv Cameras. 24 Hours Electricity. Supermarket Nearby. Security Doors. ...,lekki,1,1,1,1,lekki5,3500000.0,5000000.0,4000000.0,4,48,9,5000000
929, idado lekki lagos,7,4,3,4,"3 Bedroom Flat at Idado, Lekki For rent at N2m ... Dry. New. Big Compound. Pop Ceiling. Security. All Room Ensuit. Parking Space. Water Treatment. ...",lekki,0,0,0,0,lekki4,2500000.0,3500000.0,3000000.0,0,39,7,2000000
930, lekki phase 1 lekki lagos,11,6,5,6,5 Bedrrom Semi detached duplex with BQ For rent at N5.5m caution at N200k ... Renovated. Cheap. Dry. Big Compound. Pop Ceiling. Security. All Room Ensuit. Parking Space. Jacuzzi. Water Treatment. Security Doors. ...,lekki,0,0,0,1,lekki6,5500000.0,6200000.0,6200000.0,1,54,10,5500000
931, lekki phase 1 lekki lagos,5,3,2,3,Serviced 2 Bedroom Duplex within Lekki Phase 1 For Rent at N2.5m SC at N500k ... Serviced. Dry. Big Compound. Pop Ceiling. Security. All Room Ensuit. Parking Space. Water Treatment. 24 Hours Security. ...,lekki,1,1,0,1,lekki3,2000000.0,2500000.0,2500000.0,3,38,7,2500000
932, grace anjounse lekki phase 1 lekki lagos,5,3,2,3,"WELL FINISHED 2 BEDROOM FLAT WITH A ROOM BQ FEATURES INCLUDE; FULLY FITTED KITCHEN WITH GAS COOKER, MICROWAVE, OVEN, FRIDGE, AC, WASHING MACHINE. SWIMMING POOL,GYM, CCTV CAMERAS, WATER TREATMENT PLANT, 24/7 POWER, 24/7 SECURITY GUARD. ALL ROOMS ENSUITE AND ... Serviced. New. Street Lights. Swimming Pool. Parking Space. Gym. Water Treatment. Boys Quater. Drainage System. 24 Hours Security. Church Nearby. Big Compound. Children Play Ground. Security. All Room Ensuit. Cctv Cameras. 24 Hours Electricity. Supermarket Nearby. Security Doors. ...",lekki,1,1,1,1,lekki3,2000000.0,2500000.0,2500000.0,4,38,7,3000000
933, agungi lekki agungi lekki lagos,9,5,4,5," This is a lovely 4bedroom semi detach duplex for rent at agung lekki. its newly renovated house , all room en suite with visitors toilet , big living room with dinning area, ... ...",lekki,0,0,0,1,lekki5,3500000.0,5000000.0,4000000.0,1,48,9,3500000
934, chief collins lekki phase 1 lekki lagos,5,3,2,3,"Fully Serviced 3 bedroom flat with a room servant quarter Features Include; 24/7 security, cctv cameras, ample parking space 18 hours Generator Power daily,bq,ample parking space, fitted AC's,guest toilet Service Charge is N1,500,000 Per Annum All inclusive. ... Serviced. Renovated. Dry. Cctv Cameras. Jacuzzi. Water Treatment. Boys Quater. 24 Hours Security. ...",lekki,1,1,0,1,lekki3,2000000.0,2500000.0,2500000.0,3,38,7,2500000
935, orchid road oral estate lekki lagos,5,3,2,3,All new. Fully serviced. Avail able in 3bedroom ... Serviced. New. Swimming Pool. All Room Ensuit. 24 Hours Electricity. 24 Hours Security. ...,lekki,0,0,0,0,lekki3,2000000.0,2500000.0,2500000.0,0,38,7,1800000
936, lekki phase 1 lekki lagos,11,6,5,6,A Contemporary 5 Bedroom Semi Detached Duplex is now available for Rent in Lekki Phase 1 with Features; -Well paved and secured compound -Located in a serene environment -All rooms ensuite -Easily accessible good road network -1 Room staff quarter -Ante room -Gas ... Dry. Boys Quater. Water Treatment. Security Doors. Security. Pop Ceiling. Big Compound. All Room Ensuit. Jacuzzi. Parking Space. ...,lekki,0,0,0,1,lekki6,5500000.0,6200000.0,6200000.0,1,54,10,6000000
937, off admiralty road lekki phase 1 lekki lagos,9,5,4,5,"Luxury 4 bedroom all rooms ensuite terrace duplex, finished in a high luxury specificication with fitted kitchen, swimming pool, jetty boat and gym *Serviced generator (24 hours light) *General security *Cctv cameras *Modern Swimming Pool ... Serviced. Renovated. Furnished. Drainage System. Security Doors. Child Care. Pop Ceiling. Street Lights. Big Compound. Cctv Cameras. All Room Ensuit. Supermarket Nearby. Parking Space. 24 Hours Electricity. 24 Hours Security. Gym. Boys Quater. Water Treatment. Ocean View. Children Play Ground. Security. Swimming Pool. Jacuzzi. Restaurants Nearby. ...",lekki,1,1,1,1,lekki5,3500000.0,5000000.0,4000000.0,4,48,9,5000000
938, off admiralty road lekki phase 1 lekki lagos,7,4,3,4,Luxury 3 bedroom all rooms ensuite with a well fitted kitchen and bath *Self ServicedÂ  *Spacious Compound *Treated Water *Acessible Road *Secured Area Rent: 2.7M Serviced Charge:350 ThousandÂ  ... ...,lekki,0,0,0,1,lekki4,2500000.0,3500000.0,3000000.0,1,39,7,2700000
939, phase 1 lekki phase 1 lekki lagos,7,4,3,4,A Tasteful 3 bedroom apartment all rooms ensuite and a well fitted kitchen plus a room bq *Serviced generator *POP ceiling and a well screeded wall *Swimming pool *Ample Parking Space *24HRS Light PRICE:3.5M SERVICE ... ...,lekki,1,1,1,1,lekki4,2500000.0,3500000.0,3000000.0,4,39,7,3500000
940, lekki right lekki phase 1 lekki lagos,7,4,3,4,lovely and spacious three (3) bedroom flat to let in a serene environment. FACILITIES INCLUDE: Maidâ€™s quarter Acâ€™s very spacious rooms and Living room dining area balconies rooms en-suite fully fitted kitchen Cooker and oven ... Serviced. Renovated. Furnished. Drainage System. Security Doors. Pop Ceiling. Street Lights. Big Compound. Cctv Cameras. All Room Ensuit. Supermarket Nearby. Parking Space. 24 Hours Electricity. 24 Hours Security. Boys Quater. Water Treatment. Security. Restaurants Nearby. ...,lekki,0,0,0,1,lekki4,2500000.0,3500000.0,3000000.0,1,39,7,2500000
941, ... chevron lekki lagos,11,6,5,6,"Fabulous 5bedroom duplex with bq Rent-3.5m Agency-10% Legal fee-5% Caution-200k Location-chervon A call to us will end your search immediately FOR FURTHER ENQUIRES, SPECIFIC REQUEST AND ARRANGEMENTS FOR PHYSICAL INSPECTIONS, KINDLY SEND US A SCREENSHOT OR THE LINK TO THIS APARTMENT INSPECTIONS ARE ... Dry. Drainage System. Boys Quater. Children Play Ground. Big Compound. All Room Ensuit. Church Nearby. 24 Hours Electricity. 24 Hours Security. ...",lekki,0,0,0,0,lekki6,5500000.0,6200000.0,6200000.0,0,54,10,4700000
942, lekki phase 1 lekki lagos,7,4,3,4,Clean and Serviced 3 bedroom flat in at Lekki phase 1 Rent 2.5m Caution 100k Agency 10% Legal 5% Service charge 400k (Excluding Nepa and generator power respectively) Diesel deposit is contributed per supply by the tenants in the ... Serviced. Dry. Drainage System. Water Treatment. Children Play Ground. Pop Ceiling. Street Lights. Big Compound. All Room Ensuit. Supermarket Nearby. Church Nearby. Parking Space. Restaurants Nearby. ...,lekki,0,0,0,1,lekki4,2500000.0,3500000.0,3000000.0,1,39,7,2500000
943, ikota lekki lagos,5,3,2,3,"Exquisite 2&3 bedrooms apartment for rent. Rent for 2 beds ..1.3 Rent for 3 beds ..1.5m Agency fee -10% Agreement fee-10% Caution -100k Location-ikota villa A call to us will end your search immediately FOR FURTHER ENQUIRES, SPECIFIC REQUEST AND ARRANGEMENTS FOR ... Dry. Drainage System. Children Play Ground. Big Compound. All Room Ensuit. Church Nearby. ...",lekki,0,0,0,0,lekki3,2000000.0,2500000.0,2500000.0,0,38,7,1300000
944, ikate lekki lagos,11,6,5,6,"Exquisitely finished and Massive 5 Bedroom Fully Detached Duplex for Rent at Ikate, Lekki Features: Secluded Compound All Rooms En-Suite Fully Fitted Kitchen Laundry and Store Spacious Rooms Water Heater Ample Car Space Security Gate House Generator Spot Water Pumping Machine Water Treatment Plant 1 ... Dry. Drainage System. Water Treatment. Children Play Ground. Security. Pop Ceiling. Street Lights. Big Compound. All Room Ensuit. Church Nearby. Parking Space. Restaurants Nearby. ...",lekki,0,0,0,1,lekki6,5500000.0,6200000.0,6200000.0,1,54,10,6000000
945, chevron lekki lagos,9,5,4,5,Fully serviced and brand new 4 bedroom semi detached duplex with a room boys quarter for rent at chevron Rent 4m Agency 10% Legal 10% Caution 200k Service charge is yet to be fixed. A call to us will end your ... Serviced. Dry. Drainage System. Pop Ceiling. Street Lights. Big Compound. All Room Ensuit. Supermarket Nearby. Parking Space. 24 Hours Security. Boys Quater. Water Treatment. Children Play Ground. Security. Church Nearby. Restaurants Nearby. ...,lekki,1,0,0,1,lekki5,3500000.0,5000000.0,4000000.0,2,48,9,4000000
946, ikota lekki lagos,11,6,5,6,"5 Bedroom Duplex with two Sitting Stores at Ikota Villa Estate Available For Commercial/ Residential purpose Residential Rent 3M Commercial Rent 3.5M Caution 350,000 Agency 10% A call to us and you'll get your dream house FOR FURTHER ENQUIRES, SPECIFIC ... Dry. Renovated. Drainage System. Pop Ceiling. Street Lights. Big Compound. All Room Ensuit. Supermarket Nearby. Parking Space. 24 Hours Electricity. 24 Hours Security. Water Treatment. Children Play Ground. Security. Church Nearby. Restaurants Nearby. ...",lekki,0,0,0,0,lekki6,5500000.0,6200000.0,6200000.0,0,54,10,4700000
947, lekki phase 1 lekki lagos,7,4,3,4,"Fantastic 3bedroom flat Rent 2.5m Agency 10% Legal. 5% Caution 100k lekki-phase-1 Contact us for more Luxurious options FOR FURTHER ENQUIRES, SPECIFIC REQUEST AND ARRANGEMENTS FOR PHYSICAL INSPECTIONS, KINDLY SEND US A SCREENSHOT OR THE LINK TO THIS APARTMENT INSPECTIONS ARE BASED ON ... Dry. Drainage System. Pop Ceiling. Street Lights. Big Compound. All Room Ensuit. Parking Space. 24 Hours Electricity. 24 Hours Security. Water Treatment. Children Play Ground. Security. Church Nearby. Restaurants Nearby. ...",lekki,0,0,0,1,lekki4,2500000.0,3500000.0,3000000.0,1,39,7,2500000
948, lekki phase 1 lekki lagos,9,5,4,5,"To let Location. Lekki phase one 4bedroom flat. Rent. 2.5m Agency. 10% Legal. 5% Caution. 200k contact us and let's work with your budget FOR FURTHER ENQUIRIES, SPECIFIC REQUEST AND ARRANGEMENT FOR PHYSICAL INSPECTION, KINDLY SEND US A SCEENSHOT OR LINK ... Cheap. Dry. Renovated. Drainage System. Pop Ceiling. Street Lights. Big Compound. All Room Ensuit. Parking Space. 24 Hours Electricity. 24 Hours Security. Water Treatment. Children Play Ground. Security. Church Nearby. Restaurants Nearby. ...",lekki,0,0,0,1,lekki5,3500000.0,5000000.0,4000000.0,1,48,9,3500000
949, jakande lekki lagos,7,4,3,4,"Fully serviced apartment.. 2/3 bedroom flat. Rent. 2m ( 2bedroom regular) Rent. 2.5m (2bedroom premium and 3bedroom) Agency. 10% Legal. 5% Caution. 200k Service charge 750k Diesel deposits. 750k Location. Jakande, Lekki phase one. FOR FURTHER ENQUIRES, SPECIFIC REQUEST AND ARRANGEMENTS FOR PHYSICAL INSPECTIONS, KINDLY ... Serviced. Dry. Renovated. Drainage System. Pop Ceiling. Street Lights. Big Compound. All Room Ensuit. Supermarket Nearby. Parking Space. 24 Hours Electricity. 24 Hours Security. Gym. Water Treatment. Children Play Ground. Security. Swimming Pool. Church Nearby. Restaurants Nearby. ...",lekki,0,0,0,1,lekki4,2500000.0,3500000.0,3000000.0,1,39,7,2500000
950, lekki phase one lekki phase 1 lekki lagos,4,2,2,2,Newly renovated 2 bedroom Service charge 300 thousand naira only ... Renovated. Drainage System. Water Treatment. Security Doors. Security. Pop Ceiling. Big Compound. All Room Ensuit. Supermarket Nearby. Parking Space. 24 Hours Security. ...,lekki,1,0,0,1,lekki2,1500000.0,2000000.0,1700000.0,2,34,6,1800000
951, ikate lekki lagos,10,5,5,5,Five bedroom duplex with BQ @ lekki ikate comes with its own transformer massively and tasefully built Rent. 5m Refundable caution fees 10% Legal. 5% Agency. 10% ... Boys Quater. All Room Ensuit. Parking Space. 24 Hours Electricity. ...,lekki,1,1,1,1,lekki5,3500000.0,5000000.0,4000000.0,4,48,9,5000000
952, lekki phase 1 lekki lagos,4,2,2,2,Self-service 2 bedroom mini flat for rent at Lekki Phase 1 Rent 1.2m Caution fee 50k Service charge 150k Agency 10 % Legal 10 % ... Big Compound. All Room Ensuit. Parking Space. 24 Hours Electricity. 24 Hours Security. ...,lekki,0,0,0,0,lekki2,1500000.0,2000000.0,1700000.0,0,34,6,1200000
953, behind prime water ikate lekki lagos,5,3,2,3,FOR RENT Ikate Lagos 2 bedroom all rooms ensuite apartment Features: - All Rooms Ensuite - 24hrs Security -Estate - Big Compound - CCTV Cameras - Bathtub - Smoke Detectors - Security house - Fully ... New. Drainage System. Water Treatment. Security Doors. Security. Pop Ceiling. Street Lights. Big Compound. All Room Ensuit. Parking Space. 24 Hours Electricity. 24 Hours Security. ...,lekki,0,0,0,1,lekki3,2000000.0,2500000.0,2500000.0,1,38,7,2000000
954, off fola osibo lekki phase 1 lekki lagos,7,4,3,4,3bedroom flat apartment Rent 3m ... New. Drainage System. Water Treatment. Security. Pop Ceiling. Mosques Nearby. Big Compound. All Room Ensuit. Supermarket Nearby. Church Nearby. Parking Space. 24 Hours Security. Restaurants Nearby. ...,lekki,1,0,0,1,lekki4,2500000.0,3500000.0,3000000.0,2,39,7,3000000
955, ikota estate ikota lekki lagos,5,3,2,3,Newly built two bedroom duplex available for rent in ikota estate by mega chicken Rent:2m Agency:10% Legal: 10% Serviced charged 100k ... New. Boys Quater. Water Treatment. Security Doors. Security. Pop Ceiling. Street Lights. Big Compound. All Room Ensuit. Supermarket Nearby. Parking Space. 24 Hours Security. ...,lekki,0,0,0,1,lekki3,2000000.0,2500000.0,2500000.0,1,38,7,2000000
956, idado idado lekki lagos,3,2,1,2,New. Very decent . full privacy ... New. ...,lekki,0,0,0,0,lekki2,1500000.0,2000000.0,1700000.0,0,34,6,1300000
957, idado idado lekki lagos,7,4,3,4,This self service apartment is a clean and decent 3bed. Situated in a very quiet close. ... ...,lekki,0,0,0,0,lekki4,2500000.0,3500000.0,3000000.0,0,39,7,2000000
958, bourdillion court chevron lekki lagos,7,4,3,4,"3 bedroom luxury flat apartment with a bq attached with it at Bourdillion Court off Chevron drive with elevator and its 24/7 light service is 38,850k Monthly, NEPA is #65 per kilowatt ... Dry. Renovated. Drainage System. Security Doors. Pop Ceiling. Big Compound. All Room Ensuit. Supermarket Nearby. 24 Hours Electricity. 24 Hours Security. Boys Quater. Water Treatment. Security. Printing Service. Swimming Pool. Church Nearby. Restaurants Nearby. ...",lekki,1,0,0,1,lekki4,2500000.0,3500000.0,3000000.0,2,39,7,3000000
959, lekki garden. chevron 2 chevron lekki lagos,9,5,4,5,4 bedroom Semi Detached Duplex House for rent Lekki garden. Chevron 2 chevron Lekki Lagos ... ...,lekki,0,0,0,1,lekki5,3500000.0,5000000.0,4000000.0,1,48,9,3500000
960," lekki garden phase 2,opposite abraham adesanya abraham adesanya estate ajah lagos",7,4,3,4,"3 bedroom Terraced Duplex House for rent Lekki garden phase 2,opposite Abraham adesanya Abraham adesanya estate Ajah Lagos ... ...",lekki,0,0,0,0,lekki4,2500000.0,3500000.0,3000000.0,0,39,7,2000000
961, ikota villa ikota lekki lagos,7,4,3,4,"Brand new tastefully finished 3bedroom apartment with all room en-suite with enough parking space Rent #2,000,000 ... Dry. New. Drainage System. Water Treatment. Security Doors. Security. Pop Ceiling. Big Compound. All Room Ensuit. Parking Space. 24 Hours Security. ...",lekki,0,0,0,0,lekki4,2500000.0,3500000.0,3000000.0,0,39,7,2000000
962, lekki phase 1 lekki lagos,11,6,5,6,A Newly Renovated 5 Bedroom Detached Duplex is now available for Rent in Lekki phase 1 with Features; -Well paved and secured compound -Located in a serene environment -All rooms ensuite -2 Rooms staff quarter -Fitted AC -Heat expeller -Borehole -Water treatment plant -Walk in ... Dry. Renovated. Boys Quater. Security Doors. Security. Pop Ceiling. Big Compound. All Room Ensuit. Parking Space. ...,lekki,1,1,0,1,lekki6,5500000.0,6200000.0,6200000.0,3,54,10,6200000
963, .. lekki phase 1 lekki lagos,7,4,3,4,A Self Service 3 Bedroom Flat is now available for Rent in Lekki Phase 1 with Features; -Well paved and secured compound -Located in a serene neighborhood -Good and accessible road network -All rooms ensuite -Ample parking space -Spacious compound -Well illuminated and ... Dry. Renovated. Security Doors. Security. Pop Ceiling. Big Compound. All Room Ensuit. Parking Space. 24 Hours Security. ...,lekki,0,0,0,1,lekki4,2500000.0,3500000.0,3000000.0,1,39,7,2500000
964, lekki phase 1 lekki lagos,7,4,3,4,A Lovely 3 Bedroom Flat is now available for Rent in Lekki Phase 1 with Features; -Well paved and secured compound -Located in a serene environment -All rooms ensuite -Easily accessible good road network -Borehole -Well illuminated and ventilated rooms -Spacious master bedroom -Walk ... Dry. Security Doors. Security. Pop Ceiling. Big Compound. All Room Ensuit. Parking Space. ...,lekki,0,0,0,1,lekki4,2500000.0,3500000.0,3000000.0,1,39,7,2800000
965, ikate lekki lagos,11,6,5,6,A Spacious 5 Bedroom Detached Duplex is now available for Rent in Ikate with Features; -Well paved and secured compound -Located in a serene environment -All rooms ensuite -1 Room staff quarter -Easily accessible good road network -Gas cooker -Oven -Heat expeller -Borehole -Centralized water treatment ... Dry. New. Boys Quater. Water Treatment. Security Doors. Security. Pop Ceiling. Big Compound. All Room Ensuit. Parking Space. 24 Hours Security. ...,lekki,1,1,0,1,lekki6,5500000.0,6200000.0,6200000.0,3,54,10,6200000
966, ikate lekki lagos,5,3,2,3,Brand New 2 Bedroom for let at Ikate Elegushi Lagos Features; -Well paved and secured compound -Located in a serene neighborhood -Good and accessible road network -Ample parking space -Spacious compound -Well illuminated and ventilated room -Borehole -Water treatment plant -Bath tub Rent= N2M per annum For ... ...,lekki,0,0,0,1,lekki3,2000000.0,2500000.0,2500000.0,1,38,7,2000000
967, osapa london lekki lagos,9,5,4,5,Serviced 4 Bedroom Terrace Apartment For Rent @ Lekki - Osapa Rental fee: *NGN 2.9m* Service charge: NGN 52k monthly - to be paid yearly Caution: NGN 200k Agency: 10% Legal: 5% ... Serviced. Water Treatment. Security. Swimming Pool. Supermarket Nearby. 24 Hours Electricity. 24 Hours Security. Restaurants Nearby. ...,lekki,0,0,0,1,lekki5,3500000.0,5000000.0,4000000.0,1,48,9,3500000
968, osapa london lekki lagos,11,6,5,6,"Service 5 Bedroom Townhouse for rent @ Lekki - Osapa Rental fee: NGN 3 m Service charge: NGN 663k Caution Fee: NGN 300kÂ  Agency: 10% Legal: 10% Generator Schedule: Weekdays: 7 pm to 2 am, 4 am to ... Serviced. Water Treatment. Security. Pop Ceiling. Street Lights. Big Compound. All Room Ensuit. Supermarket Nearby. 24 Hours Electricity. 24 Hours Security. ...",lekki,0,0,0,0,lekki6,5500000.0,6200000.0,6200000.0,0,54,10,4700000
969, osapa lekki phase 2 lekki lagos,11,6,5,6,"FEATURES: - All Bedrooms En suite with Water Heaters - Fully Fitted Kitchen with Cabinets - Marble Tiles - Wardrobes - P.O.P ceiling - Dining - Serene Environment, Ample Parking Space. ... New. Boys Quater. Water Treatment. Security Doors. Security. Pop Ceiling. Street Lights. Big Compound. Cctv Cameras. All Room Ensuit. Jacuzzi. Parking Space. ...",lekki,0,0,0,0,lekki6,5500000.0,6200000.0,6200000.0,0,54,10,5000000
970, ikota lekki lagos,9,5,4,5,"FEATURES: - All Bedrooms En suite with Water Heaters - Fully Fitted Kitchen with Cabinets - Marble Tiles - Wardrobes - Serene Environment - Ample Parking Space, Self Compound ... New. Boys Quater. Water Treatment. Security Doors. Security. Pop Ceiling. Big Compound. All Room Ensuit. Parking Space. ...",lekki,0,0,0,1,lekki5,3500000.0,5000000.0,4000000.0,1,48,9,3500000
971, ikate ikate lekki lagos,7,4,3,4,Newly built luxurious (6) units three bedroom flat at ikate elegushi Rent:3.5m Service charge plus diesel: 1.5m/annum 24hrs power supply ... ...,lekki,1,1,1,1,lekki4,2500000.0,3500000.0,3000000.0,4,39,7,3500000
972, spa road ologolo lekki lagos,7,4,3,4,"Beautifully designed 3bedroom apartment with 4toilet 3bath Rent #1,700,000 ... Dry. Renovated. Drainage System. Water Treatment. Security Doors. Security. Pop Ceiling. Big Compound. All Room Ensuit. Parking Space. ...",lekki,0,0,0,0,lekki4,2500000.0,3500000.0,3000000.0,0,39,7,2000000
973, .. lekki phase 1 lekki lagos,4,2,2,2,"Serviced 2 bedroom en-suite flat for rent at Lekki Phase 1 Rent 3.5m Agency 10% Legal 5% Refundable deposit 10% Service charge 1m Negotiable Features: - All room en-suite with Air conditioner - Fitted kitchen cabinets with gas cooker, heat extractor/oven - Quality ... Big Compound. All Room Ensuit. Parking Space. 24 Hours Electricity. 24 Hours Security. ...",lekki,1,1,1,1,lekki2,1500000.0,2000000.0,1700000.0,4,34,6,3000000
974, lekki phase 1 lekki lagos,4,2,2,2,"Newly built mini flat within the heart of lekki 1. Only three tenants in a compound. Pop ceiling, guest toilet, master en-suite , robust water treatment plant; LED POP lighting all through. Each apartment has own pre ... ...",lekki,1,0,0,1,lekki2,1500000.0,2000000.0,1700000.0,2,34,6,1700000
975, ikota lekki lagos,9,5,4,5,A nice 4 Bedroom Terrace House which situates in a serene estate in Lekki. This building is well accessible with tarred roads and all amenities are in place to give you a comfortable business evironment. ... Cheap. Dry. Renovated. New. Drainage System. Boys Quater. Security Doors. Security. Pop Ceiling. Street Lights. Big Compound. All Room Ensuit. Supermarket Nearby. Parking Space. 24 Hours Security. Restaurants Nearby. ...,lekki,0,0,0,1,lekki5,3500000.0,5000000.0,4000000.0,1,48,9,3500000
976, ikate lekki lagos,7,4,3,4,Service 3 Bedroom Flat for rent @ Lekki - Ikate Rental fee: NGN 2.5m Service charge: NGN 600k Caution Fee: NGN 150k Agency: 10% Legal: 5% ... Serviced. Security. Street Lights. Swimming Pool. Big Compound. All Room Ensuit. 24 Hours Electricity. 24 Hours Security. ...,lekki,0,0,0,1,lekki4,2500000.0,3500000.0,3000000.0,1,39,7,2500000
977, orchid lekki lagos,7,4,3,4,"Brand new fully detached 3bedroom duplex for rent. Rent-2.5m Agency fee-10% Legal fee-10% Caution fee-100k Location-orchid A call to us will end your search immediately FOR FURTHER ENQUIRES, SPECIFIC REQUEST AND ARRANGEMENTS FOR PHYSICAL INSPECTIONS, KINDLY SEND US A SCREENSHOT ... Dry. Drainage System. Water Treatment. Children Play Ground. Security. Pop Ceiling. Street Lights. Big Compound. All Room Ensuit. Supermarket Nearby. Church Nearby. Parking Space. Restaurants Nearby. ...",lekki,0,0,0,1,lekki4,2500000.0,3500000.0,3000000.0,1,39,7,2500000
978, off admiralty way lekki phase 1 lekki lagos,9,5,4,5,Altra Modern open plan office space with a room bq *Stair case *Air Conditioners pipes *parking *Big compound *Generator stand *City view *Emergency Exits *Safety Rules *General Reception Rent: 850 Thousand ... Renovated. Drainage System. Security Doors. Pop Ceiling. Street Lights. Office Supplies. Big Compound. Cctv Cameras. All Room Ensuit. Supermarket Nearby. Parking Space. 24 Hours Security. Boys Quater. Water Treatment. Security. Restaurants Nearby. ...,lekki,1,0,0,1,lekki5,3500000.0,5000000.0,4000000.0,2,48,9,4000000
979, orchid lekki phase 2 lekki lagos,9,5,4,5,"Fabulous 4bedroom semi detach duplex with a bq for rent in a secured estate Rent 2.5 Caution:200 Legal 5% Agent 10% Location orchid A call to us will end your search immediately FOR FURTHER ENQUIRES, SPECIFIC REQUEST AND ARRANGEMENTS FOR PHYSICAL ... Dry. Drainage System. Boys Quater. Children Play Ground. Church Nearby. ...",lekki,0,0,0,1,lekki5,3500000.0,5000000.0,4000000.0,1,48,9,3500000
980, spg road igbo efon lekki lagos,3,2,1,2,Decent mini flat. Very private ... ...,lekki,0,0,0,0,lekki2,1500000.0,2000000.0,1700000.0,0,34,6,900000
981, chevy view chevron lekki lagos,7,4,3,4,Gatted compound. Comes with a Room BQ. ... ...,lekki,0,0,0,0,lekki4,2500000.0,3500000.0,3000000.0,0,39,7,2200000
982, idado idado lekki lagos,7,4,3,4,Sitted on 2 floors. Extra study room. Plus a room BQ ... ...,lekki,0,0,0,1,lekki4,2500000.0,3500000.0,3000000.0,1,39,7,2500000
983, osapa london lekki lagos,7,4,3,4,"Neatly built 3bedroom flat to let Rent 1.850 Caution 150k Maintenance 180k Agent/legal 10% each Location-osapa London A call to us will end your search immediately FOR FURTHER ENQUIRES, SPECIFIC REQUEST AND ARRANGEMENTS FOR PHYSICAL INSPECTIONS, KINDLY SEND US A SCREENSHOT OR ... Dry. Drainage System. Children Play Ground. All Room Ensuit. Church Nearby. ...",lekki,0,0,0,0,lekki4,2500000.0,3500000.0,3000000.0,0,39,7,2000000
984, alpha beach lekki lagos,7,4,3,4,Serviced and tastefully finished 3 bedroom en-suite flat with a room boys quarters for rent at Alpha beach road Rent 1.8m Agency 10% Legal 5% Service charge 600k (excluding NEPA and diesel for generator power supply) Negotiable A call to us ... Serviced. Dry. Boys Quater. Water Treatment. Pop Ceiling. Street Lights. Big Compound. All Room Ensuit. Parking Space. ...,lekki,0,0,0,0,lekki4,2500000.0,3500000.0,3000000.0,0,39,7,2000000
985, lekki lekki phase 1 lekki lagos,9,5,4,5,Massive compound. Comes with a Maid room ... ...,lekki,1,0,0,1,lekki5,3500000.0,5000000.0,4000000.0,2,48,9,4000000
986, chevy view estate chevron lekki lagos,2,1,1,1,"Comfortable to live 1 master room studio apartment Rent -1m Caution-100k Legal- 10% Agency- 10% Location-chevy view A call to us will end your search immediately FOR FURTHER ENQUIRES, SPECIFIC REQUEST AND ARRANGEMENTS FOR PHYSICAL INSPECTIONS, KINDLY SEND US A SCREENSHOT OR ... Serviced. Dry. Drainage System. Children Play Ground. Big Compound. Church Nearby. ...",lekki,0,0,0,1,lekki1,800000.0,1300000.0,1169999.9999999988,1,21,4,1000000
987, agungi lekki lagos,7,4,3,4,3-Bedroom Flat for rent @ Agungi Rent: *NGN 1.7m* Service Charge: *NGN 400k* Caution: NGN 150k Agency: 10% Legal: 10% ... Water Treatment. Pop Ceiling. Big Compound. All Room Ensuit. ...,lekki,0,0,0,0,lekki4,2500000.0,3500000.0,3000000.0,0,39,7,2000000
988, oral estate oral estate lekki lagos,7,4,3,4,"Beautifully built new serviced 3bedroom flat with a room bq in a secured and serene estate. Rent #1,800,000 Seevice charge including diesel #700,000 ... Dry. New. Drainage System. Boys Quater. Water Treatment. Security Doors. Security. Street Lights. Big Compound. All Room Ensuit. 24 Hours Security. ...",lekki,0,0,0,0,lekki4,2500000.0,3500000.0,3000000.0,0,39,7,2000000
989, off admiralty way lekki phase 1 lekki lagos,7,4,3,4,FOR RENT Lekki phase 1 Lagos 3 bedroom all rooms ensuite apartment Features : - All Rooms Ensuite - 24hrs Security -24 hrs Power - Boyâ€™s Quarter - Big Compound -Gym - Generator - CCTV Cameras ... Serviced. Renovated. Furnished. New. Drainage System. Water Treatment. Security Doors. Security. Pop Ceiling. Street Lights. Cctv Cameras. All Room Ensuit. Jacuzzi. Parking Space. 24 Hours Electricity. 24 Hours Security. ...,lekki,1,1,1,1,lekki4,2500000.0,3500000.0,3000000.0,4,39,7,4000000
990, idado estate chevron lekki lagos,11,6,5,6,5bedroom fully detached duplex with BQ Rent 3.5m ... Renovated. Drainage System. Pop Ceiling. Big Compound. All Room Ensuit. Supermarket Nearby. Parking Space. 24 Hours Security. Boys Quater. Water Treatment. Security. Mosques Nearby. Church Nearby. Restaurants Nearby. ...,lekki,0,0,0,0,lekki6,5500000.0,6200000.0,6200000.0,0,54,10,4700000
991, ikate lekki lagos,11,6,5,6,A Brand New 5 Bedroom Detached Duplex is now available for Rent in Ikate with Features; -Well paved and secured compound -Located in a serene environment -All rooms ensuite -1 Room staff quarter -Easily accessible good road network -Gas cooker -Electric oven -Microwave -Washing machine -Fridge -Heat ... Dry. New. Boys Quater. Security Doors. Security. Pop Ceiling. Big Compound. All Room Ensuit. Parking Space. ...,lekki,0,0,0,1,lekki6,5500000.0,6200000.0,6200000.0,1,54,10,6000000
992, .. lekki phase 1 lekki lagos,5,3,2,3,A Serviced 2 Bedroom Terrace Duplex is now available for Rent in Lekki Phase 1 with Features; -Well paved and secured compound -Located in a serene neighborhood -Good and accessible road network -All rooms ensuite -1 Room staff quarter -Ample parking space -Well ... Serviced. Dry. Renovated. Boys Quater. Water Treatment. Security Doors. Security. Pop Ceiling. Big Compound. All Room Ensuit. Parking Space. 24 Hours Security. ...,lekki,0,0,0,1,lekki3,2000000.0,2500000.0,2500000.0,1,38,7,2200000
993, bourdillon court chevron lekki lagos,9,5,4,5,"4 bedroom terrace duplex with a bq at Bourdillon court estate, chevron drive. 3.5m, service 38k monthly (covers generator, security, water, cleaning) PHCN #64 per kilowatt ... Cheap. Serviced. Dry. Boys Quater. Water Treatment. Security Doors. Security. Pop Ceiling. Street Lights. Swimming Pool. Big Compound. All Room Ensuit. Supermarket Nearby. 24 Hours Electricity. 24 Hours Security. ...",lekki,0,0,0,1,lekki5,3500000.0,5000000.0,4000000.0,1,48,9,3500000
994," lakowe, otunla ibeju lekki lagos",5,3,2,3,"Beautiful newly built 2bedroom flat with 3toilet, 2bath. Rent #500,000 ground floor Upper floor #550,000 ... Cheap. New. Drainage System. Water Treatment. Security Doors. Security. Pop Ceiling. Big Compound. All Room Ensuit. Parking Space. ...",lekki,0,0,0,0,lekki3,2000000.0,2500000.0,2500000.0,0,38,7,1000000
995, chevron lekki lagos,9,5,4,5,4 Bedroom Duplex For Rent @ Lekki - Chevron *Rent: NGN 2.6m* Caution Fee: *NGN 200k* *Agency Fee: 10%* *Legal Fee: 5%* ... Water Treatment. Pop Ceiling. All Room Ensuit. ...,lekki,0,0,0,1,lekki5,3500000.0,5000000.0,4000000.0,1,48,9,3500000
996, lekki phase 1 lekki lagos,2,1,1,1,Sharp exclusive mini within the heart of Lekki Phase 1. Rent: N1.2M. Service Charge: N250k. ... ...,lekki,1,0,0,1,lekki1,800000.0,1300000.0,1169999.9999999988,2,21,4,1200000
997, lekki phase 1 lekki lagos,6,3,3,3,Luxurious and massive 3 bedroom flat for rent at Lekki Phase 1 Rent 4.5m Agency 10% Legal 10% Caution fee and service charge applies. ... All Room Ensuit. Parking Space. 24 Hours Electricity. ...,lekki,1,1,1,1,lekki3,2000000.0,2500000.0,2500000.0,4,38,7,3500000
998, jakande lekki lagos,7,4,3,4,"Sweetly built 3bedroom duplex @ jakande Rent. 2.5 Caution fee 150k Service charge. 480k Agency. 10% Legal. 5% Call us now and let's help you end your search by getting your a luxury apartment FOR FURTHER ENQUIRES, SPECIFIC REQUEST AND ARRANGEMENTS ... Serviced. Dry. Renovated. Drainage System. Pop Ceiling. Street Lights. Big Compound. All Room Ensuit. Supermarket Nearby. Parking Space. 24 Hours Electricity. 24 Hours Security. Water Treatment. Children Play Ground. Security. Church Nearby. Restaurants Nearby. ...",lekki,0,0,0,1,lekki4,2500000.0,3500000.0,3000000.0,1,39,7,2500000
999, lekki phase 1 lekki lagos,9,5,4,5,A Lovely 4 Bedroom Terrace Duplex is now available for Rent in Lekki Phase 1 with Features; -Well paved and secured compound -Located in a serene neighborhood -Good and accessible road network -All rooms ensuite -1 Room staff quarter -Gas cooker -Oven -Heat ... Serviced. Dry. Renovated. Boys Quater. Water Treatment. Security Doors. Security. Pop Ceiling. Big Compound. All Room Ensuit. Parking Space. 24 Hours Security. ...,lekki,1,1,1,1,lekki5,3500000.0,5000000.0,4000000.0,4,48,9,5500000
1000, agungi lekki lagos,7,4,3,4,"Well finished Three bedroom apartment Rent 1.8m Caution fee 120k Service charge 160k Agency 10 % Legal 10 % Location agungi A call to us will end your search immediately FOR FURTHER ENQUIRES, SPECIFIC REQUEST AND ARRANGEMENTS FOR PHYSICAL INSPECTIONS, KINDLY SEND US ... Serviced. Dry. Drainage System. Children Play Ground. Big Compound. All Room Ensuit. Church Nearby. 24 Hours Electricity. 24 Hours Security. ...",lekki,0,0,0,0,lekki4,2500000.0,3500000.0,3000000.0,0,39,7,2000000
1001, - lekki phase 1 lekki lagos,7,4,3,4,Luxury 6 units of 3 bedroom apartment with a well fitted kitchen and swimming Pool *POP finishing *Water Treatment *Security Doors *Well Fitted kitchenÂ  *Generator *Swimmming Pool *Bar Area *Boyâ€™s Quater *Spacious compoundÂ  PRICE: 24 ... ...,lekki,1,1,1,1,lekki4,2500000.0,3500000.0,3000000.0,4,39,7,4300000
1002, off providence road lekki phase 1 lekki lagos,2,1,1,1,"Serviced 50Sqm room and palour with waiting room ground floor of a detached house office space, suitable for office use e.g law firm, estate firm and other corporate offices . partly furnished with split Ac. ... Serviced. Dry. Renovated. Furnished. Drainage System. Water Treatment. Security Doors. Security. Pop Ceiling. Big Compound. Parking Space. 24 Hours Electricity. 24 Hours Security. ...",lekki,1,1,1,1,lekki1,800000.0,1300000.0,1169999.9999999988,4,21,4,1500000
1003, adebayo doherty lekki phase 1 lekki lagos,7,4,3,4,"3 bedrooms duplex for rent at Adebayo Doherty street Lekki Phase 1 Lagos Rent: N3,500,000 Don't miss this offer, call now; APRO GLOBAL REAL ESTATES Web: info@aproglobalestate. com.ng. Tel: 01-7620139 Mobile: 080-51-595-336,080-29-481-639 070-63-822-217, 070-82-974-088 ... Supermarket Nearby. Parking Space. Restaurants Nearby. ...",lekki,1,1,1,1,lekki4,2500000.0,3500000.0,3000000.0,4,39,7,3500000
1004, william st chevron lekki lagos,9,5,4,5,?? Above is a four(4) bedroom Semi detached house with a room boy's quarter at Williams Street Chevyview Estate. All the rooms are filled with air conditioners while the kitchen is fully fitted. ... ...,lekki,0,0,0,1,lekki5,3500000.0,5000000.0,4000000.0,1,48,9,3500000
1005, ikota lekki lagos,9,5,4,5,"FEATURES: - All Bedrooms En suite with Water Heaters - Fully Fitted Kitchen with Cabinets - Marble Tiles - Wardrobes - Serene Environment - Ample Parking Space, Self Compound, within a gated Estate. ... New. Drainage System. Boys Quater. Water Treatment. Security Doors. Security. Pop Ceiling. Big Compound. Cctv Cameras. All Room Ensuit. ...",lekki,0,0,0,1,lekki5,3500000.0,5000000.0,4000000.0,1,48,9,3500000
1006, off admiralty way lekki phase 1 lekki lagos,7,4,3,4,Luxury 3 bedroom all rooms ensuite apartment with a bq *Generator house *Bore hole *Water cooperation connection *Cctv camera *Water treatment *Automatic change over *Concrete stamped floor *Acrylic fitted kitchen *Ac connection *Security *Water stantion *Pandora ... Serviced. New. Drainage System. Security Doors. Pop Ceiling. Street Lights. Big Compound. Cctv Cameras. All Room Ensuit. Supermarket Nearby. Parking Space. 24 Hours Electricity. 24 Hours Security. Boys Quater. Water Treatment. Security. Restaurants Nearby. ...,lekki,1,1,1,1,lekki4,2500000.0,3500000.0,3000000.0,4,39,7,3500000
1007, off admiralty way lekki phase 1 lekki lagos,7,4,3,4,Luxury 3 bedroom all rooms ensuite apartment with a room bq *Generator house *Bore hole *Water cooperation connection *Cctv camera *Water treatment *Automatic change over *Concrete stamped floor *Acrylic fitted kitchen *Ac connection *Security *Water stantion ... Renovated. Drainage System. Water Treatment. Security Doors. Children Play Ground. Security. Pop Ceiling. Street Lights. Big Compound. All Room Ensuit. Parking Space. 24 Hours Security. ...,lekki,0,0,0,1,lekki4,2500000.0,3500000.0,3000000.0,1,39,7,2500000
1008, off admiralty way lekki phase 1 lekki lagos,7,4,3,4,Luxury 3 bedroom all rooms ensuite apartment with a room bq *Serviced Generator *Bore hole *Water cooperation connection *Cctv camera *Automatic change over *Concrete stamped floor *Acrylic fitted kitchen *Ac connection pipes *Balcony space ... Serviced. Renovated. Drainage System. Security Doors. Pop Ceiling. Street Lights. Big Compound. All Room Ensuit. Supermarket Nearby. Parking Space. 24 Hours Electricity. 24 Hours Security. Boys Quater. Water Treatment. Security. Restaurants Nearby. ...,lekki,1,0,0,1,lekki4,2500000.0,3500000.0,3000000.0,2,39,7,3000000
1009, off admiralty way lekki phase 1 lekki lagos,7,4,3,4,lovely and spacious three (3) bedroom flat to let in a serene environment. FACILITIES INCLUDE: Maidâ€™s quarter Acâ€™s very spacious rooms and Living room dining area balconies rooms en-suite fully fitted kitchen Washing machine light fittings swimming pool security parking space etc. Rent 3m ... Serviced. Renovated. Drainage System. Boys Quater. Water Treatment. Security Doors. Security. Pop Ceiling. Street Lights. Big Compound. All Room Ensuit. Parking Space. 24 Hours Security. ...,lekki,1,0,0,1,lekki4,2500000.0,3500000.0,3000000.0,2,39,7,3000000
1010, off admiralty way lekki phase 1 lekki lagos,7,4,3,4,FOR RENT Lekki phase 1 Lagos 3 bedroom all rooms ensuite apartment plus a room bq Features: - All Rooms Ensuite - 24hrs Security - Boyâ€™s Quarter - Big Compound - Solar Panels - CCTV Cameras ... Serviced. Renovated. Furnished. Drainage System. Security Doors. Child Care. Pop Ceiling. Street Lights. Big Compound. Cctv Cameras. All Room Ensuit. 24 Hours Electricity. 24 Hours Security. Boys Quater. Water Treatment. Children Play Ground. Security. ...,lekki,1,1,1,1,lekki4,2500000.0,3500000.0,3000000.0,4,39,7,3500000
1011, ... ikate lekki lagos,7,4,3,4,3-Bedroom Semi-Detached Duplex For Rent @ Lekki - Ikate Rent: *NGN 4m* Caution: NGN 250k Agency 10% Legal 10% ... ...,lekki,1,1,1,1,lekki4,2500000.0,3500000.0,3000000.0,4,39,7,4000000
1012, ... chevron lekki lagos,11,6,5,6,Spacious 5-Bedroom Duplex + BQ For Rent @ Lekki - Chevron - Berra Estate Rent: *NGN 3.5m / Annum* Caution Fee: NGN 200k (Negotiable) Agency: 10% Legal: 10% ... Boys Quater. Pop Ceiling. Big Compound. All Room Ensuit. ...,lekki,0,0,0,0,lekki6,5500000.0,6200000.0,6200000.0,0,54,10,4700000
1013, nicon town lekki lagos,9,5,4,5,Lovely 4bedroom allroom ensuite with Interlock stone compand & boil hole water duplex at Nicon town lekki lagos ... ...,lekki,0,0,0,1,lekki5,3500000.0,5000000.0,4000000.0,1,48,9,3500000
1014, osapa lekki phase 1 lekki lagos,9,5,4,5,Newly Renovated 4 Bedroom Detached Duplex Features; -Well paved and secured compound -Located in a serene neighborhood -Good and accessible road network -All rooms ensuite -2 Rooms staff quarter -Heat expeller -Ample parking space -Spacious compound -Car port -Well illuminated and ventilated rooms -Walk in closet -Borehole -Water treatment ... ...,lekki,1,0,0,1,lekki5,3500000.0,5000000.0,4000000.0,2,48,9,4000000
1015, lekki phase 1 lekki lagos,11,6,5,6,A Magnificent 5 Bedroom Fully Detached Duplex is now available for Rent in Lekki Phase 1 with Features; -Well paved and secured compound -Located in a serene neighborhood -Good and accessible road network -All rooms ensuite -2 Rooms staff quarter -Gas cooker -Electric ... Dry. Renovated. Boys Quater. Water Treatment. Security Doors. Security. Pop Ceiling. Big Compound. All Room Ensuit. Jacuzzi. Parking Space. ...,lekki,1,1,0,1,lekki6,5500000.0,6200000.0,6200000.0,3,54,10,6200000
1016, osapa london lekki lagos,7,4,3,4,A Lovely Serviced 3 Bedroom Terrace Duplex is now available for Rent in Lekki Phase 1 with Features; -Well paved and secured compound -Located in a serene neighborhood -Good and accessible road network -All rooms ensuite -1 Room staff quarter -Gas cooker -Heat ... Serviced. Dry. Renovated. Boys Quater. Water Treatment. Security Doors. Security. Pop Ceiling. Swimming Pool. Big Compound. All Room Ensuit. Parking Space. 24 Hours Security. ...,lekki,1,1,1,1,lekki4,2500000.0,3500000.0,3000000.0,4,39,7,3500000
1017, lekki lekki phase 1 lekki lagos,7,4,3,4,A Tasteful 3 bedroom apartment all rooms ensuite with a fitted kitchen *parking space *fitted kitchen *pop finishing *treated water *Self serviced PRICE:3M ... ...,lekki,1,0,0,1,lekki4,2500000.0,3500000.0,3000000.0,2,39,7,3000000
1018, - lekki phase 1 lekki lagos,7,4,3,4,Tasteful 3 bedroom ensuite apartment with a well fitted kitchen and boys quarter *vring your generatorÂ  *POP finishing *Water Treatment *Security Doors *Well Fitted kitchenÂ  *Big compoundÂ  *General SecurityÂ  PRICE: 2.7 MillionÂ  SERVICE CHARGE: 150 ... ...,lekki,0,0,0,1,lekki4,2500000.0,3500000.0,3000000.0,1,39,7,2700000
1019, lekki phase 1 estate lekki phase 1 lekki lagos,11,6,5,6,"For Lease: 5Bedrm Fully Detached house, 1 Study room, large sitting room/dining area, family lounge, with 2 room Bq. Loundry, Facilities: Swimming pool, Water treatment plant, Gym house, Dedicated Generator house, CCTV cameras, intercom system, ... Serviced. Furnished. New. Drainage System. Security Doors. Child Care. Pop Ceiling. Street Lights. Big Compound. Cctv Cameras. All Room Ensuit. Supermarket Nearby. Parking Space. Fast Internet. 24 Hours Electricity. 24 Hours Security. Gym. Boys Quater. Water Treatment. Children Play Ground. Security. Swimming Pool. Jacuzzi. Restaurants Nearby. ...",lekki,1,1,0,1,lekki6,5500000.0,6200000.0,6200000.0,3,54,10,6200000
1020, - lekki phase 1 lekki lagos,7,4,3,4,Tasteful 3 bedroom apartment Â all rooms ensuite with a well fitted kitchen and room bq *POP finishing *Water Treatment *Security Doors *Well Fitted kitchen *Accessibile area PRICE:2.5M Service Charge:10k Monthly contribution ... ...,lekki,0,0,0,1,lekki4,2500000.0,3500000.0,3000000.0,1,39,7,2500000
1021, lekki phase 1 lekki lagos,4,2,2,2,"Self service 2 bedroom flat at Lekki Phase 1 Rent 2.5m Caution 300k Legal 250k Agency 250k Total N3,300,000 ... Serviced. Big Compound. All Room Ensuit. Parking Space. ...",lekki,1,1,1,1,lekki2,1500000.0,2000000.0,1700000.0,4,34,6,2500000
1022, jakande lekki lagos,10,5,5,5,"5bedroom duplex @ jakande Rent 3.5 net Service charge. 600k/yr, or 50k monthly Caution 10% Legal. 5% Agency 10% ... All Room Ensuit. Parking Space. 24 Hours Electricity. ...",lekki,0,0,0,1,lekki5,3500000.0,5000000.0,4000000.0,1,48,9,3500000
1023, ikota villa ikota lekki lagos,8,4,4,4,"Available at Ikota Villa Estate for sale/rent 4 Bedroom Duplex Terrace Apartment For Sale 38M Rent 2.5 M Service Charge 480,000 Caution Fee 200,000 Legal 10% Agency 10% ... Boys Quater. Big Compound. All Room Ensuit. Parking Space. 24 Hours Electricity. ...",lekki,0,0,0,1,lekki4,2500000.0,3500000.0,3000000.0,1,39,7,2500000
1024, ikate lekki lagos,10,5,5,5,5 bedroom fully detached duplex all en-suite with a room boys quarter Rent 5.5m Agency 10% Legal 10% Caution 5%k @5.5m rent is subject to change. Asking Price is 6m Features - Brand new - All rooms en-suite - 3 ... Boys Quater. Big Compound. All Room Ensuit. Parking Space. 24 Hours Electricity. 24 Hours Security. ...,lekki,1,1,1,1,lekki5,3500000.0,5000000.0,4000000.0,4,48,9,5500000
1025, osapa london lekki lagos,9,5,4,5,A Serviced 4 Bedroom Terrace Duplex is now available for Rent in Osapa with Features; -Well paved and secured compound -Located in a serene environment -All rooms ensuite -Easily accessible good road network -1 Room staff quarter -Fitted AC -Swimming pool -Gym -Gas cooker -Electric oven -Microwave -Heat ... Serviced. Dry. Renovated. Gym. Boys Quater. Water Treatment. Security Doors. Security. Pop Ceiling. Swimming Pool. Big Compound. All Room Ensuit. Parking Space. 24 Hours Security. ...,lekki,0,0,0,1,lekki5,3500000.0,5000000.0,4000000.0,1,48,9,3500000
1026, lekki phase 1 lekki lagos,7,4,3,4,A Luxury 3 Bedroom Terrace Duplex for Rent in Lekki Phase 1 with Features; -Well paved and secured compound -Located in a serene environment -All rooms ensuite -Easily accessible good road network -1 Room staff quarter -Borehole -Heat expeller -Water treatment plant -Well illuminated and ... Dry. Renovated. Boys Quater. Water Treatment. Security Doors. Security. Pop Ceiling. Big Compound. All Room Ensuit. Parking Space. 24 Hours Security. ...,lekki,1,1,1,1,lekki4,2500000.0,3500000.0,3000000.0,4,39,7,3500000
1027, lekki phase 1 lekki lagos,5,3,2,3,A serviced 2 bedroom flat is available for let at Lekki right Rent N2.4m Tenant contribute for diesel For enquiries contact us on 08117340933 or 08090876670 ... Serviced. Renovated. Water Treatment. Security. Pop Ceiling. Big Compound. All Room Ensuit. 24 Hours Security. ...,lekki,0,0,0,1,lekki3,2000000.0,2500000.0,2500000.0,1,38,7,2400000
1028, lekki phase 1 lekki lagos,11,6,5,6,A Commercial 5 Bedroom Semi Detached Duplex is now available for Rent in Lekki Phase 1 with Features; -Well paved and secured compound -Located in a very serene environment -Easily accessible road network -1 Room staff quarter -All rooms ensuite -Borehole -Water treatment ... Dry. Renovated. Boys Quater. Water Treatment. Security Doors. Security. Pop Ceiling. Big Compound. All Room Ensuit. Parking Space. ...,lekki,1,1,0,1,lekki6,5500000.0,6200000.0,6200000.0,3,54,10,6200000
1029, .. agungi lekki lagos,4,2,2,2,"For rent, Lovely 2 bedroom detached duplex for rent at Agungi Rent 2m Agency. 10% Legal. 10% Caution 100k ... Big Compound. All Room Ensuit. Parking Space. 24 Hours Electricity. 24 Hours Security. ...",lekki,1,1,1,1,lekki2,1500000.0,2000000.0,1700000.0,4,34,6,2000000
1030, chevy view chevron lekki lagos,8,4,4,4,"4bedroom semi detach duplex to let, it can also be used for commercial Rent-4m Caution-200k Legal-5% Agent-10% Location-chevy view estate ... Boys Quater. Big Compound. All Room Ensuit. Parking Space. 24 Hours Electricity. 24 Hours Security. ...",lekki,1,1,1,1,lekki4,2500000.0,3500000.0,3000000.0,4,39,7,4000000
1031, - lekki phase 1 lekki lagos,7,4,3,4,"Affordable and fantastic 3 bedroom flat with a room bq for rent at Lekki phase 1 Rent 2.8m Caution 150k Legal 5% Agency 10% Service charge 200k Self-service A call to us will end your search immediately FOR FURTHER ENQUIRES, SPECIFIC REQUEST AND ... Serviced. Dry. Drainage System. Boys Quater. Children Play Ground. Security. Pop Ceiling. Street Lights. Big Compound. All Room Ensuit. Church Nearby. 24 Hours Electricity. 24 Hours Security. Restaurants Nearby. ...",lekki,0,0,0,1,lekki4,2500000.0,3500000.0,3000000.0,1,39,7,2800000
1032, agungi lekki lagos,9,5,4,5,"Terrace duplex with a bq for rent Rent:2.5 Caution:160 Agent/legal 10% each Location: Agunji A call to us will end your search immediately FOR FURTHER ENQUIRES, SPECIFIC REQUEST AND ARRANGEMENTS FOR PHYSICAL INSPECTIONS, KINDLY SEND US A SCREENSHOT OR THE LINK ... Dry. Drainage System. Boys Quater. Children Play Ground. Street Lights. Big Compound. All Room Ensuit. Church Nearby. ...",lekki,0,0,0,1,lekki5,3500000.0,5000000.0,4000000.0,1,48,9,3500000
1033, orchid lekki lagos,9,5,4,5,"Fabulous 4bedroom semi detach duplex with a bq in a secured estate for rent Rent 2.8m Caution 150k Legal 5% Agent 10% Location: orchid A call to us will end your search immediately FOR FURTHER ENQUIRES, SPECIFIC REQUEST AND ARRANGEMENTS FOR ... Dry. Drainage System. Boys Quater. Children Play Ground. Church Nearby. ...",lekki,0,0,0,1,lekki5,3500000.0,5000000.0,4000000.0,1,48,9,3500000
1034, chevron lekki lagos,11,6,5,6,"furnished 5bedrooms duplex with a BQ, and can also be use for short let Rent -5m Caution fee-200k Self service apartment Agency 10% Legal 10% A call to us will end your search immediately FOR FURTHER ENQUIRES, ... Dry. Boys Quater. Big Compound. All Room Ensuit. 24 Hours Electricity. 24 Hours Security. ...",lekki,0,0,0,0,lekki6,5500000.0,6200000.0,6200000.0,0,54,10,5000000
1035, ilasan lekki lagos,5,3,2,3,"Nicely built Two bedroom flat at ilasan Rent: 2.2m Service:350k Power:50k monthly Refundable cautiou fee: 100k Agency 10% Legal 10% A call to us will end your search immediately FOR FURTHER ENQUIRES, SPECIFIC REQUEST AND ARRANGEMENTS FOR PHYSICAL INSPECTIONS, KINDLY SEND ... Serviced. Dry. Big Compound. All Room Ensuit. 24 Hours Electricity. 24 Hours Security. ...",lekki,0,0,0,1,lekki3,2000000.0,2500000.0,2500000.0,1,38,7,2200000
1036, - agungi lekki lagos,5,3,2,3,"Magnificent 2 bedrooms flat For rent Rent 2m Agency. 10% Legal. 10% Caution 100k Agungi A call to us will end your search immediately FOR FURTHER ENQUIRES, SPECIFIC REQUEST AND ARRANGEMENTS FOR PHYSICAL INSPECTIONS, KINDLY SEND US A SCREENSHOT OR THE LINK ... Dry. Drainage System. Water Treatment. Children Play Ground. Pop Ceiling. Big Compound. Church Nearby. Parking Space. Restaurants Nearby. ...",lekki,0,0,0,1,lekki3,2000000.0,2500000.0,2500000.0,1,38,7,2000000
1037, lekki phase 1 lekki lagos,7,4,3,4,Just two persons in a compound. 3bedroom flat Location. Lekki phase one Rent. 3m Agency. 10% Caution. 200k Legal. 5% Service charge. Unknown yet This apartment is located in a serene and conducive environment in Lekki phase one and its purely ... Serviced. Dry. Drainage System. Pop Ceiling. Street Lights. Big Compound. All Room Ensuit. Supermarket Nearby. Parking Space. 24 Hours Electricity. 24 Hours Security. Water Treatment. Children Play Ground. Security. Church Nearby. Restaurants Nearby. ...,lekki,1,0,0,1,lekki4,2500000.0,3500000.0,3000000.0,2,39,7,3000000
1038, ologolo lekki lagos,9,5,4,5,"Neatly finished Four bedroom duplex with a bq Rent 3m Caution fee 150k Agency 10 % Legal 10 % Location ologolo /igboefon A call to us will definitely end your search for a house FOR FURTHER ENQUIRES, SPECIFIC REQUEST AND ARRANGEMENTS FOR ... Dry. Drainage System. Children Play Ground. Big Compound. All Room Ensuit. Church Nearby. 24 Hours Electricity. 24 Hours Security. ...",lekki,0,0,0,1,lekki5,3500000.0,5000000.0,4000000.0,1,48,9,3500000
1039, ikota lekki lagos,9,5,4,5,"Executive 4 Bedroom Duplex with BQ @ Ikota Rent 2.5M Caution 100k Service Charge 150k ( Can be paid Twice) Legal 10% Agency 10% A call to us will definitely end your search for a house FOR FURTHER ENQUIRES, SPECIFIC ... Serviced. Furnished. Boys Quater. Water Treatment. Security. Pop Ceiling. Street Lights. Big Compound. All Room Ensuit. 24 Hours Electricity. 24 Hours Security. Restaurants Nearby. ...",lekki,0,0,0,1,lekki5,3500000.0,5000000.0,4000000.0,1,48,9,3500000
1040, chevron lekki lagos,7,4,3,4,"Brand new 3bedroom Terrance duplex with AC installed. Rent-2.5m Agency-10% Agreement-10% Caution-200k Location-chevy/chervon estate A call to us will definitely end your search for a house FOR FURTHER ENQUIRES, SPECIFIC REQUEST AND ARRANGEMENTS FOR PHYSICAL INSPECTIONS, KINDLY SEND US A SCREENSHOT ... Big Compound. All Room Ensuit. 24 Hours Electricity. 24 Hours Security. ...",lekki,0,0,0,1,lekki4,2500000.0,3500000.0,3000000.0,1,39,7,2500000
1041, ologolo lekki lagos,9,5,4,5,"Eye Four bedroom duplex with a bq Rent 2.8m Caution fee 200k Agency 10 % Legal 5% Location agungi/ologolo call us now and lets give you the luxury you deserve FOR FURTHER ENQUIRIES, SPECIFIC REQUEST AND ARRANGEMENT FOR PHYSICAL INSPECTIONS, KINDLY SEND ... Dry. Renovated. Drainage System. Pop Ceiling. Street Lights. Big Compound. All Room Ensuit. Supermarket Nearby. Parking Space. 24 Hours Electricity. 24 Hours Security. Boys Quater. Water Treatment. Children Play Ground. Security. Church Nearby. Restaurants Nearby. ...",lekki,0,0,0,1,lekki5,3500000.0,5000000.0,4000000.0,1,48,9,3500000
1042, lekki phase 1 lekki lagos,7,4,3,4," Lovely and Serviced 3 bedroom flat at Lekki Phase 1 Rent 4m Caution 5% Legal 10% Agency 5% Service charge 900k Diesel deposit 600k FOR FURTHER ENQUIRES, SPECIFIC REQUEST AND BOOKINGS KINDLY SEND US A SCREENSHOT OR THE LINK TO THIS ... Serviced. Dry. Renovated. Drainage System. Pop Ceiling. Street Lights. Big Compound. All Room Ensuit. Supermarket Nearby. Parking Space. 24 Hours Electricity. 24 Hours Security. Children Play Ground. Security. Church Nearby. Restaurants Nearby. ...",lekki,1,1,1,1,lekki4,2500000.0,3500000.0,3000000.0,4,39,7,4000000
1043, lekki phase 1 lekki lagos,9,5,4,5,"Luxurious and neatly finished 4bedroom with a room bq Rent. 4.5m Agency. 5% Legal. 5% Caution. 200k Self serviced Location. Lekki phase one A call to us and you'll get your dream house FOR FURTHER ENQUIRES, SPECIFIC REQUEST AND ARRANGEMENTS FOR PHYSICAL ... Dry. Drainage System. Pop Ceiling. Street Lights. Big Compound. All Room Ensuit. Supermarket Nearby. Parking Space. 24 Hours Electricity. 24 Hours Security. Water Treatment. Children Play Ground. Security. Church Nearby. Restaurants Nearby. ...",lekki,1,0,1,1,lekki5,3500000.0,5000000.0,4000000.0,3,48,9,4500000
1044, chisco ikate lekki lagos,11,6,5,6,"executive beautifully built Serviced 5bedroom terrace duplex with a maid room , with swimming pool, gym, beautiful mini estate/ serene environment, 24hrs power supply, 24hrs security supply Rent #3.5m S.c #600k Light pay as u ... ...",lekki,0,0,0,0,lekki6,5500000.0,6200000.0,6200000.0,0,54,10,4700000
1045, osapa osapa london lekki lagos,9,5,4,5,"Newly built beautiful tastefully finished 4 bedroom terrace duplex with a room boys quarter, with 3 cars park, partly fitted kitchen, 24hrs security , 24hrs electricity supply at #62/kwt, service charge ... Cheap. Serviced. Dry. New. Drainage System. Security Doors. Pop Ceiling. C Of O. Big Compound. Cctv Cameras. All Room Ensuit. Supermarket Nearby. Parking Space. 24 Hours Electricity. 24 Hours Security. Boys Quater. Water Treatment. Survey. Children Play Ground. Security. Restaurants Nearby. ...",lekki,1,1,1,1,lekki5,3500000.0,5000000.0,4000000.0,4,48,9,5600000
1046," lucky osujie, lekki palm city estate ado ajah lagos",9,5,4,5,"New and tastefully finished 5units of 4 bedrooms detached houses with a room boy's quarter at lucky osujie street, Lekki palm city estate opp. Olumegbon palace off Ado road, Ajah, Lagos. Rent N2.3m and ... Dry. New. Drainage System. Water Treatment. Security Doors. Security. Pop Ceiling. Street Lights. Big Compound. Cctv Cameras. All Room Ensuit. Parking Space. 24 Hours Security. ...",lekki,0,0,0,1,lekki5,3500000.0,5000000.0,4000000.0,1,48,9,3500000
1047, kanal residence osapa london lekki lagos,9,5,4,5,"Newly built tastefully finished 4bedroom semi detached duplex with a maid room, security house and a separate compound, located in a secured, serene environment/estate. Rent :#3,000,000 ... Cheap. Dry. New. Drainage System. Boys Quater. Water Treatment. Security Doors. Security. Pop Ceiling. All Room Ensuit. Parking Space. 24 Hours Security. ...",lekki,0,0,0,1,lekki5,3500000.0,5000000.0,4000000.0,1,48,9,3500000
1048, primewater estate ikate lekki lagos,7,4,3,4,"A beautiful serviced 3bedroom apartment in Primewaterview Gardens 1 Ikate for lease @ 2.5m. Agency 10%, Legal 10%, N100k Caution fee & Service Charge as advised by Estate FM. 24hr light available @ N65 per ... ...",lekki,0,0,0,1,lekki4,2500000.0,3500000.0,3000000.0,1,39,7,2500000
1049, ikota ikota lekki lagos,9,5,4,5,New! Fitted with modern facilities. 24hr power. Swimming pool. Gym. Security check . mini Court. Just by VGC estate. ... Serviced. New. Gym. Water Treatment. Security. Street Lights. Swimming Pool. Big Compound. All Room Ensuit. Jacuzzi. 24 Hours Electricity. 24 Hours Security. ...,lekki,0,0,0,1,lekki5,3500000.0,5000000.0,4000000.0,1,48,9,3500000
1050, off admiralty road lekki phase 1 lekki lagos,2,1,1,1,"Beautiful newly renovated 1bedroom flat at Lekki phase 1 off admiralty road, Lekki Rent #1,400,000 Servive charge #250,000 ... Renovated. Drainage System. Water Treatment. Security Doors. Security. Pop Ceiling. Big Compound. All Room Ensuit. Parking Space. ...",lekki,1,1,1,1,lekki1,800000.0,1300000.0,1169999.9999999988,4,21,4,1400000
1051, gbola salami agungi lekki lagos,7,4,3,4,"Luxurious 3bedroom flat all room en-suite with guest toilet and treated water in an estate not far from the express , free from flood , serene and secured estate/environment Rent#2,000,000 Service charge #30,000/month Caution #100,000 ... Dry. Renovated. Water Treatment. Security Doors. Security. Pop Ceiling. Big Compound. All Room Ensuit. Parking Space. 24 Hours Security. ...",lekki,0,0,0,0,lekki4,2500000.0,3500000.0,3000000.0,0,39,7,2000000
1052, ikota villa estate ikota lekki lagos,7,4,3,4,Spacious 3bedroom flat at ikota villa estate rent #1.4m ... Cheap. Dry. Renovated. Water Treatment. Security Doors. Security. Big Compound. All Room Ensuit. Parking Space. 24 Hours Security. ...,lekki,0,0,0,0,lekki4,2500000.0,3500000.0,3000000.0,0,39,7,2000000
1053, jinadu igbo efon lekki lagos,7,4,3,4,"A very spacious 3bedroom apartment, very big, with toilet and bath. Rent #1,300,000 Agency #130,000 Legal #130,000 Caution #100,000 ... Dry. Renovated. Water Treatment. Security Doors. Security. Pop Ceiling. Big Compound. Parking Space. ...",lekki,0,0,0,0,lekki4,2500000.0,3500000.0,3000000.0,0,39,7,2000000
1054," safe court estate, beside spar, ikate lekki lagos",7,4,3,4,We introduce to you! - Excellent finished 3 Bedroom Luxury Apartment with A room Boys Quarter. - All rooms are ensuit plus visitor's toilet. - Spacious rooms and living room. - Nice Plumbing and Electrical fittings. - Spacious kitchen with ... Serviced. Renovated. Boys Quater. Water Treatment. Elevator. Security. Pop Ceiling. Street Lights. All Room Ensuit. Supermarket Nearby. Parking Space. 24 Hours Electricity. 24 Hours Security. ...,lekki,1,0,0,1,lekki4,2500000.0,3500000.0,3000000.0,2,39,7,3000000
1055, osapa london lekki lagos,5,3,2,3,"Fantastic Two bedroom flat @ osapa london Rent. 1.5m Water treatment 25k Security and lawns. 70k Agency. 10% Legal. 10% A call to us will end your search immediately FOR FURTHER ENQUIRES, SPECIFIC REQUEST AND ARRANGEMENTS FOR PHYSICAL INSPECTIONS, KINDLY ... Serviced. Dry. Drainage System. Children Play Ground. Big Compound. All Room Ensuit. Church Nearby. ...",lekki,0,0,0,0,lekki3,2000000.0,2500000.0,2500000.0,0,38,7,1500000
1056, lekki phase 1 lekki lagos,10,5,5,5,A luxury 4 bedroom detached house is available for let in Lekki phase 1 with A room staff quarter Water treatment plant Large room Ample parking Garden Bush bar Rent N4m Contact us on 08090876670 or 08117340933 ... Renovated. Boys Quater. Water Treatment. Children Play Ground. Security. Pop Ceiling. Big Compound. All Room Ensuit. Parking Space. ...,lekki,1,0,0,1,lekki5,3500000.0,5000000.0,4000000.0,2,48,9,4000000
1057, lekki phase 1 lekki lagos,7,4,3,4,2 Units of 3 Bedroom Flat are now available for Rent in Lekki Phase 1 with Features; -Well paved and secured compound -Located in a serene neighborhood -Good and accessible road network -All rooms ensuite -1 Room staff quarter -Ample parking space -Spacious ... Dry. Security Doors. Security. Pop Ceiling. Big Compound. All Room Ensuit. Parking Space. ...,lekki,0,0,0,1,lekki4,2500000.0,3500000.0,3000000.0,1,39,7,2500000
1058, lekki phase 1 lekki lagos,5,3,2,3,"Luxurious and Serviced 2 bedroom en-suite flat for rent at Lekki Phase 1 Rent 3.5m Agency 10% Legal 5% Refundable deposit 10% Service charge 1m Negotiable Features: - All room en-suite with Air conditioner - Fitted kitchen cabinets with gas cooker, heat ... Serviced. Dry. Drainage System. Children Play Ground. Big Compound. All Room Ensuit. Church Nearby. 24 Hours Electricity. 24 Hours Security. ...",lekki,1,1,1,1,lekki3,2000000.0,2500000.0,2500000.0,4,38,7,3500000
1059, spg road ologolo lekki lagos,7,4,3,4,"Well designed 3bedroom flat, upper floor, with 3bath 4toilet Rent #1,400,000 ... Dry. Renovated. Drainage System. Water Treatment. Security Doors. Security. Pop Ceiling. Big Compound. All Room Ensuit. Parking Space. ...",lekki,0,0,0,0,lekki4,2500000.0,3500000.0,3000000.0,0,39,7,2000000
1060, lekki phase 1 lekki lagos,3,2,1,2,1 Bedroom Flat + BQ For Rent @ Victoria Island - Oniru Rental fee: NGN 2.5 millionÂ  Service Charge: NGN 2.5mÂ  Caution: NGN 500kÂ  Agency: 10% Legal: 5% ... Boys Quater. Water Treatment. Security. Pop Ceiling. Big Compound. Supermarket Nearby. Parking Space. 24 Hours Electricity. 24 Hours Security. ...,lekki,1,1,1,1,lekki2,1500000.0,2000000.0,1700000.0,4,34,6,2500000
1061, osapa london lekki lagos,7,4,3,4,Serviced 3-Bedroom apartment For Rent @ Lekki - *Osapa* Rent: *NGN 2.5m* Service Charge: NGN 750k Diesel Deposit: NGN 750k Power: PPM Caution: NGN 150k Agency: 10% Legal: 10% Features : Swimming pool Gym Fitted kitchen All rooms en suite Treated water ... Serviced. Gym. Water Treatment. Security. Pop Ceiling. Swimming Pool. All Room Ensuit. 24 Hours Electricity. 24 Hours Security. ...,lekki,0,0,0,1,lekki4,2500000.0,3500000.0,3000000.0,1,39,7,2500000
1062, off ola dimeji alo lekki phase 1 lekki lagos,11,6,5,6,5 bedroom all rooms ensuite semi detached plus a room bq Features: - All Rooms Ensuite - 24hrs Security - Boyâ€™s Quarter - Big Compound - Generator house - Showers - Bathtub - Smoke Detectors - ... Renovated. Drainage System. Boys Quater. Water Treatment. Security Doors. Security. Pop Ceiling. Street Lights. Big Compound. Cctv Cameras. All Room Ensuit. Supermarket Nearby. Parking Space. ...,lekki,0,0,0,1,lekki6,5500000.0,6200000.0,6200000.0,1,54,10,5500000
1063," orchid hotel road, chevron toll gate chevron lekki lagos",2,1,1,1,Furnished Mini Flat for rent @ Lekki - Chevron Toll gate - Orchid Hotel Road Rent: 2.2m Service charge: 13k monthly Agency: 220k Legal: 110k Caution: 100k ... Furnished. Water Treatment. Pop Ceiling. ...,lekki,1,1,1,1,lekki1,800000.0,1300000.0,1169999.9999999988,4,21,4,2000000
1064, ikota lekki lagos,8,4,4,4,Available At Ikota 4 Bedroom Semi-Detached Duplex Rent 2.5m Legal 10% Agreement 10% Caution fee 150k ... Boys Quater. All Room Ensuit. Parking Space. 24 Hours Electricity. ...,lekki,0,0,0,1,lekki4,2500000.0,3500000.0,3000000.0,1,39,7,2500000
1065, alpha beach road igbo efon lekki lagos,7,4,3,4,3-Bedroom maisonette For rent In a Secured Estate @ Lekki - Alpha Beach Road Rent: NGN 2.2m / Annum Service Charge: NGN 25k monthly (excluding power) Caution: NGN 184 k Agency: 10% Legal: 10% ... Water Treatment. Pop Ceiling. Big Compound. All Room Ensuit. ...,lekki,0,0,0,0,lekki4,2500000.0,3500000.0,3000000.0,0,39,7,2200000
1066, new road igbo efon lekki lagos,7,4,3,4,"Newly built 3 and 2bedroom shared apartment into rooms ensuite and the kitchen, living room only will be shared. The rent rant from #350k to #450k per room Agency #50k Legal #50k Caution #20k ... Cheap. Dry. New. Water Treatment. Security Doors. Security. Pop Ceiling. Big Compound. All Room Ensuit. Parking Space. 24 Hours Security. ...",lekki,0,0,0,0,lekki4,2500000.0,3500000.0,3000000.0,0,39,7,2000000
1067," oluwanisola estate, chevron lekki lagos",7,4,3,4,"** 18 Units of 3 bedroom Luxury Flat for Rent ** spacious room, Living & Dining ** Fitted Kitchen ** functioning Elevator(lift) ** Gym house, swimming, squash court, tennis court etc ** 24 hours security including armed police ** 24 hours ... Serviced. Dry. Renovated. Drainage System. Street Lights. Big Compound. All Room Ensuit. Supermarket Nearby. Parking Space. 24 Hours Electricity. 24 Hours Security. Gym. Water Treatment. Elevator. Children Play Ground. Security. Mosques Nearby. Swimming Pool. ...",lekki,1,0,0,1,lekki4,2500000.0,3500000.0,3000000.0,2,39,7,3000000
1068, chevron lekki lagos,7,4,3,4,"Magnificent 3 bedroom flat for rent at chevron Rent 1.7m Agency 10% Legal 10% Caution 100k Service charge 300k A call to us will definitely end your search for a house FOR FURTHER ENQUIRES, SPECIFIC REQUEST AND ARRANGEMENTS FOR PHYSICAL INSPECTIONS, KINDLY ... Serviced. Dry. Big Compound. All Room Ensuit. 24 Hours Electricity. 24 Hours Security. ...",lekki,0,0,0,0,lekki4,2500000.0,3500000.0,3000000.0,0,39,7,2000000
1069, chevron conservative chevron lekki lagos,11,6,5,6, New. This massive mansion comes with a room Bq. Located in a gatted environment . In the hub of Chevron conservative area. ... Serviced. New. Big Compound. All Room Ensuit. 24 Hours Security. ...,lekki,0,0,0,0,lekki6,5500000.0,6200000.0,6200000.0,0,54,10,4700000
1070, osapa london lekki lagos,2,1,1,1,Service room self con in peacock beach estate @ off shoprite osapa #700k ... ...,lekki,0,0,0,0,lekki1,800000.0,1300000.0,1169999.9999999988,0,21,4,700000
1071, off freedom way lekki phase 1 lekki lagos,9,5,4,5,"Newly built beautiful serviced 4bedroom terrace duplex suitable for office use at Lekki phase 1 off freedom way, Lekki Rent #4.5m Service charge #1.5m including diesel Electricity from 6am to 6pm ... Serviced. New. Water Treatment. Pop Ceiling. Big Compound. Cctv Cameras. All Room Ensuit. Parking Space. 24 Hours Security. ...",lekki,1,0,1,1,lekki5,3500000.0,5000000.0,4000000.0,3,48,9,4500000
1072, alpha beach road igbo efon lekki lagos,7,4,3,4,3 Bedroom flat for Rent @ Lekki - Alpha Beach Road. Rent: NGN 1.5m Service charge: NGN 86k Caution: NGN 100k Agency: 10% Legal: 10% ... All Room Ensuit. ...,lekki,0,0,0,0,lekki4,2500000.0,3500000.0,3000000.0,0,39,7,2000000
1073," ikota villa estate, ikota lekki lagos",9,5,4,5,"*FOR RENT* 4 Bedroom Terrace - newly built, nice finish, paved compound and road - spacious rooms and living room - nice wardrobes - nice and fitted kitchen - inside ikota Villa Estate beside mega chicken. - Rent: 2.8m per annum ... Cheap. New. Drainage System. Water Treatment. Pop Ceiling. Big Compound. All Room Ensuit. Parking Space. 24 Hours Security. ...",lekki,0,0,0,1,lekki5,3500000.0,5000000.0,4000000.0,1,48,9,3500000
1074, ikota ikota lekki lagos,11,6,5,6,"URGENT HOUSE FOR LEASE?? Newly built 5 bedroom fully detached duplex, All rooms ensuits,with jaccuzi, water heater, water treatment, fitted kitchen and 24 hours security, in a well secured Estate Location : Westend Estate Ikota villa ... New. Drainage System. Boys Quater. Water Treatment. Security Doors. Security. Pop Ceiling. Street Lights. Big Compound. All Room Ensuit. Supermarket Nearby. Parking Space. 24 Hours Security. ...",lekki,0,0,0,0,lekki6,5500000.0,6200000.0,6200000.0,0,54,10,4700000
1075, orchid road ikota lekki lagos,9,5,4,5,Beautiful and luxurious 4bedroom terrace at ocean bay estate Rent #2.5m Very secured and serene ... Serviced. Dry. Renovated. Drainage System. Water Treatment. Security Doors. Security. Pop Ceiling. Street Lights. Big Compound. All Room Ensuit. Supermarket Nearby. Parking Space. 24 Hours Electricity. 24 Hours Security. ...,lekki,0,0,0,1,lekki5,3500000.0,5000000.0,4000000.0,1,48,9,3500000
1076, lekki phase 1 lekki phase 1 lekki lagos,5,3,2,3,FOR RENT Lekki phase 1 Lagos 2 bedroom all rooms ensuite apartment plus a guest toilet Features: - All Rooms Ensuite - 24hrs Security - Big Compound -Fire alarm -Ocean view - Generator ... Serviced. Furnished. New. Drainage System. Security Doors. Pop Ceiling. Street Lights. Big Compound. Cctv Cameras. All Room Ensuit. Supermarket Nearby. Parking Space. Fast Internet. 24 Hours Electricity. 24 Hours Security. Water Treatment. Children Play Ground. Security. Restaurants Nearby. ...,lekki,1,1,1,1,lekki3,2000000.0,2500000.0,2500000.0,4,38,7,3000000
1077, off kunesela road ikate lekki lagos,9,5,4,5,Luxury 4 bedroom exquisite bedroom fully detached house with bq *Serviced Generator *Bore hole *Water cooperation connection *Cctv camera *Automatic change over *Concrete stamped floor *Acrylic fitted kitchen *Ac commection *Green area *Water stantion *Pandora ... Serviced. Renovated. New. Drainage System. Security Doors. Pop Ceiling. Street Lights. Big Compound. Cctv Cameras. All Room Ensuit. Supermarket Nearby. Parking Space. 24 Hours Electricity. 24 Hours Security. Boys Quater. Water Treatment. Children Play Ground. Security. Restaurants Nearby. ...,lekki,1,0,0,1,lekki5,3500000.0,5000000.0,4000000.0,2,48,9,4000000
1078, ikate lekki lagos,2,1,1,1,Lovely Room self containe in ikate and ilasan #500 ... ...,lekki,0,0,0,0,lekki1,800000.0,1300000.0,1169999.9999999988,0,21,4,500000
1079, lekki phase 1 lekki lagos,7,4,3,4,"Brand new serviced 3 bedroom flat for rent Lekki Phase 1 Rent 2.5m Agency 10% Legal 5% Caution 200k Service charge 750k NB: Service charge covers waste disposal, water treatment, security and cleaning of the compound, Lightening of common area, prepaid meter ... Serviced. Dry. Drainage System. Pop Ceiling. Street Lights. Big Compound. All Room Ensuit. Supermarket Nearby. Parking Space. 24 Hours Electricity. 24 Hours Security. Water Treatment. Children Play Ground. Security. Church Nearby. Restaurants Nearby. ...",lekki,0,0,0,1,lekki4,2500000.0,3500000.0,3000000.0,1,39,7,2500000
1080, ikate ikate lekki lagos,7,4,3,4,Very lovely Apartment . built in 2018. Very modern. Fitted kitchen. All room em suite.bfitted Ac. Comes with a Maid room . 1m service charge . caution fee 500k ... Serviced. Boys Quater. Big Compound. All Room Ensuit. 24 Hours Security. ...,lekki,1,1,1,1,lekki4,2500000.0,3500000.0,3000000.0,4,39,7,3500000
1081, ... chevron lekki lagos,9,5,4,5,"Brand new 4bedroom duplex with a room bq rent-4m agency fee -10% legal fee-5% caution-250k location-chervon estate a call to us will end your search immediately for further enquires, specific request and arrangements for physical inspections, kindly send us a screenshot or ... Dry. Drainage System. Boys Quater. Children Play Ground. Big Compound. All Room Ensuit. Church Nearby. 24 Hours Electricity. 24 Hours Security. ...",lekki,1,0,0,1,lekki5,3500000.0,5000000.0,4000000.0,2,48,9,4000000
1082, - lekki phase 1 lekki lagos,5,3,2,3,"Brand new 2 bedroom flat for residential/commercial at Lekki phase 1 Rent 2.3m Caution 100k Legal 5% Agency 10% Service charge 200k Self-service 2.5m commercial A call to us will end your search immediately FOR FURTHER ENQUIRES, SPECIFIC REQUEST AND ARRANGEMENTS FOR PHYSICAL INSPECTIONS, ... Serviced. Dry. Drainage System. Children Play Ground. Pop Ceiling. Street Lights. Big Compound. All Room Ensuit. Church Nearby. 24 Hours Electricity. Restaurants Nearby. ...",lekki,1,1,0,1,lekki3,2000000.0,2500000.0,2500000.0,3,38,7,2500000
1083, ilasan lekki lagos,3,2,1,2,"Selfcon Appartment (Shared Kitchen, Shared Parlour) for rent @ Lekki ILasan Rent. *N800k* Service charge. N250k (Guaranteed 12hr power - 7pm to 7am) Agency. 10% Legal. 10% Preferably a working class (male) ... New. Security. Pop Ceiling. Office Supplies. All Room Ensuit. 24 Hours Electricity. ...",lekki,0,0,0,0,lekki2,1500000.0,2000000.0,1700000.0,0,34,6,900000
1084, prime water estate ikate lekki lagos,6,3,3,3,FEATURES: - All Bedrooms En suite with Water Heaters - Fully Fitted Kitchen with Cabinets - Marble Tiles - Wardrobes - P.O.P ceiling - Dining - Serene Environment - Ample Parking Space -Swimming Pool -24 ... Serviced. New. Drainage System. Security Doors. Pop Ceiling. Street Lights. All Room Ensuit. Parking Space. 24 Hours Electricity. 24 Hours Security. Boys Quater. Water Treatment. Elevator. Security. Swimming Pool. ...,lekki,1,1,1,1,lekki3,2000000.0,2500000.0,2500000.0,4,38,7,3000000
1085, ikota lekki phase 2 lekki lagos,9,5,4,5,"FEATURES: - All Bedrooms En suite with Water Heaters - Fully Fitted Kitchen with Cabinets - Marble Tiles - Wardrobes - P.O.P ceiling - Dining - Serene Environment, Ample Parking Space. ... Boys Quater. Water Treatment. Security Doors. Security. Pop Ceiling. Street Lights. Big Compound. All Room Ensuit. Parking Space. ...",lekki,0,0,0,1,lekki5,3500000.0,5000000.0,4000000.0,1,48,9,3500000
1086, phase 1 lekki phase 1 lekki lagos,7,4,3,4,"Luxurious 3 Bedroom apartment all rooms ensuite with a room bqÂ  Newly finished 3 bedroom apartment with all rooms en-suite: Italian Tiled floors, Fitted Kitchens, Shower Cubicles, Baths, ample parking space, Security Camera, ac's Washing ... ...",lekki,1,1,1,1,lekki4,2500000.0,3500000.0,3000000.0,4,39,7,3500000
1087, lekki phase 1 lekki lagos,7,4,3,4,Luxury 3 bedroom all rooms ensuite apartment with a room bq *Swimming pool *Gym *Serviced Generator *Bore hole *Water cooperation connection *Cctv camera *Automatic change over *Concrete stamped floor *Acrylic fitted kitchen *Ac connection *Green area ... Serviced. Renovated. Furnished. Drainage System. Security Doors. Child Care. Pop Ceiling. Street Lights. Big Compound. Cctv Cameras. All Room Ensuit. Supermarket Nearby. Parking Space. Fast Internet. 24 Hours Electricity. 24 Hours Security. Gym. Boys Quater. Water Treatment. Elevator. Children Play Ground. Security. Swimming Pool. ...,lekki,1,1,1,1,lekki4,2500000.0,3500000.0,3000000.0,4,39,7,3500000
1088, off admiralty way lekki phase 1 lekki lagos,5,3,2,3,Exquisite newly built 2 bedroom all rooms ensuite apartment with a well fitted kitchen *Generator connection *Bore hole *Water treatment plant *Cctv camera *Automatic change over *Concrete stamped floor *Acrylic fitted kitchen *Ac piping *Green ... Serviced. Renovated. Drainage System. Water Treatment. Security Doors. Security. Pop Ceiling. Street Lights. Big Compound. All Room Ensuit. Parking Space. 24 Hours Security. ...,lekki,0,0,0,1,lekki3,2000000.0,2500000.0,2500000.0,1,38,7,2000000
1089, off admiralty way lekki phase 1 lekki lagos,7,4,3,4,Luxury 3 bedroom all rooms ensuite apartment *Sexurity house *Generator house *Bore hole *Water cooperation connection *Cctv camera *Automatic change over *Concrete stamped floor *Acrylic fitted kitchen *Ac connection *Green area *Water stantion *Pandora sit ... Serviced. New. Drainage System. Security Doors. Child Care. Pop Ceiling. Street Lights. Big Compound. Cctv Cameras. All Room Ensuit. Supermarket Nearby. Parking Space. 24 Hours Security. Gym. Water Treatment. Security. Church Nearby. Restaurants Nearby. ...,lekki,0,0,0,1,lekki4,2500000.0,3500000.0,3000000.0,1,39,7,2800000
1090, off domino road agungi lekki lagos,5,3,2,3,"Fresh brief:::: Extremely clean n well maintained Fully serviced apartment of 2 bedroom flat with bq Going rent 2m per annum Facilities:: 24/hours power, gym, rooftop lounge, bar, swimming pool, elevator, industrial treated borehole, etc Service charge per annum ... Serviced. New. Drainage System. Security Doors. Pop Ceiling. Street Lights. Big Compound. Cctv Cameras. All Room Ensuit. Supermarket Nearby. Parking Space. 24 Hours Electricity. 24 Hours Security. Water Treatment. Security. Restaurants Nearby. ...",lekki,0,0,0,1,lekki3,2000000.0,2500000.0,2500000.0,1,38,7,2000000
1091, off durosinmi etti lekki phase 1 lekki lagos,7,4,3,4,Luxury 3 bedroom all rooms ensuite apartment with a well fitted kitchen and a room bq *Generator connection *Equipped gym *Bore hole *Water treatment plant *Cctv camera *Automatic change over *Concrete stamped floor *Acrylic fitted kitchen *Ac ... Cheap. Serviced. Renovated. Drainage System. Security Doors. Pop Ceiling. Street Lights. Big Compound. Cctv Cameras. All Room Ensuit. Parking Space. 24 Hours Electricity. 24 Hours Security. Gym. Water Treatment. Security. Jacuzzi. Restaurants Nearby. ...,lekki,0,0,0,1,lekki4,2500000.0,3500000.0,3000000.0,1,39,7,2500000
1092, off admiralty way lekki phase 1 lekki lagos,5,3,2,3,Property Description this is a newly built 6 units of 2 bedrooms serviced apartment all the rooms are en-suite with extra visitor's toilet the kitchen is fully fitted with modern kitchen wares the rooms are very ... Serviced. New. Water Treatment. Security Doors. Security. Pop Ceiling. Big Compound. All Room Ensuit. Parking Space. 24 Hours Electricity. 24 Hours Security. ...,lekki,1,1,1,1,lekki3,2000000.0,2500000.0,2500000.0,4,38,7,3000000
1093, ologolo ologolo lekki lagos,11,6,5,6,"DETAILS OF PROPERTY **5 BEDROOM DUPLEX RESIDENTIAL PROPERTY . DOWNSTAIRS -2 SITTING ROOMS -DINING SECTION -ANTE ROOM -1 GUEST ROOM ENSUITE -KITCHEN -STORE ROOM/LAUNDRY -POWER INVERTER ROOM -ATTACHED BQ ROOM WITH SEPERATE TOILET AND KITCHEN UPSTAIRS -MASTER BEDROOM ENSUITE WIITH BALCONY VIEW, WALK IN CLOSET AND ... Renovated. Drainage System. Security Doors. Governor's Consent. Child Care. Pop Ceiling. C Of O. Street Lights. Big Compound. Cctv Cameras. All Room Ensuit. Supermarket Nearby. Parking Space. 24 Hours Electricity. 24 Hours Security. Boys Quater. Water Treatment. Survey. Children Play Ground. Security. ...",lekki,1,1,0,1,lekki6,5500000.0,6200000.0,6200000.0,3,54,10,6200000
1094, richmond gate estate ikate lekki lagos,9,5,4,5,Newly built 5 bedroom semi detached duplex for rent Richmond Gate estate ikate meadow hall way price :5.5m ... Serviced. Furnished. New. Drainage System. Security Doors. Pop Ceiling. Street Lights. Big Compound. Cctv Cameras. All Room Ensuit. Supermarket Nearby. Parking Space. 24 Hours Electricity. 24 Hours Security. Water Treatment. Children Play Ground. Security. Swimming Pool. Jacuzzi. ...,lekki,1,1,1,1,lekki5,3500000.0,5000000.0,4000000.0,4,48,9,5500000
1095, off admiralty way lekki phase 1 lekki lagos,7,4,3,4,Luxury 3 bedroom all rooms ensuite apartment plus a room bq *Generator house *Bore hole *Water cooperation connection *Cctv camera *Water treatment *Automatic change over *Concrete stamped floor *Acrylic fitted kitchen *Ac connection *Security *Water stantion ... Renovated. Drainage System. Security Doors. Child Care. Pop Ceiling. Street Lights. Big Compound. All Room Ensuit. Supermarket Nearby. Parking Space. 24 Hours Security. Boys Quater. Water Treatment. Security. ...,lekki,0,0,0,1,lekki4,2500000.0,3500000.0,3000000.0,1,39,7,2500000
1096, northpointe estate chevron lekki lagos,9,5,4,5,4bedroom semi detached duplex Rent 3.5m Service 1.8m ... Serviced. New. Drainage System. Pop Ceiling. Street Lights. Big Compound. Cctv Cameras. All Room Ensuit. Supermarket Nearby. Parking Space. 24 Hours Security. Gym. Water Treatment. Front Desk Service. Children Play Ground. Security. Mosques Nearby. Printing Service. Church Nearby. Jacuzzi. Restaurants Nearby. ...,lekki,0,0,0,1,lekki5,3500000.0,5000000.0,4000000.0,1,48,9,3500000
1097, osapa jakande lekki lagos,9,5,4,5,All new . 4 Bedroom terrace . Fully serviced apartment. Gatted. Well secured. ... Serviced. New. Big Compound. All Room Ensuit. 24 Hours Electricity. 24 Hours Security. ...,lekki,0,0,0,1,lekki5,3500000.0,5000000.0,4000000.0,1,48,9,3500000
1098, chevron chevron lekki lagos,9,5,4,5,This lovely Home is fitted with mordern facilities. Spacious bathroom and toilets. Plus a room BQ ... Serviced. Big Compound. All Room Ensuit. 24 Hours Electricity. 24 Hours Security. ...,lekki,0,0,0,1,lekki5,3500000.0,5000000.0,4000000.0,1,48,9,3500000
1099, idado idado lekki lagos,5,3,2,3,Brand new. Service apartment . fitted kitchen Fitted Ac. Modern facilities. Close to the Lekki epe expressway. Nearby mall. Good road network. Service charge is at 500k excluding diesel ... Serviced. New. ...,lekki,0,0,0,1,lekki3,2000000.0,2500000.0,2500000.0,1,38,7,2000000
1100, oral oral estate lekki lagos,9,5,4,5,Purely residential. Fully serviced. ... Serviced. Swimming Pool. 24 Hours Security. ...,lekki,0,0,0,1,lekki5,3500000.0,5000000.0,4000000.0,1,48,9,3500000
1101, osapa osapa london lekki lagos,7,4,3,4,Standard and spacious 3 bedroom flat with quality finishing. This house has only just 2 tenants in the compound. ... Serviced. Dry. Drainage System. Water Treatment. Security Doors. Security. Pop Ceiling. Street Lights. Cctv Cameras. All Room Ensuit. Supermarket Nearby. Parking Space. 24 Hours Security. ...,lekki,0,0,0,1,lekki4,2500000.0,3500000.0,3000000.0,1,39,7,2500000
1102, salem ilasan lekki lagos,7,4,3,4,"Brand new tastefully finished and beautifully designed3bedroom flat at ilasan by salem adjacent chisco ikate, Lekki, lagos. Rent: #2,000,000 Agency#200,000 Legal #200,000 ... Cheap. Dry. New. Drainage System. Security Doors. Security. Pop Ceiling. Big Compound. All Room Ensuit. Parking Space. 24 Hours Security. ...",lekki,0,0,0,0,lekki4,2500000.0,3500000.0,3000000.0,0,39,7,2000000
1103, lekki phase 1 lekki lagos,6,3,3,3,"*TO LET* Fully serviced 3 bedroom apartment with bq at Pinnock beach estate Jakande, Lekki Rent #3.5m ... ...",lekki,1,1,1,1,lekki3,2000000.0,2500000.0,2500000.0,4,38,7,3500000
1104, lekki phase 1 lekki lagos,2,1,1,1,"Well built Self-service 2 bedroom flat for rent at Lekki Phase 1 Rent 1.2m Caution fee 50k Service charge 150k Agency 10 % Legal 10 % A call to us will end your search immediately FOR FURTHER ENQUIRES, SPECIFIC REQUEST AND ... Dry. Drainage System. Children Play Ground. Big Compound. All Room Ensuit. Church Nearby. ...",lekki,1,0,0,1,lekki1,800000.0,1300000.0,1169999.9999999988,2,21,4,1200000
1105, lekki phase 1 lekki lagos,2,1,1,1, Sharp exclusive mini within the heart of Lekki Phase 1. Rent: N1.2M. Service Charge: N250k. ... ...,lekki,1,0,0,1,lekki1,800000.0,1300000.0,1169999.9999999988,2,21,4,1200000
1106, chevron lekki lagos,5,3,2,3,"Exquisite 2 bedroom Flat Chervon Price :2m Legal 10% Agency 10% Caution 5% 1bedroom flat Rent. 1.5m Agency. 10% Legal. 10% Caution. 5% New Service charge 240k 24 /7 power light A call to us will end your search immediately FOR FURTHER ENQUIRES, SPECIFIC REQUEST ... Serviced. Dry. Drainage System. Children Play Ground. Big Compound. All Room Ensuit. Church Nearby. 24 Hours Electricity. 24 Hours Security. ...",lekki,0,0,0,1,lekki3,2000000.0,2500000.0,2500000.0,1,38,7,2000000
1107, ikate ikate lekki lagos,7,4,3,4,Service apartment. Service charge 800k. Lekki right ... ...,lekki,1,1,1,1,lekki4,2500000.0,3500000.0,3000000.0,4,39,7,3500000
1108, jakande lekki lagos,6,3,3,3," To let. Fully serviced apartment.. 2/3 bedroom flat. Rent. 2m ( 2bedroom regular) Rent. 2.5m (2bedroom premium and 3bedroom) Agency. 10% Legal. 5% Caution. 200k Service charge 750k Diesel deposits. 750k Location. Jakande, Lekki phase one. ... Serviced. New. All Room Ensuit. Parking Space. 24 Hours Electricity. 24 Hours Security. ...",lekki,1,1,0,1,lekki3,2000000.0,2500000.0,2500000.0,3,38,7,2500000
1109, orchid road lekki chevron lekki lagos,8,4,4,4,Mint standard new 3bedroom terrace house with 24house power ....service charge 35k monthly while power is pay as you go ... Cheap. Serviced. Dry. New. Boys Quater. Water Treatment. Survey. Security. Big Compound. All Room Ensuit. Supermarket Nearby. 24 Hours Electricity. 24 Hours Security. Restaurants Nearby. ...,lekki,1,0,0,1,lekki4,2500000.0,3500000.0,3000000.0,2,39,7,3000000
1110," off victoria arobieke street, phase1 lekki phase 1 lekki lagos",8,4,4,4,"Fresh cozy spacious 3bedroom self powered apartment, with dedicated prepared meter in a secured, serene neighborhood of Lekki phase1 proper....service charge is 400k ... Dry. New. Boys Quater. Water Treatment. Security Doors. Security. Pop Ceiling. Street Lights. Big Compound. All Room Ensuit. Supermarket Nearby. 24 Hours Security. ...",lekki,1,1,1,1,lekki4,2500000.0,3500000.0,3000000.0,4,39,7,3500000
1111, .. lekki phase 1 lekki lagos,9,5,4,5,A Lovely 4 Bedroom Semi Detached Duplex is now available for Rent in Lekki Phase 1 with Features; -Well paved and secured compound -Located in a serene neighborhood -Good and accessible road network -All rooms ensuite -1 Room staff quarter -Fitted AC -Gas ... Dry. Boys Quater. Water Treatment. Security Doors. Security. Pop Ceiling. Big Compound. All Room Ensuit. Parking Space. ...,lekki,1,0,1,1,lekki5,3500000.0,5000000.0,4000000.0,3,48,9,4600000
1112, richmond gate estate ikate lekki lagos,7,4,3,4,Luxury 3 bedroom all rooms ensuite apartment with a room bq *Swimming pool *Gym *Serviced Generator (24 hours) *Bore hole *Water cooperation connection *Cctv camera *Automatic change over *Concrete stamped floor *Acrylic fitted kitchen *Ac connection ... Serviced. New. Drainage System. Security Doors. Child Care. Pop Ceiling. Street Lights. Big Compound. Cctv Cameras. All Room Ensuit. Supermarket Nearby. Parking Space. 24 Hours Electricity. 24 Hours Security. Gym. Boys Quater. Water Treatment. Front Desk Service. Children Play Ground. Security. Swimming Pool. Jacuzzi. ...,lekki,0,0,0,1,lekki4,2500000.0,3500000.0,3000000.0,1,39,7,2500000
1113, lekki phase 1 lekki lagos,8,4,4,4, Brand new 4bedrm semi detached duplex at Lekki second tollgate before eleganzer bus stop with 24 hours light Rent 2.5m Agreement 10% Agency 10% ... ...,lekki,0,0,0,1,lekki4,2500000.0,3500000.0,3000000.0,1,39,7,2500000
1114, orchid ikota lekki lagos,2,1,1,1,Mini flat Rent 1.2m/1.1m/1m/900 Selfcontain Rent 750k/650k /600k/550k/500k Caution fee 50k each Service charge 60k each Location orchid road/lekki conservation ... Big Compound. All Room Ensuit. Parking Space. 24 Hours Electricity. ...,lekki,1,0,0,1,lekki1,800000.0,1300000.0,1169999.9999999988,2,21,4,1200000
1115, .. ikota lekki lagos,4,2,2,2,Brand new 2bedroom flat Rent. 1.2m Agency 10% Legal 10% Caution. 10% Location. Ikota School ... New. Big Compound. All Room Ensuit. Parking Space. 24 Hours Electricity. 24 Hours Security. ...,lekki,0,0,0,0,lekki2,1500000.0,2000000.0,1700000.0,0,34,6,1200000
1116, agungi lekki lagos,8,4,4,4,3units of 4bedroom Terrace duplex with a bq for rent Rent:2.5 Caution:160 Agent/legal 10% each Location: Agunji ... Big Compound. All Room Ensuit. Parking Space. 24 Hours Electricity. 24 Hours Security. ...,lekki,0,0,0,1,lekki4,2500000.0,3500000.0,3000000.0,1,39,7,2500000
1117, ikota lekki lagos,9,5,4,5,"4 Bedroom Fully Detached Duplex with BQ Rent 4M Service Charge 480,000 Caution Fee 200,000 Legal 10% Agency 10% Available at Ikota Contact us for more Luxurious options FOR FURTHER ENQUIRES, SPECIFIC REQUEST AND ARRANGEMENTS FOR PHYSICAL INSPECTIONS, KINDLY SEND US ... Serviced. Dry. Drainage System. Pop Ceiling. Street Lights. Big Compound. All Room Ensuit. Supermarket Nearby. Parking Space. 24 Hours Electricity. 24 Hours Security. Water Treatment. Children Play Ground. Security. Church Nearby. Restaurants Nearby. ...",lekki,1,0,0,1,lekki5,3500000.0,5000000.0,4000000.0,2,48,9,4000000
1118, maruwa lekki phase 1 lekki lagos,7,4,3,4,"Magnificent e bedrooms flat Location-Marwa Rent-3m S.C-800k Desiel deposit-300k Agency -10% Legal-5% Caution -100k. A call to us will get you your desired house FOR FURTHER ENQUIRES, SPECIFIC REQUEST AND ARRANGEMENTS FOR PHYSICAL INSPECTIONS, KINDLY SEND US A SCREENSHOT OR THE LINK TO ... Serviced. Dry. Drainage System. Pop Ceiling. Street Lights. Big Compound. All Room Ensuit. Supermarket Nearby. Parking Space. 24 Hours Electricity. 24 Hours Security. Water Treatment. Children Play Ground. Security. Church Nearby. Restaurants Nearby. ...",lekki,1,0,0,1,lekki4,2500000.0,3500000.0,3000000.0,2,39,7,3000000
1119, agungi lekki lagos,7,4,3,4,"Fantastic three bedroom apartment with a bq rent 1.8m caution fee 100k service charge 120k agency 10 % legal 10 % location agungi contact us for more luxurious options for further enquires, specific request and arrangements for physical inspections, kindly send us a ... Serviced. Dry. Drainage System. Pop Ceiling. Street Lights. Big Compound. All Room Ensuit. Supermarket Nearby. Parking Space. 24 Hours Electricity. 24 Hours Security. Water Treatment. Children Play Ground. Security. Church Nearby. Restaurants Nearby. ...",lekki,0,0,0,0,lekki4,2500000.0,3500000.0,3000000.0,0,39,7,2000000
1120, ikota lekki lagos,9,5,4,5,"Luxurious 4 bedroom duplex with bq @ ikota rent 2.5m caution 200k service charge 500k legal 5% agency 10% a call to us will definitely end your search for a house for further enquires, specific request and arrangements for ... Serviced. Dry. New. Boys Quater. Pop Ceiling. Big Compound. All Room Ensuit. Parking Space. 24 Hours Electricity. 24 Hours Security. Restaurants Nearby. ...",lekki,0,0,0,1,lekki5,3500000.0,5000000.0,4000000.0,1,48,9,3500000
1121, ... osapa london lekki lagos,11,6,5,6,"Mind Blowing Five bedroom duplex Rent 4m Caution fee 200k Agency 10 % Legal 10 % Location osapa Give us a call now and let's give you the luxury you deserve FOR FURTHER ENQUIRES, SPECIFIC REQUEST AND ARRANGEMENTS FOR PHYSICAL INSPECTIONS, KINDLY ... Dry. Drainage System. Children Play Ground. Street Lights. Big Compound. All Room Ensuit. Church Nearby. 24 Hours Electricity. 24 Hours Security. Restaurants Nearby. ...",lekki,0,0,0,0,lekki6,5500000.0,6200000.0,6200000.0,0,54,10,4700000
1122, chevron lekki lagos,11,6,5,6,"Brandnew 5bedroom fully detached duplex with a BQ for rent. Rent-4m Agency fee -10% Agreement-5% Caution-200k Location-chervon alternative A call to us will end your search immediately FOR FURTHER ENQUIRES, SPECIFIC REQUEST AND ARRANGEMENTS FOR PHYSICAL INSPECTIONS, KINDLY SEND US A ... Dry. Drainage System. Boys Quater. Water Treatment. Children Play Ground. Street Lights. Big Compound. All Room Ensuit. Supermarket Nearby. Church Nearby. ...",lekki,0,0,0,0,lekki6,5500000.0,6200000.0,6200000.0,0,54,10,4700000
1123, ... osapa london lekki lagos,9,5,4,5,A Newly Renovated 4 Bedroom Fully Detached Duplex is now available for Rent in Osapa with Features; -Well paved and secured compound -Located in a serene environment -All rooms ensuite -Easily accessible good road network -1 Room staff quarter -Gas cooker -Electric oven -Heat ... Dry. Renovated. Boys Quater. Water Treatment. Security Doors. Security. Pop Ceiling. Big Compound. All Room Ensuit. Jacuzzi. Parking Space. ...,lekki,0,0,0,1,lekki5,3500000.0,5000000.0,4000000.0,1,48,9,3700000
1124, lekki phase 1 lekki lagos,7,4,3,4,A Self Service 3 Bedroom Semi Detached Duplex is now available for Rent in Lekki phase 1 with Features; -Well paved and secured compound -Located in a serene environment -All rooms ensuite -Easily accessible good road network -1 Room staff quarter -2 ... Dry. Renovated. Boys Quater. Water Treatment. Security Doors. Security. Pop Ceiling. Big Compound. All Room Ensuit. Parking Space. 24 Hours Security. ...,lekki,1,1,1,1,lekki4,2500000.0,3500000.0,3000000.0,4,39,7,3500000
1125, lekki phase 1 lekki lagos,9,5,4,5,A Luxury 4 Bedroom Terrace Duplex is now available for Rent in Lekki Phase 1 with Features; -Well paved and secured compound -Located in a serene environment -All rooms ensuite -1 Room staff quarter -Easily accessible good road network -Gas cooker -Electric oven -Microwave -Washing ... Serviced. Dry. New. Boys Quater. Water Treatment. Security Doors. Security. Pop Ceiling. Big Compound. All Room Ensuit. Jacuzzi. Parking Space. 24 Hours Security. ...,lekki,1,1,1,1,lekki5,3500000.0,5000000.0,4000000.0,4,48,9,5600000
1126, lekki phase 1 lekki lagos,11,6,5,6,A Commercial 5 Bedroom Fully Detached Duplex is now available for Rent in Lekki Phase 1 with Features; -Well paved and secured compound -Located off a major road -Good and accessible road network -All rooms ensuite -2 Rooms staff quarter -Fitted AC -Ample ... Dry. Boys Quater. Security Doors. Security. Pop Ceiling. Big Compound. All Room Ensuit. Parking Space. ...,lekki,1,1,0,1,lekki6,5500000.0,6200000.0,6200000.0,3,54,10,6200000
1127, lekki right hand side lekki phase 1 lekki lagos,7,4,3,4,2 Units of 3 Bedroom Flat are now available for Rent in Lekki Right with Features; -Well paved and secured compound -Located in a serene neighborhood -Good and accessible road network -All rooms ensuite -1 Room staff quarter each -Fridge -Ample parking space -Well ... Dry. Renovated. Boys Quater. Security Doors. Security. Pop Ceiling. Big Compound. All Room Ensuit. Parking Space. ...,lekki,1,1,1,1,lekki4,2500000.0,3500000.0,3000000.0,4,39,7,4300000
1128, lekki phase 1 lekki lagos,7,4,3,4,A Lovely 3 Bedroom Flat is now available for Rent in Lekki Phase 1 with Features; -Well paved and secured compound -Located in a serene environment -All rooms ensuite -1 Room staff quarter -Easily accessible good road network -Heat expeller -Borehole -Water treatment plant -Well ... Dry. Renovated. Boys Quater. Security Doors. Security. Pop Ceiling. Big Compound. All Room Ensuit. Parking Space. 24 Hours Security. ...,lekki,1,0,0,1,lekki4,2500000.0,3500000.0,3000000.0,2,39,7,3000000
1129, lekki phase 1 lekki lagos,9,5,4,5,A Self Service 4 Bedroom Semi Detached Duplex is now available for Rent in Lekki Phase 1 with Features; -Well paved and secured compound -Located in a serene neighborhood -Good and accessible road network -All rooms ensuite -1 Room staff quarter -Ample ... Dry. Renovated. Water Treatment. Security Doors. Security. Pop Ceiling. Big Compound. All Room Ensuit. Parking Space. ...,lekki,1,1,1,1,lekki5,3500000.0,5000000.0,4000000.0,4,48,9,5600000
1130, lekki scheme 2 ajah lagos,9,5,4,5,Brand New 4 Bedroom Semi Detached Duplex + 2 Bedroom BQ. Rent: NGN 2.5 m Agency: 10% Legal: 5% ... New. Drainage System. Boys Quater. Water Treatment. Pop Ceiling. Big Compound. All Room Ensuit. ...,lekki,0,0,0,1,lekki5,3500000.0,5000000.0,4000000.0,1,48,9,3500000
1131, lekki scheme 2 ajah lagos,9,5,4,5,Spacious 4 Bedroom Detached Duplex + Bq + 2 Sitting Rooms + Study Room For rent @ Ajah - Lekki Scheme 2 Rental fee: NGN 3m (negotiable) Agency: 10% Legal: 10% ... Boys Quater. Pop Ceiling. Big Compound. All Room Ensuit. ...,lekki,0,0,0,1,lekki5,3500000.0,5000000.0,4000000.0,1,48,9,3500000
1132, lekki scheme 2 ajah lagos,7,4,3,4,Well Maintained 3 Bedroom Flat + BQ for rent @ Ajah - Lekki Scheme 2 Rental fee: NGN 1.5m Caution Fee: NGN 400k Service Charge: NGN 200k Agency: 10% Legal: 10% ... Boys Quater. Water Treatment. Security. Pop Ceiling. Big Compound. All Room Ensuit. Parking Space. ...,lekki,0,0,0,0,lekki4,2500000.0,3500000.0,3000000.0,0,39,7,2000000
1133, chevron lekki lagos,9,5,4,5,4 Bedroom Semi Detached Duplex + BQ for rent @ Lekki - Chevron (Ideal For Office/Commercial Purpose) Rental fee: NGN 3.5 m Caution: NGN 200k Agency: 10% Legal: 10% ... All Room Ensuit. Supermarket Nearby. Parking Space. ...,lekki,0,0,0,1,lekki5,3500000.0,5000000.0,4000000.0,1,48,9,3500000
1134, lekki phase 2 lekki lagos,9,5,4,5,"FEATURES: - All Bedrooms En suite with Water Heaters - Fully Fitted Kitchen with Cabinets - Marble Tiles - Wardrobes - Serene Environment - Ample Parking Space, Self Compound ... New. Drainage System. Boys Quater. Water Treatment. Security Doors. Security. Pop Ceiling. Big Compound. All Room Ensuit. Parking Space. ...",lekki,0,0,0,1,lekki5,3500000.0,5000000.0,4000000.0,1,48,9,3500000
1135," eleganza gardens, vgc lekki lagos",7,4,3,4,"NOW LETTING!! We have 3 Bedroom luxury flat to complete in few weeks time. in a paved estate facing VGC. *Details:* ** Directly Opposite V.G.C ** Serene Environment with Greens ** Spacious Rooms, Living Room and Dining Available ** nice ... Serviced. New. Drainage System. Water Treatment. Children Play Ground. Security. Pop Ceiling. Street Lights. Swimming Pool. Big Compound. All Room Ensuit. 24 Hours Security. ...",lekki,0,0,0,0,lekki4,2500000.0,3500000.0,3000000.0,0,39,7,2000000
1136, chevron lekki lagos,7,4,3,4,"Luxurious 3bedroom serviced apartment with a bq for rent Location-osapa Rent:2.5 S/C:500k Caution:200 Legal:5% Agent:10% A call to us will end your search immediately FOR FURTHER ENQUIRES, SPECIFIC REQUEST AND ARRANGEMENTS FOR PHYSICAL INSPECTIONS, KINDLY SEND US A SCREENSHOT OR THE LINK ... Serviced. Dry. Drainage System. Boys Quater. Children Play Ground. Big Compound. All Room Ensuit. Church Nearby. 24 Hours Electricity. 24 Hours Security. ...",lekki,0,0,0,1,lekki4,2500000.0,3500000.0,3000000.0,1,39,7,2500000
1137, off admiralty way lekki phase 1 lekki lagos,11,6,5,6,Ultra modern 5 bedroom semi detached house with bq Generator stand Bore hole Water cooperation connection Cctv camera Automatic change over Concrete stamped floor Acrylic fitted kitchen Ac piping Green area Water stantion Pandora sit ... Renovated. New. Drainage System. Security Doors. Child Care. Pop Ceiling. Street Lights. Big Compound. Cctv Cameras. All Room Ensuit. Supermarket Nearby. 24 Hours Security. Boys Quater. Water Treatment. Children Play Ground. Security. ...,lekki,0,0,0,0,lekki6,5500000.0,6200000.0,6200000.0,0,54,10,5000000
1138, ikate ikate lekki lagos,5,3,2,3,New. Built by the Masters. This magnificent 2 bedroom is mastro. No words... ... Serviced. New. All Room Ensuit. 24 Hours Electricity. ...,lekki,1,1,1,1,lekki3,2000000.0,2500000.0,2500000.0,4,38,7,3000000
1139, chevron lekki lagos,7,4,3,4,"FEATURES: - All Bedrooms En suite with Water Heaters - Fully Fitted Kitchen with Cabinets - Marble Tiles - Wardrobes - P.O.P ceiling - Dining - Serene Environment -Ample Parking Space, 24 hours power, Swimming ... Drainage System. Security Doors. Pop Ceiling. Street Lights. Big Compound. Cctv Cameras. All Room Ensuit. Parking Space. 24 Hours Electricity. 24 Hours Security. Gym. Water Treatment. Elevator. Children Play Ground. Security. Swimming Pool. ...",lekki,0,0,0,1,lekki4,2500000.0,3500000.0,3000000.0,1,39,7,2800000
1140, chevron lekki lagos,9,5,4,5,A nice 4 Bedroom Semi-detached House which situates in a serene estate in Lekki. This building is well accessible with tarred roads and all amenities are in place to give you a comfortable business environment. ... Dry. New. Boys Quater. Security Doors. Security. Pop Ceiling. Street Lights. Office Supplies. Cctv Cameras. All Room Ensuit. Supermarket Nearby. Parking Space. 24 Hours Security. Restaurants Nearby. ...,lekki,1,0,0,1,lekki5,3500000.0,5000000.0,4000000.0,2,48,9,4000000
1141, .. agungi lekki lagos,7,4,3,4,Nice 3bedroom flat with a room bq Rent. 1.8m S.C. 500k (excluding diesel) Agency. 10% Legal. 10% Caution. 150k Gen light is 7pm to 7am weekday Weekend 12pm to 3pm 7pm to 7am Location. Agungi Give us a call now and let's give you the ... Serviced. Dry. Drainage System. Boys Quater. Children Play Ground. Big Compound. All Room Ensuit. Church Nearby. 24 Hours Electricity. 24 Hours Security. ...,lekki,0,0,0,0,lekki4,2500000.0,3500000.0,3000000.0,0,39,7,2000000
1142, - ikate lekki lagos,2,1,1,1,Selfcon Appartment (Shared kitchen) For Rent @ Lekki - Ikate Rent: *NGN 815 k* Service charge: NGN 150 k Caution: NGN 50 k Agency: 5% ... Pop Ceiling. ...,lekki,0,0,0,1,lekki1,800000.0,1300000.0,1169999.9999999988,1,21,4,815000
1143, lekki phase 1 lekki lagos,7,4,3,4,A Serviced Brand New 3 Bedroom Flat is now available for Rent in Lekki Phase 1 with Features; -Well paved and secured compound -Located in a serene neighborhood -Good and accessible road network -All rooms ensuite -Swimming pool -Gym -1 Room staff quarter -Fitted ... Serviced. Dry. New. Security Doors. Pop Ceiling. Big Compound. All Room Ensuit. Parking Space. 24 Hours Security. Gym. Boys Quater. Water Treatment. Elevator. Security. Swimming Pool. Jacuzzi. ...,lekki,1,1,1,1,lekki4,2500000.0,3500000.0,3000000.0,4,39,7,4300000
1144, manor garden estate vgc lekki lagos,9,5,4,5,"** 4 bedroom Semi-Detached Duplex for Rent ** plus A room Boy's Quarter ** spacious rooms, Living room & Dining available ** spacious Kitchen with gas cooker, Store etc ** children playing ground in the estate. ** 24 hours ... Serviced. Dry. Renovated. Drainage System. Boys Quater. Water Treatment. Children Play Ground. Security. Pop Ceiling. Street Lights. All Room Ensuit. Parking Space. 24 Hours Security. ...",lekki,0,0,0,1,lekki5,3500000.0,5000000.0,4000000.0,1,48,9,3500000
1145, osapa london lekki lagos,2,1,1,1,"Furnished Selfcon Appartment For Rent @ Lekki - Osapa Rent: *NGN 800k* ( covers phcn, 12 hours gen weekdays n 24 hours weekend, cleaning, waste disposal and caution fee) Agency: 10% Legal: 5% ... Water Treatment. All Room Ensuit. ...",lekki,0,0,0,1,lekki1,800000.0,1300000.0,1169999.9999999988,1,21,4,800000
1146, idado idado lekki lagos,5,3,2,3,Newly built 2bedroom terrace. Sitting room and kitchen downstairs and the 2 rooms all upstairs. Modern fishing. Self service ... ...,lekki,0,0,0,1,lekki3,2000000.0,2500000.0,2500000.0,1,38,7,2000000
1147, ikate lekki lagos,7,4,3,4,"Lovely 3 bedroom en-suite flat for rent at Ikate Rent 2m Agency 10% Legal 10% Caution 100k Service charge 250k A call to us will end your search immediately FOR FURTHER ENQUIRES, SPECIFIC REQUEST AND ARRANGEMENTS FOR PHYSICAL INSPECTIONS, KINDLY SEND ... Serviced. Dry. Drainage System. Children Play Ground. Pop Ceiling. Big Compound. All Room Ensuit. Church Nearby. Parking Space. ...",lekki,0,0,0,0,lekki4,2500000.0,3500000.0,3000000.0,0,39,7,2000000
1148, ... ikate lekki lagos,7,4,3,4,"Removed 3 bedrooms flat at Ikate Rent 3m Caution: 100K Service charge is N600,000/year Legal. 5% Agency fee.10% FEATURES INCLUDE ALL ROOMS ENSUITE FITTED KITCHEN GUEST TOILET BALCONY LARGE LIVING AREA SPACE Large Kitchen and Bedrooms SWIMMING POOL GYM FACILITY MANAGEMENT OFFICE AMPLE PARKING SPACE WATER TREATMENT PLANT 24/7 SECURITY 24/7 POWER DEDICATED ELEVATOR ESTATE WELL ... Serviced. Dry. Renovated. Security Doors. Pop Ceiling. Street Lights. Big Compound. All Room Ensuit. Supermarket Nearby. Parking Space. 24 Hours Electricity. 24 Hours Security. Gym. Water Treatment. Survey. Security. Swimming Pool. ...",lekki,1,0,0,1,lekki4,2500000.0,3500000.0,3000000.0,2,39,7,3000000
1149, chevron lekki lagos,9,5,4,5,A nice 4 Bedroom Semi-Detached House with inbuilt BQ which situates in a serene estate in Lekki. This building is well accessible with tarred roads and all amenities are in place to make you have ... Cheap. Renovated. Drainage System. Boys Quater. Water Treatment. Security Doors. Security. Pop Ceiling. Street Lights. All Room Ensuit. Supermarket Nearby. Jacuzzi. Parking Space. Restaurants Nearby. ...,lekki,0,0,0,1,lekki5,3500000.0,5000000.0,4000000.0,1,48,9,3500000
1150, lekki phase 1 lekki phase 1 lekki lagos,9,5,4,5,FOR RENT Lekki phase 1 Lagos 4 bedroom all rooms ensuite apartment plus a bq Features: - All Rooms Ensuite - 24hrs Security -24 hrs Power - Boyâ€™s Quarter - Big Compound -Ocean view - Generator - ... Serviced. New. Drainage System. Security Doors. Pop Ceiling. Street Lights. Big Compound. Cctv Cameras. All Room Ensuit. Supermarket Nearby. Parking Space. 24 Hours Electricity. 24 Hours Security. Boys Quater. Water Treatment. Ocean View. Children Play Ground. Security. Church Nearby. Jacuzzi. Restaurants Nearby. ...,lekki,1,1,1,1,lekki5,3500000.0,5000000.0,4000000.0,4,48,9,5000000
1151, off admiralty way lekki phase 1 lekki lagos,5,3,2,3,FOR RENT Lekki Lagos 2 bedroom all rooms ensuite apartment with a study room Features: - All Rooms Ensuite - 24hrs Security -24 hrs Power - Big Compound - Generator - CCTV Cameras - Bathtub - ... Serviced. Renovated. Drainage System. Water Treatment. Security Doors. Security. Pop Ceiling. Street Lights. Big Compound. All Room Ensuit. Parking Space. 24 Hours Electricity. 24 Hours Security. ...,lekki,1,1,0,1,lekki3,2000000.0,2500000.0,2500000.0,3,38,7,2500000
1152, off admiralty way lekki phase 1 lekki lagos,7,4,3,4,Luxury 3 bedroom all rooms ensuite apartment *Generator house *Bore hole *Water cooperation connection *Cctv camera *Water treatment *Automatic change over *Concrete stamped floor *Acrylic fitted kitchen *Ac connection *Security *Water stantion *Pandora sit out ... Serviced. Renovated. Drainage System. Security Doors. Child Care. Pop Ceiling. Street Lights. Big Compound. Cctv Cameras. All Room Ensuit. Supermarket Nearby. Parking Space. 24 Hours Security. Water Treatment. Security. Jacuzzi. ...,lekki,0,0,0,1,lekki4,2500000.0,3500000.0,3000000.0,1,39,7,2800000
1153, off providence road lekki phase 1 lekki lagos,9,5,4,5,FOR SALE Lekki Phase 1 Lagos 4 bedroom detached duplex with 2 bqs for rent Features: - All Rooms Ensuite - 24hrs Security - 2 Boyâ€™s Quarter - Big Compound - Solar Panels - CCTV Cameras - Bathtub - Smoke Detectors - Cinema - Fully Fitted Kitchen - Air ... Serviced. Furnished. New. Drainage System. Security Doors. Child Care. Pop Ceiling. Street Lights. Big Compound. Cctv Cameras. All Room Ensuit. Supermarket Nearby. Parking Space. 24 Hours Electricity. 24 Hours Security. Gym. Boys Quater. Water Treatment. Children Play Ground. Security. Swimming Pool. Jacuzzi. ...,lekki,1,1,1,1,lekki5,3500000.0,5000000.0,4000000.0,4,48,9,5600000
1154, .. ikate lekki lagos,11,6,5,6,A Brand New 5 Bedroom Fully Detached Duplex is now available for Rent in Ikate with Features; -Well paved and secured compound -Located in a serene neighborhood -Good and accessible road network -All rooms ensuite -1 Room staff quarter -Ample parking space -Well ... Dry. New. Boys Quater. Water Treatment. Security Doors. Security. Pop Ceiling. Big Compound. All Room Ensuit. Parking Space. ...,lekki,0,0,0,1,lekki6,5500000.0,6200000.0,6200000.0,1,54,10,6000000
1155, - lekki phase 1 lekki lagos,11,6,5,6,A Self Service 5 Bedroom Fully Detached Duplex is now available for Rent in Lekki Phase 1 with Features; -Well paved and secured compound -Located in a serene neighborhood -Good and accessible road network -All rooms ensuite -1 Room staff quarter -Ample ... Dry. Boys Quater. Water Treatment. Security Doors. Security. Pop Ceiling. Big Compound. All Room Ensuit. Parking Space. ...,lekki,1,1,0,1,lekki6,5500000.0,6200000.0,6200000.0,3,54,10,6200000
1156, lekki phase 1 lekki lagos,9,5,4,5,A Lovely 4 Bedroom Semi Detached Duplex is now available for Rent in Lekki Phase 1 with Features; -Well paved and secured compound -Located in a serene neighborhood -Good and accessible road network -All rooms ensuite -2 Rooms staff quarter -Ample parking ... Dry. Renovated. Boys Quater. Water Treatment. Security Doors. Security. Pop Ceiling. Big Compound. All Room Ensuit. Parking Space. ...,lekki,1,1,1,1,lekki5,3500000.0,5000000.0,4000000.0,4,48,9,5000000
1157, ilasan lekki lagos,11,6,5,6,5 Bedroom Townhouse + BQ ( Corner Piece) For Rent @ Lekki - ILasan Rental fee: NGN 3.5 m Service charge: NGN 30k (Monthly) Caution Fee: NGN 200k Agency: 10% Legal: 5% ... Serviced. Boys Quater. Water Treatment. Pop Ceiling. Big Compound. All Room Ensuit. Parking Space. 24 Hours Electricity. ...,lekki,0,0,0,0,lekki6,5500000.0,6200000.0,6200000.0,0,54,10,4700000
1158, ikate ikate lekki lagos,9,5,4,5,Serviced. 24/7 power on. Modern design. Batted environment. Services mini estate. Comes with a maid room. Service charge 680k ... Serviced. New. Boys Quater. Big Compound. All Room Ensuit. 24 Hours Electricity. 24 Hours Security. ...,lekki,1,0,1,1,lekki5,3500000.0,5000000.0,4000000.0,3,48,9,4500000
1159, ologolo lekki lagos,7,4,3,4,3 bedroom self compound. Fitted kitchen . wardrobe .....very modern . self service ... ...,lekki,1,0,0,1,lekki4,2500000.0,3500000.0,3000000.0,2,39,7,3000000
1160, spg igbo efon lekki lagos,3,2,1,2,Newly built. Fully serviced. ... Serviced. New. Big Compound. 24 Hours Security. ...,lekki,0,0,0,0,lekki2,1500000.0,2000000.0,1700000.0,0,34,6,1300000
1161, lekki phase 1 lekki lagos,5,3,2,3,A Luxury Serviced 2 Bedroom Flat is now available for Rent in Lekki Phase 1 with Features; -Well paved and secured compound -Located in a serene neighborhood -Good and accessible road network -All rooms ensuite -1 Room staff quarter -Fitted AC -Washing machine -Gas ... Serviced. Dry. Renovated. Water Treatment. Security Doors. Security. Pop Ceiling. Big Compound. All Room Ensuit. Parking Space. 24 Hours Security. ...,lekki,1,1,1,1,lekki3,2000000.0,2500000.0,2500000.0,4,38,7,3000000
1162, lekki phase 1 lekki lagos,11,6,5,6,A Commercial 5 Bedroom Semi Detached Duplex is now available for Rent in Lekki Phase 1 with Features; -Well paved and secured compound -Located in a serene environment -All rooms ensuite -2 Rooms staff quarter -Easily accessible good road network -Fitted AC -Gas ... Dry. Renovated. Boys Quater. Water Treatment. Security Doors. Security. Pop Ceiling. Big Compound. All Room Ensuit. ...,lekki,1,1,0,1,lekki6,5500000.0,6200000.0,6200000.0,3,54,10,6200000
1163, nicon town lekki lagos,11,6,5,6,A Massive 5 Bedroom Fully Detached Duplex is now available for Rent in Nicon Town with Features; -Well paved and secured compound -Located in a serene environment -All rooms ensuite -Easily accessible good road network -2 Rooms staff quarter -Ante room -Gas cooker -Electric ... Dry. New. Boys Quater. Water Treatment. Security Doors. Security. Pop Ceiling. Big Compound. All Room Ensuit. Parking Space. 24 Hours Security. ...,lekki,1,1,0,1,lekki6,5500000.0,6200000.0,6200000.0,3,54,10,6200000
1164, lekki phase 1 lekki lagos,9,5,4,5,A Self Service 4 Bedroom Fully Detached Duplex is now available for Rent in Lekki Phase 1 with Features; -Well paved and secured compound -Located in a serene environment -All rooms ensuite -Easily accessible good road network -1 Room staff quarter -Heat ... Dry. Boys Quater. Water Treatment. Security Doors. Security. Pop Ceiling. Big Compound. All Room Ensuit. Parking Space. ...,lekki,1,1,1,1,lekki5,3500000.0,5000000.0,4000000.0,4,48,9,5600000
1165, lekki phase 1 lekki lagos,9,5,4,5,A Newly Renovated 4 Bedroom Semi Detached Duplex is now available for Rent in Lekki Phase 1 with Features; -Well paved and secured compound -Located in a serene environment -All rooms ensuite -Easily accessible good road network -1 Room staff quarter -Borehole -Water ... Dry. Renovated. Boys Quater. Security Doors. Security. Pop Ceiling. Big Compound. All Room Ensuit. Parking Space. ...,lekki,1,0,1,1,lekki5,3500000.0,5000000.0,4000000.0,3,48,9,4500000
1166, pinnock estate osapa london lekki lagos,11,6,5,6,A Self Service 5 Bedroom Fully Detached Duplex is now available for Rent in Pinnock Estate with Features; -Well paved and secured compound -Located in a serene neighborhood -Good and accessible road network -All rooms ensuite -1 Room staff quarter -Ample parking ... Dry. New. Boys Quater. Water Treatment. Security Doors. Security. Pop Ceiling. Big Compound. All Room Ensuit. Parking Space. ...,lekki,0,0,0,1,lekki6,5500000.0,6200000.0,6200000.0,1,54,10,6000000
1167, lekki phase 1 lekki lagos,2,1,1,1,"Lovely Commercial Shop Space for let in Lekki Phase 1 Lagos. Price N4M per annum For Enquiries and Inspection Please Call Us On: 09098586907, 08181849377 or 09098586908 ... ...",lekki,1,1,1,1,lekki1,800000.0,1300000.0,1169999.9999999988,4,21,4,2000000
1168, lekki phase 1 lekki lagos,2,1,1,1,"Lovely Commercial Shop Space for let in Lekki Phase 1 Lagos. Price N4M per annum For Enquiries and Inspection Please Call Us On: 09098586907, 08181849377 or 09098586908 ... ...",lekki,1,1,1,1,lekki1,800000.0,1300000.0,1169999.9999999988,4,21,4,2000000
1169," car wash bridge, agungi agungi lekki lagos",9,5,4,5,4bedroom terrace duplex In a well secured and organized estate that has both options of 1) we can service if for you 2) you can service yourself ... ...,lekki,0,0,0,1,lekki5,3500000.0,5000000.0,4000000.0,1,48,9,3500000
1170, jakande lekki lagos,6,3,3,3,3bedroom duplex @ jakande Rent. 2.5 Caution fee 150k Service charge. 480k Agency. 10% Legal. 5% ... All Room Ensuit. Parking Space. 24 Hours Electricity. ...,lekki,1,1,0,1,lekki3,2000000.0,2500000.0,2500000.0,3,38,7,2500000
1171, lekki phase 1 lekki lagos,6,3,3,3,To let 3bedroom flat with bq Rent. 2.2m Agency. 10% Legal. 10% Caution. 150k Location. Lekki phase one ... All Room Ensuit. Parking Space. 24 Hours Electricity. 24 Hours Security. ...,lekki,0,0,0,1,lekki3,2000000.0,2500000.0,2500000.0,1,38,7,2200000
1172, lekki phase 1 lekki lagos,6,3,3,3,"24/7/365 days fully serviced 3 bedroom apartment with a study room, laundry room, store and one room boys quarter at Lekki Phase 1 Rent 3.5m Agency 10% Legal 10% Caution 295k Service charge 1m Diesel deposit per consumption 300k ... Serviced. Boys Quater. Big Compound. All Room Ensuit. Parking Space. 24 Hours Electricity. 24 Hours Security. ...",lekki,1,1,1,1,lekki3,2000000.0,2500000.0,2500000.0,4,38,7,3500000
1173, ikota lekki lagos,8,4,4,4,"Available at Ikota Villa Estate 4 Bedroom Fully Detached Duplex with BQ Rent 4M Service Charge 480,000 Caution Fee 200,000 Legal 10% Agency 10% ... Boys Quater. All Room Ensuit. Parking Space. 24 Hours Electricity. ...",lekki,1,1,1,1,lekki4,2500000.0,3500000.0,3000000.0,4,39,7,4000000
1174, chevy view chevron lekki lagos,2,1,1,1,Lovely Master bedroom Mini flat Apartment for rent Location: Chevron rent: 1m Agreement:10 percent legal; 10 percent Caution:100k Service charge:100k ... Big Compound. All Room Ensuit. Parking Space. 24 Hours Electricity. 24 Hours Security. ...,lekki,0,0,0,1,lekki1,800000.0,1300000.0,1169999.9999999988,1,21,4,1000000
1175, lekki phase 1 lekki lagos,6,3,3,3,"Brand new serviced 3 bedroom flat for rent Lekki Phase 1 Rent 2.5m Agency 10% Legal 5% Caution 200k Service charge 750k NB: Service charge covers waste disposal, water treatment, security and cleaning of the compound, Lightening of common area, prepaid meter ... New. Big Compound. All Room Ensuit. Parking Space. 24 Hours Electricity. ...",lekki,1,1,0,1,lekki3,2000000.0,2500000.0,2500000.0,3,38,7,2500000
1176, lekki phase 1 lekki lagos,6,3,3,3,Serviced 3 bedroom flat in an estate at Lekki phase 1 Rent 2.5m Caution 150k Agency 10% Legal 5% Service charge 600k (Excluding Nepa and generator power respectively) 12hrs weekdays 18hrs weekends and public holidays Diesel deposit is contributed per supply ... Boys Quater. All Room Ensuit. Parking Space. 24 Hours Electricity. ...,lekki,1,1,0,1,lekki3,2000000.0,2500000.0,2500000.0,3,38,7,2500000
1177, marwa lekki phase 1 lekki lagos,6,3,3,3,3 bedroom apartment for rent Location-Marwa Rent-3m S.C-800k Desiel deposit-300k Agency -10% Legal-5% Caution -100k. ... Big Compound. All Room Ensuit. Parking Space. 24 Hours Electricity. ...,lekki,1,1,1,1,lekki3,2000000.0,2500000.0,2500000.0,4,38,7,3000000
1178, osapa london lekki lagos,4,2,2,2,3bedroom flat at osapa London Rent 2.2 Refundable caution 100k Legal 10% Agency 10% ... Big Compound. All Room Ensuit. Parking Space. 24 Hours Electricity. 24 Hours Security. ...,lekki,1,1,1,1,lekki2,1500000.0,2000000.0,1700000.0,4,34,6,2200000
1179, lekki lekki phase 1 lekki lagos,7,4,3,4,"An Exquisite well finished 3 Bedroom Apartment all rooms Ensuite with a 1 room Bq. *Fully fitted Kitchen *Electronic Security system *Sound and lighting Electronic System *Water Treatment *Garage SpaceÂ  * Swimming Pool *Gym *Security Doors, Etc PRICE: #5MÂ  SERVICE CHARGES & DIESEL:#700 Thousand ... ...",lekki,1,1,1,1,lekki4,2500000.0,3500000.0,3000000.0,4,39,7,4300000
1180, lekki lekki phase 1 lekki lagos,7,4,3,4,Tasteful 3 bedroom ensuite apartment with a well fitted kitchen and boys quarter (self serviced) *POP finishing *Water Treatment *Security Doors *Well Fitted kitchenÂ  *Big compoundÂ  *General SecurityÂ  PRICE: 3Million yearly ... ...,lekki,0,0,0,1,lekki4,2500000.0,3500000.0,3000000.0,1,39,7,2500000
1181, - lekki phase 1 lekki lagos,7,4,3,4,Tasteful 3 bedroom ensuite apartment with a well fitted kitchen and a drivers quartersÂ  *POP finishing *Water Treatment *Security Doors *Well Fitted kitchenÂ  *Big compoundÂ  *General SecurityÂ  *Self Serviced PRICE: 2.7 MillionÂ  SERVICE CHARGE: Managed ... ...,lekki,0,0,0,1,lekki4,2500000.0,3500000.0,3000000.0,1,39,7,2700000
1182, off admiralty way lekki phase 1 lekki lagos,7,4,3,4,"Fully serviced three bedroom apartment located in a serene and secured environment in Lekki with eye-catching features such as tiled rooms, neatly painted rooms, good access roads, and spacious rooms. Lekki is easily accessible due ... Renovated. Security Doors. Pop Ceiling. Street Lights. Big Compound. Cctv Cameras. All Room Ensuit. Supermarket Nearby. Parking Space. 24 Hours Electricity. 24 Hours Security. Water Treatment. Security. Restaurants Nearby. ...",lekki,1,1,1,1,lekki4,2500000.0,3500000.0,3000000.0,4,39,7,3500000
1183, off freedom way lekki phase 1 lekki lagos,5,3,2,3,Luxury 2 bedroom apartment with a well fitted open plan kitchen Generator connection Bore hole Water cooperation connection Cctv camera Automatic change over Concrete stamped floor Acrylic fitted kitchen Ac Green area Water stantion Pandora ... Serviced. Furnished. New. Drainage System. Security Doors. Child Care. Pop Ceiling. Street Lights. Big Compound. Cctv Cameras. All Room Ensuit. Supermarket Nearby. Parking Space. 24 Hours Electricity. 24 Hours Security. Water Treatment. Security. Swimming Pool. Church Nearby. Restaurants Nearby. ...,lekki,1,1,1,1,lekki3,2000000.0,2500000.0,2500000.0,4,38,7,3500000
1184, - lekki phase 1 lekki lagos,7,4,3,4,A Tasteful 3 bedroom aprtment Â with a well fitted kitchenÂ  *Serviced generator *POP ceiling and a well screeded wall *Gated Compound *Ample Parking Space *24 hours generator Â  *Lawn *Secured area PRICE: #5MillionÂ  SERVICE CHARGE:2.5 ... ...,lekki,1,1,1,1,lekki4,2500000.0,3500000.0,3000000.0,4,39,7,4300000
1185, off admiralty road lekki phase 1 lekki lagos,9,5,4,5,"For Lease: 4 Bedroom semi Detached house, 1 Study room, large sitting room/dining area, family lounge, with 2 room Bq. Loundry, Facilities: Swimming pool, Water treatment plant, Gym house, Dedicated Generator house, CCTV cameras, intercom ... Serviced. Renovated. Drainage System. Security Doors. Child Care. Pop Ceiling. C Of O. Street Lights. Big Compound. All Room Ensuit. Parking Space. 24 Hours Electricity. 24 Hours Security. Gym. Boys Quater. Water Treatment. Children Play Ground. Security. ...",lekki,1,1,1,1,lekki5,3500000.0,5000000.0,4000000.0,4,48,9,5600000
1186, lekki right lekki phase 1 lekki lagos,7,4,3,4,"3 Bedroom apartment with a well fitted kitchen for rent in Lekki right spacious compound with well treated drinkable water, all the rooms-en suite. Large and well Cabineted Fully equipped Kitchen with Cooker, Smoke expeller ... ...",lekki,1,1,1,1,lekki4,2500000.0,3500000.0,3000000.0,4,39,7,3500000
1187, ikota lekki lagos,11,6,5,6,"Exquisite 5bedroom fully detached duplex with a room bq at ikota Rent. 3m Agency. 10% Legal. 5% Caution 100k Contact us for more Luxurious options FOR FURTHER ENQUIRES, SPECIFIC REQUEST AND ARRANGEMENTS FOR PHYSICAL INSPECTIONS, KINDLY SEND US A SCREENSHOT OR ... Dry. Drainage System. Pop Ceiling. Street Lights. Big Compound. All Room Ensuit. Supermarket Nearby. Parking Space. 24 Hours Electricity. 24 Hours Security. Boys Quater. Water Treatment. Children Play Ground. Security. Church Nearby. Restaurants Nearby. ...",lekki,0,0,0,0,lekki6,5500000.0,6200000.0,6200000.0,0,54,10,4700000
1188, lekki phase 1 lekki lagos,7,4,3,4,Serviced 3 bedroom flat in an estate at Lekki phase 1 Rent 2.5m Caution 150k Agency 10% Legal 5% Service charge 600k (Excluding Nepa and generator power respectively) 12hrs weekdays 18hrs weekends and public holidays Diesel deposit is contributed per supply ... Serviced. Dry. Drainage System. Pop Ceiling. Street Lights. Big Compound. All Room Ensuit. Supermarket Nearby. Parking Space. 24 Hours Electricity. 24 Hours Security. Water Treatment. Children Play Ground. Security. Church Nearby. Restaurants Nearby. ...,lekki,0,0,0,1,lekki4,2500000.0,3500000.0,3000000.0,1,39,7,2500000
1189, chevron lekki lagos,7,4,3,4,"3bedroom semi-detached Duplex for rent . Chevron Rent- 3.5m Caution-150k Agency-10% Legal -10% A call to us will definitely end your search for a house FOR FURTHER ENQUIRES, SPECIFIC REQUEST AND ARRANGEMENTS FOR PHYSICAL INSPECTIONS, KINDLY SEND US A SCREENSHOT OR ... Dry. Drainage System. Children Play Ground. Big Compound. Church Nearby. 24 Hours Electricity. Restaurants Nearby. ...",lekki,1,1,1,1,lekki4,2500000.0,3500000.0,3000000.0,4,39,7,3500000
1190, ologolo lekki lagos,7,4,3,4,"Sweetly built Three bedroom apartment Rent 1.7m Caution fee 150k Service charge 200k Agency 10 % Legal 10 % Location igboefon /ologolo A call to us will definitely end your search for a house FOR FURTHER ENQUIRES, SPECIFIC REQUEST AND ARRANGEMENTS FOR PHYSICAL ... Serviced. Dry. Big Compound. All Room Ensuit. 24 Hours Electricity. 24 Hours Security. ...",lekki,0,0,0,0,lekki4,2500000.0,3500000.0,3000000.0,0,39,7,2000000
1191, orchid road lekki phase 2 lekki lagos,9,5,4,5,"4 bedroom duplex with a bq for rent @ Orchid road, Lekki Rent 3m Legal 5% Agency 10% Caution 300k Rent is negotiable A call to us will end your search for a house FOR FURTHER ENQUIRIES, SPECIFIC REQUEST AND ... Dry. Renovated. Drainage System. Pop Ceiling. Street Lights. Big Compound. Supermarket Nearby. Parking Space. 24 Hours Electricity. 24 Hours Security. Boys Quater. Water Treatment. Children Play Ground. Security. Church Nearby. Restaurants Nearby. ...",lekki,0,0,0,1,lekki5,3500000.0,5000000.0,4000000.0,1,48,9,3500000
1192, agungi lekki lagos,9,5,4,5,"Four bedroom duplex Rent 3m Caution fee 200k Agency 10 % Legal 10 % Location agungi For more luxurious options,. a call to us will end your house search FOR FURTHER ENQUIRES, SPECIFIC REQUEST AND PHYSICAL INSPECTIONS, KINDLY SEND US A SCREENSHOT ... Dry. Renovated. Drainage System. Pop Ceiling. Street Lights. Big Compound. All Room Ensuit. Supermarket Nearby. Parking Space. 24 Hours Electricity. 24 Hours Security. Children Play Ground. Security. Church Nearby. Restaurants Nearby. ...",lekki,0,0,0,1,lekki5,3500000.0,5000000.0,4000000.0,1,48,9,3500000
1193, chevron lekki lagos,11,6,5,6,"Luxurious 5bedroom fully detached Duplex with a BQ. Location - chevron Rent -4m Caution -250k Agency -10% Legal -5% It's a self service apartment. A call to us will end your search immediately FOR FURTHER ENQUIRES, SPECIFIC REQUEST AND ... Dry. Drainage System. Boys Quater. Children Play Ground. Big Compound. Church Nearby. ...",lekki,0,0,0,0,lekki6,5500000.0,6200000.0,6200000.0,0,54,10,4700000
1194, .. ikota lekki lagos,5,3,2,3,"Brand new 2bedroom flat Rent. 1.2m Agency 10% Legal 10% Caution. 10% Location. Ikota School A call to us will end your search immediately FOR FURTHER ENQUIRES, SPECIFIC REQUEST AND ARRANGEMENTS FOR PHYSICAL INSPECTIONS, KINDLY SEND US A SCREENSHOT OR ... Dry. Drainage System. Children Play Ground. Big Compound. Church Nearby. ...",lekki,0,0,0,0,lekki3,2000000.0,2500000.0,2500000.0,0,38,7,1200000
1195, mini serviced estate osapa london lekki lagos,11,6,5,6,"beautifully built luxurious 5bedroom duplex in a serviced estate with 3 to 4 car park space, 24hrs security, clean water supply, 24hrs electricity supply, serene environment/ estate, with swimming pool, basket ball court, gym house, ... ...",lekki,0,0,0,1,lekki6,5500000.0,6200000.0,6200000.0,1,54,10,6000000
1196, prime water estate lekki phase 1 lekki lagos,7,4,3,4,3bedroom flat apartment Rent 2.5m ... Serviced. Renovated. Drainage System. Security Doors. Pop Ceiling. Street Lights. Big Compound. Cctv Cameras. All Room Ensuit. Supermarket Nearby. Parking Space. 24 Hours Electricity. 24 Hours Security. Water Treatment. Elevator. Front Desk Service. Children Play Ground. Security. Mosques Nearby. Swimming Pool. Church Nearby. Restaurants Nearby. ...,lekki,0,0,0,1,lekki4,2500000.0,3500000.0,3000000.0,1,39,7,2500000
1197, osapa osapa london lekki lagos,9,5,4,5,Brand new. This exclusive mansion comes with a room bq ... New. ...,lekki,0,0,0,1,lekki5,3500000.0,5000000.0,4000000.0,1,48,9,3500000
1198, northern foreshore chevron lekki lagos,9,5,4,5,A beautiful serviced fully detached 4bed with bq @ Northern Foreshore for lease Rent: 3.5m pa 24/hrs electricity 24/hrs security Serene and secured estate ... Serviced. Renovated. Drainage System. Security Doors. Pop Ceiling. Street Lights. Big Compound. Cctv Cameras. All Room Ensuit. Supermarket Nearby. Parking Space. 24 Hours Electricity. 24 Hours Security. Boys Quater. Water Treatment. Children Play Ground. Security. ...,lekki,0,0,0,1,lekki5,3500000.0,5000000.0,4000000.0,1,48,9,3500000
1199, off freedom way ikate lekki lagos,7,4,3,4,"Beautiful under a complete renovation 3bedroom flat at off freedom way, donate-Lekki, Lagos. Rent :#2m ... Renovated. Drainage System. Water Treatment. Security Doors. Security. Pop Ceiling. Big Compound. All Room Ensuit. Parking Space. 24 Hours Security. ...",lekki,0,0,0,0,lekki4,2500000.0,3500000.0,3000000.0,0,39,7,2000000
1200, off freedom way lekki phase 1 lekki lagos,9,5,4,5,"Beautiful newly renovated 4bedroom semi detached duplex at oladimeji alo, off freedom way, Lekki phase 1, Lekki , Lagos. Rent : #3,800,000 ... Dry. Renovated. Drainage System. Water Treatment. Security Doors. Security. Pop Ceiling. All Room Ensuit. Parking Space. 24 Hours Security. ...",lekki,0,0,0,1,lekki5,3500000.0,5000000.0,4000000.0,1,48,9,3800000
1201, alternative route chevron lekki lagos,11,6,5,6,"Newly built luxurious 5 bedroom semi-detached house with a room boy's quarters and a gate house at Chevron alternative Rent: #3,500,000 ... Dry. New. Drainage System. Boys Quater. Water Treatment. Security Doors. Security. Pop Ceiling. Big Compound. All Room Ensuit. Parking Space. ...",lekki,0,0,0,0,lekki6,5500000.0,6200000.0,6200000.0,0,54,10,4700000
1202, off freedom way ikate lekki lagos,5,3,2,3,FOR RENT Ikate Lagos 2 bedroom all rooms ensuite apartment Features: - All Rooms Ensuite - 24hrs Security -24 hrs Power - Big Compound - Generator - CCTV Cameras - Bathtub - Smoke Detectors - ... Serviced. New. Drainage System. Water Treatment. Security Doors. Security. Pop Ceiling. Street Lights. Big Compound. Cctv Cameras. All Room Ensuit. Parking Space. 24 Hours Electricity. 24 Hours Security. ...,lekki,0,0,0,1,lekki3,2000000.0,2500000.0,2500000.0,1,38,7,2000000
1203, vintage estate close to shoprite jakande lekki lagos,9,5,4,5,"Vintage estate 4 bedroom + a studio room, with 1 Bq ensuite. *Renting fee =4mill. *Service charge (monthly)=N38,300 *Light per killowat=N70 The Facilities Include Club House, GYM House, 24 Hours Security and Electricity, Centralized Sewage, Water Treatment, Street ... Serviced. New. Drainage System. Security Doors. Pop Ceiling. Street Lights. Big Compound. Cctv Cameras. All Room Ensuit. Supermarket Nearby. Parking Space. 24 Hours Electricity. 24 Hours Security. Gym. Boys Quater. Water Treatment. Security. Swimming Pool. Jacuzzi. ...",lekki,1,0,0,1,lekki5,3500000.0,5000000.0,4000000.0,2,48,9,4000000
1204, ikota lekki lagos,9,5,4,5,FEATURES: - All Bedrooms En suite with Water Heaters - Fully Fitted Kitchen with Cabinets - Marble Tiles - Wardrobes - P.O.P ceiling - Dining - Serene Environment - Ample Parking Space. ... New. Boys Quater. Water Treatment. Security Doors. Security. Pop Ceiling. Swimming Pool. Big Compound. All Room Ensuit. Parking Space. ...,lekki,0,0,0,1,lekki5,3500000.0,5000000.0,4000000.0,1,48,9,3500000
1205, osapa lekki phase 2 lekki lagos,11,6,5,6,"FEATURES: - All Bedrooms En suite with Water Heaters - Fully Fitted Kitchen with Cabinets - Marble Tiles - Wardrobes - P.O.P ceiling - Dining - Serene Environment, Ample Parking Space. ... New. Boys Quater. Water Treatment. Security Doors. Security. Pop Ceiling. Street Lights. Big Compound. Cctv Cameras. All Room Ensuit. Parking Space. ...",lekki,0,0,0,0,lekki6,5500000.0,6200000.0,6200000.0,0,54,10,5000000
1206, chevron lekki lagos,11,6,5,6,A nice 5 Bedroom Detached duplex which situates in a serene estate in Lekki. This building is well accessible with tarred roads and all amenities are in place to make your stay a comfortable experience. ... Cheap. Dry. Renovated. Drainage System. Boys Quater. Water Treatment. Security Doors. Security. Pop Ceiling. Big Compound. All Room Ensuit. Supermarket Nearby. Parking Space. 24 Hours Security. ...,lekki,0,0,0,0,lekki6,5500000.0,6200000.0,6200000.0,0,54,10,4700000
1207, agungi lekki lagos,2,1,1,1,Mini-Flat (upstairs) for Rent @ Lekki - Agungi Rent: NGN 900k Service Charge: 150k Agency: 10% Legal: 5% ... Security. ...,lekki,0,0,0,1,lekki1,800000.0,1300000.0,1169999.9999999988,1,21,4,900000
1208, .. osapa london lekki lagos,7,4,3,4,A Self Serviced 3 Bedroom Flat for Rent in Osapa with Features; -Well paved and secured compound -Located in a serene neighborhood -Good and accessible road network -All rooms ensuite -1 Room staff quarter -Ample parking space -Well illuminated and ventilated rooms -Borehole -Water treatment ... Dry. Boys Quater. Water Treatment. Security Doors. Security. Pop Ceiling. Big Compound. All Room Ensuit. Parking Space. ...,lekki,0,0,0,0,lekki4,2500000.0,3500000.0,3000000.0,0,39,7,2000000
1209, agungi agungi lekki lagos,5,3,2,3,Beautifully built serviced 2bed at Agungi @ 1.7m ground floor. Service charge 500k. Diesel is contributed ... Cheap. Serviced. Renovated. New. Drainage System. Water Treatment. Security Doors. Security. Pop Ceiling. Big Compound. All Room Ensuit. Parking Space. 24 Hours Security. ...,lekki,0,0,0,0,lekki3,2000000.0,2500000.0,2500000.0,0,38,7,1700000
1210, .. lekki phase 1 lekki lagos,11,6,5,6,A Executive Brand New 5 Bedroom Fully Detached Duplex is now available for Rent in Lekki Phase 1 with Features; -Well paved and secured compound -Located in a serene neighborhood -Good and accessible road network -All rooms ensuite -1 Room staff ... Dry. New. Gym. Boys Quater. Water Treatment. Security Doors. Security. Pop Ceiling. Swimming Pool. Big Compound. All Room Ensuit. Parking Space. ...,lekki,1,1,0,1,lekki6,5500000.0,6200000.0,6200000.0,3,54,10,6200000
1211, lekki phase 1 lekki lagos,7,4,3,4,A Self Service 3 Bedroom Semi Detached Duplex is now available for Rent in Lekki Phase 1 with Features; -Well paved and secured compound -Located in a serene environment -All rooms ensuite -Easily accessible good road network -1 Room staff quarter -Fitted ... Dry. Renovated. Boys Quater. Security Doors. Security. Pop Ceiling. Big Compound. All Room Ensuit. Parking Space. ...,lekki,1,1,1,1,lekki4,2500000.0,3500000.0,3000000.0,4,39,7,4300000
1212, chevy view chevron lekki lagos,11,6,5,6,Massive 5 bedroom plus a Room Bq. Gatted environment with good road network. This is a Home u will live to love! ... New. ...,lekki,0,0,0,0,lekki6,5500000.0,6200000.0,6200000.0,0,54,10,4700000
1213, chevron chevron lekki lagos,7,4,3,4,Luxury 3Bedroom apartment . fully serviced. ... Serviced. All Room Ensuit. 24 Hours Electricity. 24 Hours Security. ...,lekki,0,0,0,0,lekki4,2500000.0,3500000.0,3000000.0,0,39,7,2200000
1214, lekki phase 1 lekki lagos,9,5,4,5,A Commercial 4 Bedroom Fully Detached Duplex is now available for Rent in Lekki Phase 1 with Features; -Well paved and secured compound -Located in a serene neighborhood -Good and accessible road network -All rooms ensuite -1 Room staff quarter -Ample parking ... Dry. Renovated. Boys Quater. Water Treatment. Security Doors. Security. Pop Ceiling. Big Compound. All Room Ensuit. Parking Space. ...,lekki,1,1,1,1,lekki5,3500000.0,5000000.0,4000000.0,4,48,9,5600000
1215, osapa london lekki lagos,2,1,1,1,Spacious BQ Apartment (No kitchen) for rent @ Lekki - Osapa Rent: *NGN 600k* (negotiable) Service Charge: *NGN 15k* monthly Caution: 30k Agency: 10% Legal: 10% ... Boys Quater. ...,lekki,0,0,0,0,lekki1,800000.0,1300000.0,1169999.9999999988,0,21,4,600000
1216, - lekki phase 1 lekki lagos,7,4,3,4,Luxury 3 bedroom Apartment Â all rooms ensuite with a well fitted kitchen and a 1 bed room boys quarter. *POP finishing *Swimming pool *Water Treatment *Security Doors *Well Fitted kitchen and wardrobesÂ  *1 room boys ... ...,lekki,1,0,0,1,lekki4,2500000.0,3500000.0,3000000.0,2,39,7,3000000
1217, lekki phase 1 lekki lagos,9,5,4,5,A Luxury Serviced 4 Bedroom Terrace Duplex is now available for Rent in Lekki Phase 1 with Features; -Well paved and secured compound -Located in a serene neighborhood -Good and accessible road network -All rooms ensuite -1 Room staff quarter -Fitted AC -Swimming ... Serviced. Dry. Gym. Boys Quater. Water Treatment. Security Doors. Security. Pop Ceiling. Swimming Pool. Big Compound. All Room Ensuit. Parking Space. 24 Hours Security. ...,lekki,1,0,1,1,lekki5,3500000.0,5000000.0,4000000.0,3,48,9,4800000
1218," eleganza gardens, vgc lekki lagos",5,3,2,3,- New 2 bedroom flat under completion - the rooms are ensuit plus visitor's toilet - large living room - moderate kitchen - Ample parking space - fenced and gated compound - Service charge: 150k per year - Rent: 1.2m per year Note: 1. ... Serviced. New. Drainage System. Water Treatment. Security. Big Compound. All Room Ensuit. Parking Space. 24 Hours Security. ...,lekki,0,0,0,0,lekki3,2000000.0,2500000.0,2500000.0,0,38,7,1200000
1219, agungi lekki lagos,9,5,4,5,4-Bedroom Semi-Detached Duplex + BQ. @ Oba Amusa Rent: *NGN 3m* Caution: NGN 200k Agency: 10% Legal: 5% ... Water Treatment. Pop Ceiling. All Room Ensuit. ...,lekki,0,0,0,1,lekki5,3500000.0,5000000.0,4000000.0,1,48,9,3500000
1220, oral oral estate lekki lagos,5,3,2,3,Newly built apartment. Fittedvwith modern facilities. Am room ensuite. Service charge 700k. Available in 3Bedroom. ... Serviced. New. Big Compound. All Room Ensuit. 24 Hours Security. ...,lekki,0,0,0,0,lekki3,2000000.0,2500000.0,2500000.0,0,38,7,1700000
1221, osapa london lekki lagos,9,5,4,5,"Executive and Fabulous Four bedroom terrace duplex with a room bq Rent. 4m Agency. 10% Legal 5% Caution. 200k Service charge 30k monthly Contact us for more Luxurious options FOR FURTHER ENQUIRES, SPECIFIC REQUEST AND ARRANGEMENTS FOR PHYSICAL INSPECTIONS, ... Serviced. Dry. Street Lights. Big Compound. All Room Ensuit. 24 Hours Electricity. 24 Hours Security. ...",lekki,1,0,0,1,lekki5,3500000.0,5000000.0,4000000.0,2,48,9,4000000
1222, jakande lekki lagos,7,4,3,4,"3bedroom flat at jakande Rent. 2.8m Agency. 10% Legal. 5% Caution. 10%. Service charge. 200k Contact us for more luxury FOR FURTHER ENQUIRES, SPECIFIC REQUEST AND ARRANGEMENTS FOR PHYSICAL INSPECTIONS, KINDLY SEND US A SCREENSHOT OR THE LINK TO THIS APARTMENT INSPECTIONS ARE ... Serviced. Dry. Drainage System. Pop Ceiling. Street Lights. Big Compound. All Room Ensuit. Supermarket Nearby. Parking Space. 24 Hours Electricity. 24 Hours Security. Water Treatment. Children Play Ground. Security. Church Nearby. Restaurants Nearby. ...",lekki,0,0,0,1,lekki4,2500000.0,3500000.0,3000000.0,1,39,7,2800000
1223, .. ikota lekki lagos,5,3,2,3,A Self Service 2 Bedroom Flat is now available for Rent in Ikota with Features; -Well paved and secured compound -Located in a serene neighborhood -Good and accessible road network -All rooms ensuite -Open plan kitchen -Ample parking space -Well illuminated and ventilated ... Dry. Renovated. Water Treatment. Security Doors. Security. Pop Ceiling. Big Compound. All Room Ensuit. Parking Space. 24 Hours Security. ...,lekki,0,0,0,0,lekki3,2000000.0,2500000.0,2500000.0,0,38,7,1300000
1224, lekki phase 1 lekki lagos,9,5,4,5,Alone in the compound massive 4 bedroom semi-detached house with one room boys in an estate in Lekki Phase 1 Rent 5.5m Caution 250k Legal 5% Agency 10% *Features* All rooms ensuite 2 living rooms Study Laundry Shower Jacuzzi Security gate ... Dry. Renovated. Drainage System. Security Doors. Pop Ceiling. Street Lights. Big Compound. All Room Ensuit. Supermarket Nearby. Parking Space. 24 Hours Electricity. 24 Hours Security. Water Treatment. Survey. Children Play Ground. Security. Church Nearby. Jacuzzi. Restaurants Nearby. ...,lekki,1,1,1,1,lekki5,3500000.0,5000000.0,4000000.0,4,48,9,5500000
1225, - osapa london lekki lagos,7,4,3,4,Spacious 3-Bedroom Apartment For Rent @ Lekki - Osapa Rent: *NGN 2.5m* Service Charge: NGN 600k (Excluding Power) Caution: 200k (refundable) Agency: 10% Legal: 10% ... Renovated. Pop Ceiling. All Room Ensuit. ...,lekki,0,0,0,1,lekki4,2500000.0,3500000.0,3000000.0,1,39,7,2500000
1226, nicon town lekki lagos,11,6,5,6,"A Magnificent 5 Bedroom Fully Detached Duplex is now available for Rent in Nicon Town with Features; -Well paved, gated and secured compound -Located in a serene environment -All rooms en suite -2 Rooms staff quarter -Swimming pool -Fitted AC -Gas cooker -Electric oven -Microwave -Heat ... Dry. Renovated. Boys Quater. Water Treatment. Security Doors. Security. Pop Ceiling. Big Compound. All Room Ensuit. Jacuzzi. Parking Space. 24 Hours Security. ...",lekki,1,1,0,1,lekki6,5500000.0,6200000.0,6200000.0,3,54,10,6200000
1227, lekki phase 1 lekki lagos,15,8,7,8,A Lovely Brand New 7 Bedroom Fully Detached Duplex is now available for Rent in Lekki phase 1 with Features; -Well paved and secured compound -Located in a serene neighborhood -Good and accessible road network -All rooms ensuite -1 Room staff ... Dry. New. Boys Quater. Water Treatment. Security Doors. Security. Pop Ceiling. Swimming Pool. Big Compound. All Room Ensuit. Parking Space. ...,lekki,1,1,0,1,lekki8,7000000.0,7000000.0,7000000.0,3,59,10,7000000
1228, off admiralty way lekki phase 1 lekki lagos,7,4,3,4,"Luxury 3 bedroom all rooms ensuite apartment , finished to high luxury specificications with fitted kitchen, swimming pool and gym *Serviced house *General security *Cctv cameras *Modern Swimming Pool *Well equipped gym *Parking Space ... New. Drainage System. Security Doors. Child Care. Pop Ceiling. C Of O. Street Lights. Big Compound. Cctv Cameras. All Room Ensuit. Parking Space. 24 Hours Electricity. 24 Hours Security. Boys Quater. Water Treatment. Security. Swimming Pool. ...",lekki,1,1,1,1,lekki4,2500000.0,3500000.0,3000000.0,4,39,7,4000000
1229, maruwa lekki phase 1 lekki lagos,7,4,3,4,"Executive three (3) bedroom all en-suite apartment with a room service quarters to let in a nice environment . Location: Lekki phase 1, Lagos Rent: #2.8 million Service Charge: #200k Service generator Fitted kitchen Oven ... Serviced. Renovated. Drainage System. Boys Quater. Water Treatment. Security Doors. Security. Pop Ceiling. Street Lights. Big Compound. All Room Ensuit. Supermarket Nearby. Parking Space. 24 Hours Security. ...",lekki,0,0,0,1,lekki4,2500000.0,3500000.0,3000000.0,1,39,7,2800000
1230, off admiralty way lekki phase 1 lekki lagos,7,4,3,4,FOR RENT Lekki phase 1 Lagos 3 bedroom all rooms ensuite duplex (Town house) Features : - All Rooms Ensuite - 24hrs Security -Swimming pool - Boyâ€™s Quarter - Big Compound - CCTV Cameras - Bathtub ... Renovated. Drainage System. Security Doors. Pop Ceiling. Street Lights. Big Compound. Cctv Cameras. All Room Ensuit. Supermarket Nearby. Parking Space. 24 Hours Electricity. 24 Hours Security. Boys Quater. Water Treatment. Security. Swimming Pool. Restaurants Nearby. ...,lekki,1,0,0,1,lekki4,2500000.0,3500000.0,3000000.0,2,39,7,3300000
1231, pinnock estate osapa london lekki lagos,11,6,5,6,A Self Service 5 Bedroom Fully Detached Duplex is now available for Rent in Pinnock Estate with Features; -Well paved and secured compound -Located in a serene neighborhood -Good and accessible road network -All rooms ensuite -1 Room staff quarter -Ample parking ... Dry. New. Boys Quater. Water Treatment. Security Doors. Security. Pop Ceiling. Big Compound. All Room Ensuit. Parking Space. ...,lekki,0,0,0,1,lekki6,5500000.0,6200000.0,6200000.0,1,54,10,6000000
1232, norther foreshore lekki phase 1 lekki lagos,8,4,4,4,This property is located on the island in northen foreshore to be prices is comprises of 3 bedroom all en-suites with one room B.Q with 2bq in a serviced estate on 24/7 hours electricty in ... ...,lekki,1,1,1,1,lekki4,2500000.0,3500000.0,3000000.0,4,39,7,3500000
1233, osapa london lekki lagos,5,3,2,3,"Two bedroom flat available at osapa london. Rent 1.8m Service charge 335k Refundable caution fee 150k Agency 10% Legal 10% In this apartment you bring ur own generator A call to us will end your search immediately FOR FURTHER ENQUIRES, ... Dry. Big Compound. All Room Ensuit. ...",lekki,0,0,0,0,lekki3,2000000.0,2500000.0,2500000.0,0,38,7,1800000
1234, osapa london lekki lagos,7,4,3,4,"Well built 3bedroom service apartment with a bq for rent Location-osapa Rent:2.5 S/C:500k Caution:200 Legal:5% Agent:10% A call to us will end your search immediately FOR FURTHER ENQUIRES, SPECIFIC REQUEST AND ARRANGEMENTS FOR PHYSICAL INSPECTIONS, KINDLY SEND US A SCREENSHOT OR THE ... Serviced. Dry. Drainage System. Children Play Ground. Pop Ceiling. Big Compound. All Room Ensuit. Church Nearby. Parking Space. 24 Hours Electricity. 24 Hours Security. Restaurants Nearby. ...",lekki,0,0,0,1,lekki4,2500000.0,3500000.0,3000000.0,1,39,7,2500000
1235, ikota lekki lagos,7,4,3,4,"Exquisite 2&3 bedrooms apartment for rent. Rent for 2 beds ..1.3 Rent for 3 beds ..1.5m Agency fee -10% Agreement fee-10% Caution -100k Location-ikota villa A call to us will end your search immediately FOR FURTHER ENQUIRES, SPECIFIC REQUEST AND ARRANGEMENTS FOR ... Dry. Drainage System. Children Play Ground. Big Compound. All Room Ensuit. Church Nearby. ...",lekki,0,0,0,0,lekki4,2500000.0,3500000.0,3000000.0,0,39,7,2000000
1236, chevy view estate chevron lekki lagos,9,5,4,5,"Luxurious 4bedroom semi detached duplex to let, it can also be used for commercial Rent-4m Caution-200k Legal-5% Agent-10% Location-chevy view estate A call to us will end your search immediately FOR FURTHER ENQUIRES, SPECIFIC REQUEST AND ARRANGEMENTS FOR PHYSICAL INSPECTIONS, KINDLY ... Dry. Drainage System. Water Treatment. Children Play Ground. Security. Pop Ceiling. Street Lights. Big Compound. All Room Ensuit. Supermarket Nearby. Church Nearby. Parking Space. Restaurants Nearby. ...",lekki,1,0,0,1,lekki5,3500000.0,5000000.0,4000000.0,2,48,9,4000000
1237, osapa london lekki lagos,7,4,3,4,"Fabulous 3bedroom flat @ osapa london Rent. 2m Caution fee. 100k Legal 10% Agency. 10% A call to us will end your search immediately FOR FURTHER ENQUIRES, SPECIFIC REQUEST AND ARRANGEMENTS FOR PHYSICAL INSPECTIONS, KINDLY SEND US A SCREENSHOT OR ... Dry. Drainage System. Children Play Ground. Pop Ceiling. Big Compound. All Room Ensuit. Church Nearby. Restaurants Nearby. ...",lekki,0,0,0,0,lekki4,2500000.0,3500000.0,3000000.0,0,39,7,2000000
1238, lekki phase 1 lekki lagos,7,4,3,4,"Available for rent at the topmost floor. Magnificent 3bedroom flat Location. Lekki phase one Rent. 2.5m Agency. 10 Legal. 5% Service charge 35k monthly (24hrs) NOTE: In this building there's available Caracas, 3bedroom flat for 30m. Finished. 3bedroom flat is 37m All for sale!!! A call ... Serviced. Dry. Drainage System. Children Play Ground. Security. Street Lights. Big Compound. All Room Ensuit. Supermarket Nearby. Church Nearby. ...",lekki,0,0,0,1,lekki4,2500000.0,3500000.0,3000000.0,1,39,7,2500000
1239, chevron lekki lagos,7,4,3,4,"Well built 3bedroom semi-detached Terrence Duplex all ensuit Rent- 3m Caution-100k Legal- 10% Agency -10%. A call to us will definitely end your search for a house FOR FURTHER ENQUIRES, SPECIFIC REQUEST AND ARRANGEMENTS FOR PHYSICAL INSPECTIONS, ... Dry. Big Compound. All Room Ensuit. 24 Hours Electricity. 24 Hours Security. ...",lekki,1,0,0,1,lekki4,2500000.0,3500000.0,3000000.0,2,39,7,3000000
1240, ikota lekki lagos,7,4,3,4,"Exotic 3 Bedroom flat for Rent with BQ at Ikota Rent 2M Caution 250K Legal 10% Agency 10% Service Charge 900k A call to us will definitely end your search for a house FOR FURTHER ENQUIRES, SPECIFIC REQUEST AND ARRANGEMENTS ... Dry. Drainage System. Boys Quater. Children Play Ground. Big Compound. All Room Ensuit. Church Nearby. 24 Hours Electricity. 24 Hours Security. ...",lekki,0,0,0,0,lekki4,2500000.0,3500000.0,3000000.0,0,39,7,2000000
1241, chevron lekki lagos,7,4,3,4,"Luxurious 3bedroom Terrance duplex for rent Rent-2.5m Agency fee -10% Legal fee-5% Service charge-150k Location-chevy/chervon A call to us will definitely end your search for a house for further enquires, specific request and arrangements for physical inspections, kindly send us a ... Serviced. Dry. Drainage System. Children Play Ground. Big Compound. All Room Ensuit. Church Nearby. 24 Hours Electricity. 24 Hours Security. ...",lekki,0,0,0,1,lekki4,2500000.0,3500000.0,3000000.0,1,39,7,2500000
1242, lekki phase 1 lekki lagos,7,4,3,4,"Luxurious and massive 3 bedroom flat for rent at Lekki Phase 1 Rent 4.5m Agency 10% Legal 10% Caution fee and service charge applies. Contact us for more luxury options FOR FURTHER ENQUIRES, SPECIFIC REQUEST AND ARRANGEMENTS FOR PHYSICAL INSPECTIONS KINDLY ... Cheap. Serviced. Dry. Renovated. Drainage System. Water Treatment. Children Play Ground. Pop Ceiling. Street Lights. All Room Ensuit. Supermarket Nearby. Church Nearby. Parking Space. 24 Hours Electricity. 24 Hours Security. Restaurants Nearby. ...",lekki,1,1,1,1,lekki4,2500000.0,3500000.0,3000000.0,4,39,7,4300000
1243, lekki phase 1 lekki lagos,7,4,3,4,Serviced 3 bedroom flat at Lekki Phase 1 Rent 4m Caution 5% Legal 10% Agency 5% Service charge 900k Diesel deposit 600k you want more luxury options? then you're in the right place. contact us now for more available options FOR FURTHER ... Serviced. Dry. Renovated. Drainage System. Pop Ceiling. Street Lights. Big Compound. All Room Ensuit. Supermarket Nearby. Parking Space. 24 Hours Electricity. 24 Hours Security. Water Treatment. Children Play Ground. Security. Church Nearby. Restaurants Nearby. ...,lekki,1,1,1,1,lekki4,2500000.0,3500000.0,3000000.0,4,39,7,4000000
1244, lekki phase 1 lekki lagos,7,4,3,4,Rent 3.5m Agency 10% Legal 10% Caution 295k Service charge 1m Diesel deposit per consumption 300k Lekki phase 1 Just one call and the stress of getting a House is off your back A call to us and you'll get your ... Serviced. Dry. Drainage System. Pop Ceiling. Street Lights. Big Compound. All Room Ensuit. Supermarket Nearby. Parking Space. 24 Hours Electricity. 24 Hours Security. Water Treatment. Children Play Ground. Security. Church Nearby. Restaurants Nearby. ...,lekki,1,1,1,1,lekki4,2500000.0,3500000.0,3000000.0,4,39,7,3500000
1245, lekki phase 1 lekki lagos,7,4,3,4,A Lovely 3 Bedroom Terrace Duplex is now available for Rent in Lekki Phase 1 with Features; -Well paved and secured compound -Located in a serene environment -All rooms ensuite -Easily accessible good road network -1 Room staff quarter -Borehole -Water treatment plant -Well ... Dry. Boys Quater. Security Doors. Security. Pop Ceiling. Big Compound. All Room Ensuit. Parking Space. ...,lekki,1,1,1,1,lekki4,2500000.0,3500000.0,3000000.0,4,39,7,3500000
1246, oniru victoria island lagos,11,6,5,6,A Brand New 5 Bedroom Semi Detached Duplex is now available for Rent in Lekki Right hand side with Features; -Well paved and secured compound -Located in a serene neighborhood -Good and accessible road network -All rooms ensuite -2 Rooms staff ... Dry. New. Security Doors. Security. Pop Ceiling. Big Compound. All Room Ensuit. Parking Space. 24 Hours Security. ...,lekki,1,1,0,1,lekki6,5500000.0,6200000.0,6200000.0,3,54,10,6200000
1247, lekki phase 1 lekki lagos,7,4,3,4,A Serviced 3 Bedroom Terrace Duplex is now available for Rent in Lekki Phase 1 with Features; -Well paved and secured compound -Located in a serene environment -All rooms ensuite -1 Room staff quarter -Easily accessible good road network -Fitted AC -Borehole -Water treatment ... Serviced. Dry. Boys Quater. Water Treatment. Security Doors. Security. Pop Ceiling. Big Compound. All Room Ensuit. Parking Space. 24 Hours Security. ...,lekki,1,1,1,1,lekki4,2500000.0,3500000.0,3000000.0,4,39,7,3500000
1248, lekki phase 1 lekki lagos,12,6,6,6,A 5 bedroom detached house is available for let in Lekki phase 1 withÂ  Ample parking space Car port 2 rooms staff quarter Water treatment plant Security doors Rent N7m For enquires contact us on 08117340933 or 08090876670 ... Renovated. Boys Quater. Water Treatment. Security Doors. Security. Pop Ceiling. Street Lights. Big Compound. All Room Ensuit. Parking Space. 24 Hours Security. ...,lekki,1,1,0,1,lekki6,5500000.0,6200000.0,6200000.0,3,54,10,6200000
1249, .. lekki phase 1 lekki lagos,7,4,3,4,A Luxury 3 Bedroom Semi Detached Duplex is now available for Rent in Lekki Phase 1 with Features; -Well paved and secured compound -Located in a serene neighborhood -Good and accessible road network -All rooms ensuite -1 Room staff quarter -Fitted AC -Gas ... Dry. New. Boys Quater. Security Doors. Security. Pop Ceiling. Big Compound. All Room Ensuit. Parking Space. ...,lekki,1,1,1,1,lekki4,2500000.0,3500000.0,3000000.0,4,39,7,4000000
1250, lekki phase 1 lekki lagos,7,4,3,4,Serviced 3 Bedroom Flat For Rent @ Lekki Phase 1 Rental fee: NGN 2.5 m Service charge: NGN 600kÂ  Caution Fee: NGN 150kÂ  Agency: 10% Legal: 5% ... Serviced. Pop Ceiling. Mosques Nearby. Big Compound. All Room Ensuit. Church Nearby. 24 Hours Security. ...,lekki,0,0,0,1,lekki4,2500000.0,3500000.0,3000000.0,1,39,7,2500000
1251, chevron lekki lagos,2,1,1,1,"Exquisite 1 bedroom mini Flat Chervon 1bedroom flat Rent. 1.5m Agency. 10% Legal. 10% Caution. 5% Price :2m Legal 10% Agency 10% Caution 5% New Service charge 240k 24 /7 power light A call to us will end your search immediately FOR FURTHER ENQUIRES, ... Serviced. Dry. Drainage System. Pop Ceiling. Street Lights. Big Compound. All Room Ensuit. Supermarket Nearby. Parking Space. 24 Hours Electricity. 24 Hours Security. Water Treatment. Children Play Ground. Security. Church Nearby. Restaurants Nearby. ...",lekki,1,1,1,1,lekki1,800000.0,1300000.0,1169999.9999999988,4,21,4,1500000
1252, chevron lekki lagos,7,4,3,4,3 Bedroom Penthouse With Fitted AC For Rent @ Lekki - Chevron Rent: NGN 2.5m Caution Fee: NGN 200k Agency Fee: 10% Legal Fee: 5% ... Drainage System. Water Treatment. Security. Pop Ceiling. Parking Space. ...,lekki,0,0,0,1,lekki4,2500000.0,3500000.0,3000000.0,1,39,7,2500000
1253, richmond gate estate ikate lekki lagos,9,5,4,5,4 bedroom terrace duplex for rent Richmond Gate estate ikate meadow hall way.. Price :4.5m ... Serviced. Renovated. Furnished. New. Drainage System. Security Doors. Pop Ceiling. Street Lights. Big Compound. Cctv Cameras. All Room Ensuit. Supermarket Nearby. Parking Space. 24 Hours Electricity. 24 Hours Security. Boys Quater. Water Treatment. Ocean View. Children Play Ground. Security. Swimming Pool. ...,lekki,1,0,1,1,lekki5,3500000.0,5000000.0,4000000.0,3,48,9,4500000
1254, admiralty way lekki phase 1 lekki lagos,3,2,1,2,Luxury 1 bedroom apartment with a well fitted kitchen Generator Bore hole Water cooperation connection Cctv camera Automatic change over Concrete stamped floor Acrylic fitted kitchen Green area Water stantion Delineated visitors car park Security ... Serviced. Renovated. Drainage System. Water Treatment. Security Doors. Child Care. Security. Pop Ceiling. Street Lights. Big Compound. All Room Ensuit. Parking Space. 24 Hours Electricity. 24 Hours Security. ...,lekki,0,0,0,1,lekki2,1500000.0,2000000.0,1700000.0,1,34,6,1500000
1255, lekki phase 1 lekki lagos,11,6,5,6,A Nicely Built 5 Bedroom Semi Detached Duplex is now available for Rent in Lekki with Features; -Well paved and secured compound -Located in a serene environment -All rooms ensuite -1 Room staff quarter -Easily accessible good road network -Borehole -Water treatment ... Dry. Renovated. Boys Quater. Water Treatment. Security Doors. Pop Ceiling. Big Compound. All Room Ensuit. Parking Space. ...,lekki,0,0,0,1,lekki6,5500000.0,6200000.0,6200000.0,1,54,10,6000000
1256, off palace road ikate lekki lagos,6,3,3,3,"Well elevated 2bedroom flat service with good water and power in ikate, Lekki1 ... Cheap. Serviced. Dry. Renovated. Water Treatment. Security Doors. Security. Pop Ceiling. Big Compound. All Room Ensuit. Parking Space. 24 Hours Security. Restaurants Nearby. ...",lekki,0,0,0,1,lekki3,2000000.0,2500000.0,2500000.0,1,38,7,2000000
1257, lekki phase one lekki phase 1 lekki lagos,3,2,1,2,Well built and finished mini flat ... Renovated. 24 Hours Electricity. ...,lekki,0,0,0,1,lekki2,1500000.0,2000000.0,1700000.0,1,34,6,1500000
1258, idado idado lekki lagos,7,4,3,4,Serviced 3 bedroom apartment. Clean and decent compound. Gated Environment ... ...,lekki,0,0,0,0,lekki4,2500000.0,3500000.0,3000000.0,0,39,7,2000000
1259, osapa osapa london lekki lagos,5,3,2,3,Newly built luxury 2Bedroom. Swimming pool. Gym. Fully serviced. Service charge 700k. Power 1m ... Serviced. New. Gym. Swimming Pool. Big Compound. All Room Ensuit. 24 Hours Electricity. 24 Hours Security. ...,lekki,0,0,0,1,lekki3,2000000.0,2500000.0,2500000.0,1,38,7,2300000
1260," ologolo, ologolo lekki lagos",7,4,3,4,Spacious 3 bedroom flat for rent at Ologolo. Rent 1.9m ... Dry. Water Treatment. Pop Ceiling. Street Lights. All Room Ensuit. Supermarket Nearby. Parking Space. 24 Hours Security. ...,lekki,0,0,0,0,lekki4,2500000.0,3500000.0,3000000.0,0,39,7,2000000
1261, lekki phase 1 lekki lagos,11,6,5,6,A Lovely 5 Bedroom Terrace Duplex is now available for Rent in Lekki Phase 1 with Features; -Well paved and secured compound -Located in a serene environment -All rooms ensuite -1 Room staff quarter -Easily accessible good road network -Gas cooker -Heat expeller -Borehole -Water ... Dry. Water Treatment. Security. Pop Ceiling. Big Compound. All Room Ensuit. Parking Space. ...,lekki,0,0,0,1,lekki6,5500000.0,6200000.0,6200000.0,1,54,10,6000000
1262, ikota estate ikota lekki lagos,9,5,4,5,"Luxurious beautifully built 4 bedroom detached house at Ikota villa estate, ikota Rent #3,200,000 ... Cheap. Dry. New. Drainage System. Water Treatment. Security Doors. Security. Pop Ceiling. Street Lights. All Room Ensuit. Parking Space. 24 Hours Security. ...",lekki,0,0,0,1,lekki5,3500000.0,5000000.0,4000000.0,1,48,9,3500000
1263, .. ikota lekki lagos,10,5,5,5,"Newly built and well finished 4 bedroom terrace duplex at Ikota Villa Estate, Ikota , Lekki. Rent:#3M p.a Neg [redacted] ... Cheap. Furnished. New. Drainage System. Water Treatment. Security Doors. Pop Ceiling. Street Lights. All Room Ensuit. Jacuzzi. Parking Space. Fast Internet. 24 Hours Security. ...",lekki,0,0,0,1,lekki5,3500000.0,5000000.0,4000000.0,1,48,9,3500000
1264," golf, lakowe ibeju lekki lagos",5,3,2,3,"Beautifully built 2bedroom flat at golf, lakowe, ibeju-Lekki lagos. Rent #500,000 Caution #50,000 Agency #50,000 Legal #50,000 ... Dry. New. Water Treatment. Security Doors. Security. Pop Ceiling. Big Compound. All Room Ensuit. Parking Space. ...",lekki,0,0,0,0,lekki3,2000000.0,2500000.0,2500000.0,0,38,7,1000000
1265, spring bay estate ikate lekki lagos,7,4,3,4,Luxury 3 bedroom all rooms ensuite apartment with a bq *Serviced generator *Gas cooker and extractor *Bore hole *Water cooperation connection *Cctv camera *Water treatment *Automatic change over *Concrete stamped floor *Acrylic fitted kitchen *Fitted acâ€™s ... Serviced. New. Drainage System. Boys Quater. Water Treatment. Security Doors. Security. Pop Ceiling. Street Lights. Big Compound. All Room Ensuit. Parking Space. 24 Hours Electricity. 24 Hours Security. ...,lekki,1,1,1,1,lekki4,2500000.0,3500000.0,3000000.0,4,39,7,3500000
1266, off admiralty way lekki phase 1 lekki lagos,11,6,5,6,FOR RENT. Lekki Phase 1 Lagos 5 bedroom detached duplex with a room bq for rent Features: - All Rooms Ensuite - 24hrs Security - Room Boyâ€™s Quarter - Big Compound - Solar Panels - ... Furnished. New. Drainage System. Security Doors. Child Care. Pop Ceiling. Street Lights. Big Compound. Cctv Cameras. All Room Ensuit. Parking Space. 24 Hours Security. Boys Quater. Water Treatment. Security. Jacuzzi. ...,lekki,1,1,0,1,lekki6,5500000.0,6200000.0,6200000.0,3,54,10,6200000
1267, off adebayo dorothy lekki phase 1 lekki lagos,5,3,2,3,Exquisite newly built 2 bedroom all rooms ensuite apartment with a well fitted kitchen *Generator connection *Bore hole *Water treatment plant *Cctv camera *Automatic change over *Concrete stamped floor *Acrylic fitted kitchen *Ac piping *Green ... New. Drainage System. Security Doors. Pop Ceiling. Street Lights. Big Compound. Cctv Cameras. All Room Ensuit. Supermarket Nearby. Parking Space. 24 Hours Security. Water Treatment. Children Play Ground. Security. Jacuzzi. ...,lekki,1,1,0,1,lekki3,2000000.0,2500000.0,2500000.0,3,38,7,2500000
1268, off admiralty road lekki phase 1 lekki lagos,9,5,4,5,"4 Bedroom Terrace house Â with a well fitted kitchen for rent in Lekki phase 1. Spacious compound with well treated Â water, all the rooms-en suite,Â Large and well fitted Cabinet, Fully equipped Kitchen with Cooker, Smoke ... ...",lekki,1,1,1,1,lekki5,3500000.0,5000000.0,4000000.0,4,48,9,5600000
1269, off admiralty way lekki phase 1 lekki lagos,7,4,3,4,Tasteful 3 bedroom apartmemt all rooms ensuite with a well fitted kitchen and a boys quartersÂ  *POP finishing *Water Treatment *Security Doors *Well Fitted kitchen *self serviced *Resisdential area *Glass fitted showersÂ  PRICE:3.6 Million SERVICE CHARGE:427 thousand ... ...,lekki,1,1,1,1,lekki4,2500000.0,3500000.0,3000000.0,4,39,7,3600000
1270, . lekki phase 1 lekki lagos,7,4,3,4,A Tasteful 3 bedroom apartment Â with a well fitted kitchenÂ  *Self servicedÂ  *newly renovatedÂ  *Gated Compound *Ample Parking SpaceÂ  *well fitted kitchenÂ  *Secured area and gated area PRICE: 2 MillionÂ  SERVICE CHARGE:200 ThousandÂ  Caution deposit: ... ...,lekki,0,0,0,0,lekki4,2500000.0,3500000.0,3000000.0,0,39,7,2000000
1271, - lekki phase 1 lekki lagos,7,4,3,4,"LEKKI PHASE 1 A 3 bedroom flat for rentÂ Fully Serviced (24hrs electricity) and well maintained/renovated 3bed room Residential Apartment plus a room servant quarterÂ  Location: Admiralty Road, Lekki Phase 1, Lagos Amenities:Swimming Pool, Â 24/7 Electricity24/7 SecurityElectric fenceCctv cameraFitted ... ...",lekki,1,1,1,1,lekki4,2500000.0,3500000.0,3000000.0,4,39,7,4300000
1272, freedom way lekki phase 1 lekki lagos,5,3,2,3,"Newly built 3units of 2bed room flats Location: freedom way Lekki Phase 1 Rent for both 2bed room on the ground floor #1.6m net Refundable caution deposit 100k Legal fee 10%. Agency fee 10% Service Charge 300k (Service charge cover iSecurity, ... ...",lekki,0,0,0,0,lekki3,2000000.0,2500000.0,2500000.0,0,38,7,1600000
1273, behind tantalizer lekki phase 1 lekki lagos,9,5,4,5,"Luxurious 4 Bedroom semi detached all rooms ensuite houseÂ  Newly finished 4 bedroom semi detached house with all rooms en-suite: Italian Tiled floors, Fitted Kitchens, Shower Cubicles, Baths, ample parking space, Security Camera, ac's, Washing ... ...",lekki,1,1,1,1,lekki5,3500000.0,5000000.0,4000000.0,4,48,9,5600000
1274, ikota ikota lekki lagos,9,5,4,5,This 4 bedroom terrace comes with a room BQ. Service charge 500k. Fenced mini estate. ... Serviced. New. Boys Quater. All Room Ensuit. 24 Hours Electricity. 24 Hours Security. ...,lekki,0,0,0,1,lekki5,3500000.0,5000000.0,4000000.0,1,48,9,3500000
1275, agungi agungi lekki lagos,4,2,2,2,This is a newly built self service 2 Bedroom flat apartment with ample parking space. Rent: 1.7m Legal: 10% Agency: 10% Refundable Caution: 150k ... Dry. New. Drainage System. Water Treatment. Security Doors. Security. Pop Ceiling. Cctv Cameras. All Room Ensuit. Supermarket Nearby. Parking Space. 24 Hours Security. ...,lekki,1,0,0,1,lekki2,1500000.0,2000000.0,1700000.0,2,34,6,1800000
1276, eletu osapa london lekki lagos,9,5,4,5,"Beautifully built tastefully finished 4 bedroom semi-detached house with a room boy's quarter at Osapa London, Lekki, Lagos. Rent #3,200,000 ... Dry. Drainage System. Boys Quater. Water Treatment. Security Doors. Security. Pop Ceiling. Street Lights. Big Compound. All Room Ensuit. Supermarket Nearby. Parking Space. ...",lekki,0,0,0,1,lekki5,3500000.0,5000000.0,4000000.0,1,48,9,3500000
1277, bridge gate estate agungi lekki lagos,2,1,1,1,"Newly built portable 1bedroom apartment at bridge gate estate Agungi, Ajah, Lagos. Rent #850,000 ... New. Drainage System. Water Treatment. Security Doors. Security. Pop Ceiling. Big Compound. Parking Space. ...",lekki,0,0,0,1,lekki1,800000.0,1300000.0,1169999.9999999988,1,21,4,850000
1278, chevron lekki lagos,8,4,4,4,4 bedroom semi-detached with a BQ for rent at chevron Rent 3m Agency 10% Legal 10% Caution 200k ... All Room Ensuit. Parking Space. ...,lekki,1,0,0,1,lekki4,2500000.0,3500000.0,3000000.0,2,39,7,3000000
1279, chevron alternative chevron lekki lagos,10,5,5,5,Brandnew 5bedroom fully detached duplex with a BQ for rent. Rent-4m Agency fee -10% Agreement-5% Caution-200k Location-chervon alternative ... Boys Quater. Big Compound. All Room Ensuit. Parking Space. 24 Hours Electricity. 24 Hours Security. ...,lekki,1,0,0,1,lekki5,3500000.0,5000000.0,4000000.0,2,48,9,4000000
1280, oral estate lekki lagos,8,4,4,4,Newly built 4bedroom terrace duplex for rent. Iocation: Orchid/Lekki Price:3m Caution:150k Legal:5% Agent:10% ... New. All Room Ensuit. Parking Space. 24 Hours Electricity. ...,lekki,1,0,0,1,lekki4,2500000.0,3500000.0,3000000.0,2,39,7,3000000
1281, ikota villa ikota lekki lagos,8,4,4,4,Newly built 4 unit of 4bedroom semi n fully detached duplex with Bq. Rent-3.5/4m Agency-10% Agreement-10% Caution-200k Service charge-40k monthly. Location-ikota villa gra ... New. All Room Ensuit. Parking Space. 24 Hours Electricity. 24 Hours Security. ...,lekki,1,1,1,1,lekki4,2500000.0,3500000.0,3000000.0,4,39,7,4000000
1282, lekki phase 1 lekki lagos,8,4,4,4,"4 bedroom terrace for rent in Lekki phase 1 Rent 3m Agency 300k Legal 150k Caution 200k Service charge 360k Total N4,010,000 ... All Room Ensuit. Parking Space. 24 Hours Electricity. ...",lekki,1,0,0,1,lekki4,2500000.0,3500000.0,3000000.0,2,39,7,3000000
1283, chevron lekki lagos,7,3,4,3,Location- Chevy view 3bedroom semi-detached Terrence Duplex all ensuit Rent- 3m Caution-100k Legal- 10% Agency -10%. ... Renovated. Boys Quater. Big Compound. All Room Ensuit. Parking Space. 24 Hours Electricity. 24 Hours Security. ...,lekki,1,1,1,1,lekki3,2000000.0,2500000.0,2500000.0,4,38,7,3000000
1284, osapa london lekki lagos,11,6,5,6,FEATURES: - All Bedrooms En suite with Water Heaters - Fully Fitted Kitchen with Cabinets - Marble Tiles - Wardrobes - P.O.P ceiling - Dining - Serene Environment -Ample Parking Space. ... New. Boys Quater. Water Treatment. Security Doors. Security. Pop Ceiling. Street Lights. Big Compound. Cctv Cameras. All Room Ensuit. Jacuzzi. Parking Space. ...,lekki,0,0,0,0,lekki6,5500000.0,6200000.0,6200000.0,0,54,10,4700000
1285, off admiralty way lekki phase 1 lekki lagos,7,4,3,4,Location Lekki phase 1 Luxury 3 bedroom all rooms ensuite apartment *Generator house *Bore hole *Water cooperation connection *Cctv camera *Water treatment *Automatic change over *Concrete stamped floor *Acrylic fitted kitchen *Ac connection *Security *Water stantion ... Serviced. Renovated. Drainage System. Water Treatment. Security Doors. Security. Pop Ceiling. Street Lights. Big Compound. Cctv Cameras. All Room Ensuit. 24 Hours Security. ...,lekki,0,0,0,1,lekki4,2500000.0,3500000.0,3000000.0,1,39,7,2800000
1286, off admiralty way lekki phase 1 lekki lagos,5,3,2,3,FOR RENT Lekki phase 1 Lagos 2 bedroom all rooms ensuite apartment plus a guest toilet Features: - All Rooms Ensuite - 24hrs Security - Big Compound -Fire alarm - Generator - CCTV Cameras - ... Serviced. Renovated. Drainage System. Water Treatment. Security Doors. Security. Pop Ceiling. Street Lights. Big Compound. All Room Ensuit. Parking Space. 24 Hours Electricity. 24 Hours Security. ...,lekki,1,1,0,1,lekki3,2000000.0,2500000.0,2500000.0,3,38,7,2500000
1287, off admiralty way lekki phase 1 lekki lagos,5,3,2,3,FOR RENT Lekki phase 1 Lagos 2 bedroom all rooms ensuite apartment Features: - All Rooms Ensuite - 24hrs Security -24 hrs Power - Boyâ€™s Quarter - Big Compound -Gym - Generator - CCTV Cameras ... Serviced. Renovated. Furnished. New. Drainage System. Security Doors. Child Care. Pop Ceiling. Street Lights. Big Compound. Cctv Cameras. All Room Ensuit. Supermarket Nearby. Parking Space. 24 Hours Electricity. 24 Hours Security. Gym. Water Treatment. Children Play Ground. Security. Swimming Pool. ...,lekki,1,1,1,1,lekki3,2000000.0,2500000.0,2500000.0,4,38,7,3000000
1288, ikate estate ikate lekki lagos,5,3,2,3,FOR RENT Ikate Lagos 2 bedroom all rooms ensuite apartment Features: - All Rooms Ensuite - 24hrs Security -24 hrs Power - Big Compound - Generator - CCTV Cameras - Bathtub - Smoke Detectors - ... Serviced. New. Drainage System. Water Treatment. Security Doors. Security. Pop Ceiling. Street Lights. Big Compound. All Room Ensuit. Supermarket Nearby. Parking Space. 24 Hours Electricity. 24 Hours Security. ...,lekki,0,0,0,1,lekki3,2000000.0,2500000.0,2500000.0,1,38,7,2000000
1289, off admiralty way lekki phase 1 lekki lagos,5,3,2,3,FOR RENT Lekki phase 1 Lagos 2 bedroom all rooms ensuite apartment plus a guest toilet Features: - All Rooms Ensuite - 24hrs Security - Big Compound -Fire alarm - Generator space - CCTV ... Serviced. Renovated. Drainage System. Boys Quater. Water Treatment. Security Doors. Security. Pop Ceiling. Street Lights. Big Compound. All Room Ensuit. 24 Hours Security. ...,lekki,1,1,0,1,lekki3,2000000.0,2500000.0,2500000.0,3,38,7,2500000
1290, denco court ikate lekki lagos,9,5,4,5,4bedroom terrace with BQ Rent 3m Legal 150k Agency 300k Service 600k ... Serviced. New. Drainage System. Security Doors. Pop Ceiling. Street Lights. Big Compound. Cctv Cameras. All Room Ensuit. Supermarket Nearby. Parking Space. 24 Hours Security. Boys Quater. Water Treatment. Security. Mosques Nearby. Church Nearby. Jacuzzi. Restaurants Nearby. ...,lekki,0,0,0,1,lekki5,3500000.0,5000000.0,4000000.0,1,48,9,3500000
1291, alternative route chevron lekki lagos,11,6,5,6,"Beautifully built luxurious 5 bedroom fully detached house with a room boy's quarters and a gate house at Chevron alternative Rent #4,500,000 ... Dry. New. Drainage System. Boys Quater. Water Treatment. Security Doors. Security. Pop Ceiling. Big Compound. All Room Ensuit. Parking Space. ...",lekki,0,0,0,0,lekki6,5500000.0,6200000.0,6200000.0,0,54,10,4700000
1292, lekki phase 1 lekki lagos,6,3,3,3,Serviced 3 bedroom flat in at Lekki phase 1 Rent 2.5m Caution 100k Agency 10% Legal 5% Service charge 400k (Excluding Nepa and generator power respectively) Diesel deposit is contributed per supply by the tenants in the building ... Serviced. All Room Ensuit. Parking Space. ...,lekki,1,1,0,1,lekki3,2000000.0,2500000.0,2500000.0,3,38,7,2500000
1293, agungi lekki lagos,6,3,3,3,3bedroom flat to let Rent 1.8 Caution 120 S/C 160 Agent/legal 10% each Location: Agunji ... Big Compound. All Room Ensuit. Parking Space. 24 Hours Electricity. 24 Hours Security. ...,lekki,0,0,0,0,lekki3,2000000.0,2500000.0,2500000.0,0,38,7,1800000
1294, .. jakande lekki lagos,4,2,2,2,Luxurious 2bedroom flat Rent. 2m Agency. 10% Legal. 10% S.C 500k Caution. 150k ... Big Compound. All Room Ensuit. Parking Space. 24 Hours Electricity. 24 Hours Security. ...,lekki,1,1,1,1,lekki2,1500000.0,2000000.0,1700000.0,4,34,6,2000000
1295, lekki phase 1 lekki lagos,6,3,3,3, LOVELY 3BED ROOM FLAT AVAILABLE IN LEKKI PHASE 1 RENT 2.5M ASKING ... ...,lekki,1,1,0,1,lekki3,2000000.0,2500000.0,2500000.0,3,38,7,2500000
1296, lekki right lekki phase 1 lekki lagos,7,4,3,4,A 3 bedroom semi detached duplex is available for let at Lekki Right with a room staff quarter Rent N3.5M For enquiries contact us on 08117340933 or 08090876670 ... Renovated. Boys Quater. Water Treatment. Security Doors. Security. Big Compound. All Room Ensuit. ...,lekki,1,1,1,1,lekki4,2500000.0,3500000.0,3000000.0,4,39,7,3500000
1297, kajola eleranigbe ibeju lekki lagos,7,4,3,4,"Newly built, Close to the road Very spacious good power ... Dry. Furnished. New. Water Treatment. Security Doors. Security. Pop Ceiling. Street Lights. Big Compound. All Room Ensuit. Parking Space. 24 Hours Electricity. 24 Hours Security. ...",lekki,0,0,0,0,lekki4,2500000.0,3500000.0,3000000.0,0,39,7,2000000
1298, ikate ikate lekki lagos,7,4,3,4,Newly built. Modern design. Fitted kitchen. Wardrobe .terrace duplex with maid room . Lekki right. Serviced. ... Serviced. New. ...,lekki,1,1,1,1,lekki4,2500000.0,3500000.0,3000000.0,4,39,7,3800000
1299," milverton estate, lekki lekki lagos",6,3,3,3,"Luxrious and serviced 3-Bedrooms flat on ground floor at Milverton estate Lekki. (Fully Serviced estate, 24hr power) N2.5m net ... ...",lekki,1,1,0,1,lekki3,2000000.0,2500000.0,2500000.0,3,38,7,2500000
1300, chevy view chevron lekki lagos,7,4,3,4,Fully serviced. In a serviced estate. Purely residential. ... Serviced. Big Compound. All Room Ensuit. 24 Hours Security. ...,lekki,0,0,0,1,lekki4,2500000.0,3500000.0,3000000.0,1,39,7,2500000
1301, off freedom way ikate lekki lagos,5,3,2,3,FOR RENT Ikate Lagos 2 bedroom all rooms ensuite apartment Features: - All Rooms Ensuite - 24hrs Security -24 hrs Power - Boyâ€™s Quarter - Big Compound - Generator - CCTV Cameras - Bathtub - ... Serviced. New. Drainage System. Boys Quater. Water Treatment. Security Doors. Security. Pop Ceiling. Street Lights. Cctv Cameras. All Room Ensuit. 24 Hours Electricity. 24 Hours Security. ...,lekki,0,0,0,1,lekki3,2000000.0,2500000.0,2500000.0,1,38,7,2300000
1302, agungi agungi lekki lagos,5,3,2,3,Fully serviced. Fitted kitchen. Fitted AC. Fenced compound. Security. 24/7 power. This luxury 2bed comes with a room BQ! Service charge 650k ... Serviced. New. Boys Quater. Big Compound. All Room Ensuit. 24 Hours Electricity. 24 Hours Security. ...,lekki,0,0,0,1,lekki3,2000000.0,2500000.0,2500000.0,1,38,7,2300000
1303, ikota lekki lagos,9,5,4,5,"Exquisite 4 Bedroom Semi Detached Duplex Available At Ikota Rent 2.5m Legal 10% Agreement 10% Caution fee 150k Contact us for more Luxurious options FOR FURTHER ENQUIRES, SPECIFIC REQUEST AND ARRANGEMENTS FOR PHYSICAL INSPECTIONS, KINDLY SEND US A SCREENSHOT OR THE ... Dry. Drainage System. Pop Ceiling. Street Lights. Big Compound. All Room Ensuit. Supermarket Nearby. Parking Space. 24 Hours Electricity. 24 Hours Security. Water Treatment. Children Play Ground. Security. Church Nearby. Restaurants Nearby. ...",lekki,0,0,0,1,lekki5,3500000.0,5000000.0,4000000.0,1,48,9,3500000
1304, ikota lekki lagos,2,1,1,1,Massive Studio Apartment (With Kitchen) For Rent @ Lekki - Ikota Rent: *NGN 800k* Caution: NGN 50k Agency: 10% Legal: 10% ... ...,lekki,0,0,0,1,lekki1,800000.0,1300000.0,1169999.9999999988,1,21,4,800000
1305, osapa london lekki lagos,6,3,3,3,superclean spacious all round tiles pop all room ensuite fenced and gated interlocking service charge water heater and lots more ... Serviced. New. All Room Ensuit. 24 Hours Security. 24 Hours Electricity. Pop Ceiling. Water Treatment. Street Lights. Big Compound. Restaurants Nearby. Parking Space. Fast Internet. Supermarket Nearby. ...,lekki,0,0,0,0,lekki3,2000000.0,2500000.0,2500000.0,0,38,7,1700000
1306," orchid road,chevron tollgate chevron lekki lagos",2,1,1,1,"The room comes with Ac&it shared kitchen,for inspection pls call 08089633335/08168285322 ... Cheap. Serviced. 24 Hours Electricity. Water Treatment. Fast Internet. Pop Ceiling. 24 Hours Security. Security Doors. ...",lekki,0,0,0,0,lekki1,800000.0,1300000.0,1169999.9999999988,0,21,4,500000
1307, gbetu road awoyaya off lekki epe expressway ajah lagos,12,6,6,6,"?? ?? ?? ?? ?? ?? ?? ?? ?? ?? *DIRECT BRIEF* TO LET 5 bedroom American Standard duplex So Is Good For HOTEL, SERVICE APARTMENT SUCH AS NATIONAL YOUTH CORPS LODGE & ... Renovated. Children Play Ground. All Room Ensuit. Church Nearby. Big Compound. ...",lekki,0,0,0,0,lekki6,5500000.0,6200000.0,6200000.0,0,54,10,4700000
1308," tom ogboi street, itedo estate lekki phase 1 lekki lagos",3,2,1,2,ONE TENANT REQUIRED TO TAKE ALL UNITS IN THE COMPOUND!!!! There are 30 units of mini apartments in the compound : 24 Units of Room and Parlour and 6 units of studio apartments. Room and Parlour at ... Dry. New. Street Lights. Pop Ceiling. Security Doors. Water Treatment. All Room Ensuit. ...,lekki,0,0,0,1,lekki2,1500000.0,2000000.0,1700000.0,1,34,6,1600000
1309," muiz banire street opp imax cinema lekki phase 1, lekki lagos lekki phase 1 lekki lagos",7,4,3,4,"2 units of Luxury 3 Bedroom flats with a room boys quarter each. Features include: Indoor pool, fully equipped gymnasium,Club area, fitted kitchens, air conditioners, fire hose reel on each floor, sewage system( not the ... ...",lekki,1,1,1,1,lekki4,2500000.0,3500000.0,3000000.0,4,39,7,4300000
1310, elegushi lekki phase 1 lekki lagos,7,4,3,4,3 bedroom flat for rent at Elegushi Ikate for 2 million ... ...,lekki,0,0,0,0,lekki4,2500000.0,3500000.0,3000000.0,0,39,7,2000000
1311, elegushi ikate lekki lagos,7,4,3,4,3 bedroom flat for rent at Elegushi Ikate for 2 million ... ...,lekki,0,0,0,0,lekki4,2500000.0,3500000.0,3000000.0,0,39,7,2000000
1312, elegushi ikate lekki lagos,6,3,3,3,"3 bedroom flat at Ikate elegushi for 2 million, 3 bedroom flat plus room and parlour BQ. ... ...",lekki,0,0,0,1,lekki3,2000000.0,2500000.0,2500000.0,1,38,7,2000000
1313, lekki phase1 lekki phase 1 lekki lagos,9,5,4,5,4 bedroom Semi Detached Duplex House for rent Lekki Phase1 Lekki Phase 1 Lekki Lagos ... New. Water Treatment. ...,lekki,1,1,1,1,lekki5,3500000.0,5000000.0,4000000.0,4,48,9,5600000
1314, lekki phase 1 lekki phase 1 lekki lagos,9,5,4,5,"4 Bedroom town house, all room en-suite + 1 room BQ, spacious living room with family lounge, sizable room, equipped kitchen, standby generator @ Lekki phase 1 for rent @ #4m/annum; service charge= #600k/annum ... Furnished. New. Parking Space. Street Lights. Security Doors. All Room Ensuit. Pop Ceiling. Boys Quater. Restaurants Nearby. Big Compound. 24 Hours Electricity. Mosques Nearby. Church Nearby. Supermarket Nearby. Security. 24 Hours Security. ...",lekki,1,0,0,1,lekki5,3500000.0,5000000.0,4000000.0,2,48,9,4000000
1315, ... idado lekki lagos,7,4,3,4,For inspection pls call [redacted]/[redacted] ... Cheap. Renovated. Dry. Water Treatment. All Room Ensuit. 24 Hours Security. Pop Ceiling. Big Compound. ...,lekki,0,0,0,0,lekki4,2500000.0,3500000.0,3000000.0,0,39,7,2000000
1316, off alpha beach road igbo efon lekki lagos,11,6,5,6,For inspection pls call 08089633335/08168285322 ... Cheap. New. Water Treatment. Security. All Room Ensuit. 24 Hours Security. Pop Ceiling. Big Compound. ...,lekki,0,0,0,0,lekki6,5500000.0,6200000.0,6200000.0,0,54,10,4700000
1317, ilasan lekki lagos,7,4,3,4,For inspection pls call 08089633335/08168285322 ... Cheap. New. Water Treatment. All Room Ensuit. 24 Hours Security. Fast Internet. Pop Ceiling. ...,lekki,0,0,0,0,lekki4,2500000.0,3500000.0,3000000.0,0,39,7,2200000
1318, lekki phase1 lekki phase 1 lekki lagos,3,2,1,2,Â  Â  Â  Â  Â  Â  Â  Serviced Executive 1bedroom mini flats Apartment Â  Â  Â  Â  Â ****Corporate ppl only*** 1. Serviced Executive 1 bed apartmentÂ  @ Off road 12. Â  Â  R- 1.8M Â  Â  Net- 1.7M Â  Â  Utilitiles. ... New. ...,lekki,1,0,0,1,lekki2,1500000.0,2000000.0,1700000.0,2,34,6,1700000
1319, chevy view estate chevron lekki lagos,9,5,4,5,"For rent : 4bedroom semi detached duplex with a bq and security house Location: Chevy View Estate, Lekki Price: 3.5m Document: Governorâ€™s consent Features: -All room en-suite -Fully fitted kitchen -Stamp concrete floor -Inbuilt speakers -Smoke alarm -Jacuzzi -Water treatment plant -Washing machine - - ... New. ...",lekki,0,0,0,1,lekki5,3500000.0,5000000.0,4000000.0,1,48,9,3500000
1320, chevron lekki lagos,13,7,6,7,"Is a lovely duplex in a lovely area of the lovely estate ,for inspection pls call 08168285322/08089633335 ... Water Treatment. Street Lights. Security. Security Doors. Pop Ceiling. ...",lekki,0,0,0,0,lekki7,6000000.0,6800000.0,6529999.999999999,0,56,10,5500000
1321, gbangbala street ikate lekki lagos,7,4,3,4,For inspection pls call 08089633335/08168285322 ... Cheap. Renovated. Water Treatment. Supermarket Nearby. Security. Security Doors. Pop Ceiling. ...,lekki,0,0,0,1,lekki4,2500000.0,3500000.0,3000000.0,1,39,7,2500000
1322, lekki right lekki phase 1 lekki lagos,9,5,4,5,Brand new Self Serviced Terrace in a serene environment ... New. Parking Space. Printing Service. Street Lights. Security Doors. All Room Ensuit. Pop Ceiling. Boys Quater. Big Compound. Drainage System. Cctv Cameras. Water Treatment. Security. 24 Hours Security. ...,lekki,1,0,1,1,lekki5,3500000.0,5000000.0,4000000.0,3,48,9,4500000
1323, owode alpha beach igbo efon lekki lagos,3,2,1,2,Lovely spacious Newly built Mini flats available at Owode alpha beach. Prices from 700k and 800k rent. Pictures available on request ... Cheap. New. Children Play Ground. Parking Space. Street Lights. Security Doors. All Room Ensuit. Pop Ceiling. Big Compound. Drainage System. Child Care. Cctv Cameras. Ocean View. Water Treatment. Supermarket Nearby. Security. 24 Hours Security. ...,lekki,0,0,0,0,lekki2,1500000.0,2000000.0,1700000.0,0,34,6,900000
1324, road13 ikota lekki lagos,5,3,2,3,"The new one is going for 1.6,the one dt is not new is going for 1.5m,it has fitted kitchen &. Furnish with Ac,for inspection pls call 08089633335/08168285322 ... Serviced. Cheap. New. Parking Space. Water Treatment. All Room Ensuit. 24 Hours Security. Pop Ceiling. Big Compound. 24 Hours Electricity. ...",lekki,0,0,0,0,lekki3,2000000.0,2500000.0,2500000.0,0,38,7,1500000
1325, admiralty home estate igbo efon lekki lagos,11,6,5,6,"Is massive 4bed with spacious compound,sitting room&rooms,it has a Bq that can be rented out for 400k,for inspection pls call [redacted]/[redacted] ... Renovated. Water Treatment. Street Lights. Security. All Room Ensuit. 24 Hours Security. Fast Internet. Pop Ceiling. Boys Quater. Big Compound. ...",lekki,0,0,0,0,lekki6,5500000.0,6200000.0,6200000.0,0,54,10,4700000
1326, off chevron drive chevron lekki lagos,9,5,4,5,For inspection pls call [redacted]/[redacted] ... Serviced. Cheap. New. Water Treatment. All Room Ensuit. 24 Hours Security. Fast Internet. Pop Ceiling. ...,lekki,0,0,0,1,lekki5,3500000.0,5000000.0,4000000.0,1,48,9,3500000
1327, graceville court opposite ikate behind romay garden ilasan lekki lagos,2,1,1,1,Is a lovely Bq without kitchen@ilasan for inspection pls call 08168285322 ... Serviced. Cheap. New. Parking Space. Water Treatment. Security. Security Doors. Fast Internet. Pop Ceiling. Boys Quater. ...,lekki,0,0,0,0,lekki1,800000.0,1300000.0,1169999.9999999988,0,21,4,400000
1328, ikate ikate lekki lagos,9,5,4,5,Newly built luxurious and luxurious 4bedroom duplex with room bq ... New. ...,lekki,1,0,1,1,lekki5,3500000.0,5000000.0,4000000.0,3,48,9,4500000
1329, off freedom road lekki phase 1 lekki phase 1 lekki lagos,3,2,1,2,1 bedroom mini flat Mini flat Flat / Apartment for rent Off freedom road lekki phase 1 Lekki Phase 1 Lekki Lagos ... Cheap. Furnished. New. Jacuzzi. Survey. Water Treatment. Street Lights. Gym. Swimming Pool. Security. Security Doors. All Room Ensuit. 24 Hours Security. Big Compound. 24 Hours Electricity. ...,lekki,0,0,0,0,lekki2,1500000.0,2000000.0,1700000.0,0,34,6,900000
1330, spg ologolo lekki lagos,2,1,1,1,"Nice 2bedroom @Spg opposite agungi in a lovely environment, it has 1 toilet &bath for inspection pls call [redacted]/[redacted] ... Cheap. Renovated. Water Treatment. 24 Hours Security. Big Compound. ...",lekki,0,0,0,1,lekki1,800000.0,1300000.0,1169999.9999999988,1,21,4,1100000
1331, cluster one estate ikota lekki lagos,7,4,3,4,"For inspection pls call [redacted],[redacted] ... Cheap. Renovated. Mosques Nearby. All Room Ensuit. 24 Hours Security. Pop Ceiling. Big Compound. Free Wifi. ...",lekki,0,0,0,0,lekki4,2500000.0,3500000.0,3000000.0,0,39,7,2000000
1332, off fola osibo street lekki lekki lagos,2,1,1,1,1 bedroom mini flat Boys Quarters Flat / Apartment for rent Off fola osibo street Lekki Lekki Lagos ... Renovated. ...,lekki,1,1,1,1,lekki1,800000.0,1300000.0,1169999.9999999988,4,21,4,1300000
1333, atlantic view estate igbo efon lekki lagos,9,5,4,5,For inspection pls call 08089633335/08168285322 ... Renovated. Water Treatment. Street Lights. Supermarket Nearby. All Room Ensuit. 24 Hours Security. Fast Internet. Pop Ceiling. Big Compound. ...,lekki,0,0,0,1,lekki5,3500000.0,5000000.0,4000000.0,1,48,9,3500000
1334, osapa osapa london lekki lagos,9,5,4,5,It has mordern facilities and serviced ... New. C Of O. 24 Hours Security. 24 Hours Electricity. ...,lekki,1,1,1,1,lekki5,3500000.0,5000000.0,4000000.0,4,48,9,5600000
1335, providence street lekki phase 1 lekki lagos,2,1,1,1,1 bedroom mini flat Mini flat Flat / Apartment for rent Providence street Lekki Phase 1 Lekki Lagos ... Renovated. New. ...,lekki,1,1,1,1,lekki1,800000.0,1300000.0,1169999.9999999988,4,21,4,1300000
1336, ocean breeze estate ologolo lekki lagos,7,4,3,4,For inspection pls call 08089633335/08168285322 ... Cheap. New. Water Treatment. All Room Ensuit. 24 Hours Security. Fast Internet. Pop Ceiling. Boys Quater. ...,lekki,0,0,0,1,lekki4,2500000.0,3500000.0,3000000.0,1,39,7,2700000
1337, megamound ikota lekki lagos,7,4,3,4,For inspection pls call 08089633335/08168285322 ... Renovated. Water Treatment. All Room Ensuit. 24 Hours Security. Pop Ceiling. ...,lekki,0,0,0,1,lekki4,2500000.0,3500000.0,3000000.0,1,39,7,2500000
1338, off admiralty road lekki phase 1 lekki lagos,2,1,1,1,2 Nos of 1 Bedroom Flat off Admiralty Road Lekki ... ...,lekki,1,1,1,1,lekki1,800000.0,1300000.0,1169999.9999999988,4,21,4,1400000
1339, agungi lekki lagos,7,4,3,4,"Serviced charge is 300k,for inspection pls call 08089633335/08168285322 ... Renovated. All Room Ensuit. 24 Hours Security. Pop Ceiling. ...",lekki,0,0,0,0,lekki4,2500000.0,3500000.0,3000000.0,0,39,7,2000000
1340, lekki phase 1 lekki phase 1 lekki lagos,7,4,3,4,"FOR LEASE. *************************** 48units of luxury 3 bedroom flats. @ Babatunde Osoba crescents lekki PHASE 1. Fully Air-conditioned. Waterfront Over looking Banana ISLAND LAGOS, Fully serviced with 24hours power supply. Elevator, swimming pool outside Bar over looking ... New. Parking Space. Mosques Nearby. Church Nearby. Supermarket Nearby. Security Doors. All Room Ensuit. 24 Hours Security. Pop Ceiling. Restaurants Nearby. Big Compound. 24 Hours Electricity. ...",lekki,1,1,1,1,lekki4,2500000.0,3500000.0,3000000.0,4,39,7,4300000
1341, canal west estate osapa london lekki lagos,11,6,5,6,"The house is@Canal West Estate, very big,neat&spacious with a Bq,for inspection pls call 08089633335/08168285322 ... Cheap. Renovated. Cctv Cameras. Jacuzzi. Supermarket Nearby. Security. Security Doors. All Room Ensuit. Pop Ceiling. ...",lekki,0,0,0,0,lekki6,5500000.0,6200000.0,6200000.0,0,54,10,4700000
1342, lovely estate @chevron alternative chevron lekki lagos,9,5,4,5,For inspection pls call [redacted]/[redacted] ... Cheap. Dry. New. Water Treatment. All Room Ensuit. 24 Hours Security. Fast Internet. Pop Ceiling. Boys Quater. ...,lekki,0,0,0,1,lekki5,3500000.0,5000000.0,4000000.0,1,48,9,3500000
1343, leon garden chevron lekki lagos,9,5,4,5,For inspection pls call [redacted]/[redacted] ... Serviced. New. Water Treatment. All Room Ensuit. 24 Hours Security. Fast Internet. Pop Ceiling. 24 Hours Electricity. ...,lekki,0,0,0,1,lekki5,3500000.0,5000000.0,4000000.0,1,48,9,3500000
1344, off orchid road lekki ikota lekki lagos,2,1,1,1,1 bedroom mini flat Self Contain Flat / Apartment for rent Off Orchid road lekki Ikota Lekki Lagos ... Serviced. Renovated. Water Treatment. Street Lights. Security. Security Doors. ...,lekki,0,0,0,0,lekki1,800000.0,1300000.0,1169999.9999999988,0,21,4,400000
1345, elf lekki phase 1 lekki lagos,5,3,2,3,For inspection pls call [redacted]/[redacted] ... Cheap. Renovated. Supermarket Nearby. All Room Ensuit. 24 Hours Security. Fast Internet. Pop Ceiling. Big Compound. Drainage System. ...,lekki,0,0,0,1,lekki3,2000000.0,2500000.0,2500000.0,1,38,7,2200000
1346, off alpha beach road igbo efon lekki lagos,4,2,2,2,A 2 BEDROOM FLAT AT IGBO EFON OFF APLHA BEACH ROAD IN A SECURED AND FLOOR FREE ENVIRONMENT AT N800K RENTÂ  Â  Â  Â  Â  Â  Â  Â  Â  Â  Â  Â  Â  #800k LEGALÂ  Â  Â  ... ...,lekki,0,0,0,0,lekki2,1500000.0,2000000.0,1700000.0,0,34,6,900000
1347, lekki phase1 lekki phase 1 lekki lagos,9,5,4,5,TO LET LOCATION : Lekki phase 1 DESCRIPTION :Brandnew superbly finished 4 bedroom terrace duplex with a bq RENT: N6M SERVICE CHARGE : 1.3M - Features- â€¢ 2 living rooms â€¢ All rooms ensuite â€¢ Fitted kitchen â€¢ Ample parking â€¢ Cctv â€¢ 24hrs security â€¢ ... New. ...,lekki,1,1,1,1,lekki5,3500000.0,5000000.0,4000000.0,4,48,9,5600000
1348, off alpha beach road igbo efon lekki lagos,7,4,3,4,For inspection pls call [redacted]/[redacted] ... Cheap. Renovated. Water Treatment. Security. All Room Ensuit. 24 Hours Security. Fast Internet. Pop Ceiling. Big Compound. ...,lekki,0,0,0,0,lekki4,2500000.0,3500000.0,3000000.0,0,39,7,2000000
1349, westend estate ikota lekki lagos,7,4,3,4,It has modern equipment and serviced ... Serviced. Furnished. New. All Room Ensuit. 24 Hours Security. Boys Quater. Big Compound. 24 Hours Electricity. ...,lekki,0,0,0,0,lekki4,2500000.0,3500000.0,3000000.0,0,39,7,2000000
1350, maruwa lekki phase 1 lekki lagos,9,5,4,5,"The Bq can be rented for 500k,for inspection pls call 08089633335/08168285322 ... Serviced. Cheap. New. Water Treatment. All Room Ensuit. 24 Hours Security. Fast Internet. Pop Ceiling. Boys Quater. Big Compound. ...",lekki,0,0,0,1,lekki5,3500000.0,5000000.0,4000000.0,1,48,9,3800000
1351, chevron dirve chevron lekki lagos,9,5,4,5,Tastifully finished 4 bedroom terrace in Lekki Paradise Estate ( Lekki Gardens) on Chevron Drive Rent #2.8m Agency 10% ... Serviced. New. Parking Space. Security. Security Doors. All Room Ensuit. Pop Ceiling. ...,lekki,0,0,0,1,lekki5,3500000.0,5000000.0,4000000.0,1,48,9,3500000
1352, villa estate ikota lekki lagos,9,5,4,5,Brand new semi detached lovely built ... ...,lekki,0,0,0,1,lekki5,3500000.0,5000000.0,4000000.0,1,48,9,3500000
1353, pinnock beach estate lekki lagos,11,6,5,6,5bedroom semi detached duplex with bqew built luxurious ... New. ...,lekki,1,1,0,1,lekki6,5500000.0,6200000.0,6200000.0,3,54,10,6200000
1354, lekki county road ikota lekki lagos,9,5,4,5,For inspection pls call [redacted]/[redacted] ... Cheap. Renovated. Water Treatment. All Room Ensuit. 24 Hours Security. Pop Ceiling. Big Compound. ...,lekki,0,0,0,1,lekki5,3500000.0,5000000.0,4000000.0,1,48,9,3500000
1355, west end estate ikota lekki lagos,7,4,3,4,For inspection pls call [redacted]/[redacted] ... Cheap. Renovated. Water Treatment. All Room Ensuit. 24 Hours Security. Fast Internet. Pop Ceiling. Boys Quater. ...,lekki,0,0,0,0,lekki4,2500000.0,3500000.0,3000000.0,0,39,7,2000000
1356, agungi lekki lagos,7,4,3,4,Serviced 3BEDROOM FLAT RENT 1.7 LEGAL 170 AGENCY 170 SC 250 ... Serviced. Renovated. Parking Space. Water Treatment. Street Lights. All Room Ensuit. 24 Hours Security. Pop Ceiling. Big Compound. ...,lekki,0,0,0,0,lekki4,2500000.0,3500000.0,3000000.0,0,39,7,2000000
1357, orchid road chevron lekki lagos,9,5,4,5,For inspection pls call 08089633335/08168285322 ... Serviced. Dry. Old. New. Water Treatment. All Room Ensuit. 24 Hours Security. Fast Internet. Pop Ceiling. 24 Hours Electricity. ...,lekki,0,0,0,1,lekki5,3500000.0,5000000.0,4000000.0,1,48,9,3500000
1358, alexander court osapa london lekki lagos,7,4,3,4,For inspection pls call 08089633335/08168285322 ... Renovated. Water Treatment. Security. Pop Ceiling. ...,lekki,0,0,0,1,lekki4,2500000.0,3500000.0,3000000.0,1,39,7,2500000
1359, lekki phase1 lekki phase 1 lekki lagos,11,6,5,6,"5 BEDROOM DETACHED DUPLEX FOR SALE. Location: Lekki phase 1, Lagos Price: 150M Features: - All Rooms Ensuite - New - Fully Fitted Kitchen - CCTV Camera - Indoor Speakers - Water Heaters - 2 BQs - Jacuzzi - Carport * * * ... New. ...",lekki,1,1,0,1,lekki6,5500000.0,6200000.0,6200000.0,3,54,10,6200000
1360, safecourt estate badore ajah lagos,7,4,3,4,TO LET A 3BD WITH BQ AT SAFECOURT ESTATE IKATE LEKKI NEXT TO SPAR.... FEATURES INCLUDE ALL ROOMS ENSUITE FITTED KITCHEN GUEST TOILET BALCONY LARGE LIVING AREA SPACE LARGE KITCHEN & BEDROOMS SWIMMING POOL GYM FACILITY MANAGEMENT OFFICE AMPLE PARKING SPACE WATER TREATMENT PLANT 24/7 SECURITY 24/7 POWER DEDICATED ELEVATOR ESTATE ... Serviced. Children Play Ground. Parking Space. Elevator. Swimming Pool. Supermarket Nearby. Security. Security Doors. All Room Ensuit. 24 Hours Security. Pop Ceiling. Big Compound. Drainage System. ...,lekki,1,0,0,1,lekki4,2500000.0,3500000.0,3000000.0,2,39,7,3000000
1361, maruwa lekki phase 1 lekki lagos,7,4,3,4,For inspection pls call 08089633335/08168285322 ... ...,lekki,0,0,0,0,lekki4,2500000.0,3500000.0,3000000.0,0,39,7,2200000
1362, lekki phase 1 lekki lagos,9,5,4,5,Newly built 4 bedroom Semi Detached duplex for rent Located in a serene neighbourhood in Lekki Phase 1 Lagos Price is 6 million Comes with the following features Large rooms All rooms ensuite Fully fitted kitchen Walk in closets Jacuzzi Home automation A ... ...,lekki,1,1,1,1,lekki5,3500000.0,5000000.0,4000000.0,4,48,9,5600000
1363, oba amunsa estate agungi lekki lagos,12,6,6,6,For inspection pls call 08089633335/08168285322 ... New. Jacuzzi. Water Treatment. All Room Ensuit. 24 Hours Security. Fast Internet. Pop Ceiling. Boys Quater. Big Compound. ...,lekki,0,0,0,0,lekki6,5500000.0,6200000.0,6200000.0,0,54,10,4700000
1364, chevy view chevron lekki lagos,7,4,3,4,For inspection pls call [redacted]/[redacted] ... Cheap. Renovated. Water Treatment. All Room Ensuit. 24 Hours Security. Fast Internet. Pop Ceiling. ...,lekki,0,0,0,0,lekki4,2500000.0,3500000.0,3000000.0,0,39,7,2000000
1365, allan balogun estate. agungi lekki lagos,2,1,1,1,1 bedroom mini flat Shared Apartment Flat / Apartment for rent Allan balogun ESTATE. Agungi Lekki Lagos ... Renovated. ...,lekki,0,0,0,0,lekki1,800000.0,1300000.0,1169999.9999999988,0,21,4,550000
1366, ikate lekki lagos,5,3,2,3,Rent 2m Service charge 500k ... New. Water Treatment. All Room Ensuit. 24 Hours Security. Big Compound. ...,lekki,0,0,0,1,lekki3,2000000.0,2500000.0,2500000.0,1,38,7,2000000
1367," peninsula estate, orchid chevron lekki lagos",12,7,5,7,It has mordern facilities and serviced ... New. C Of O. 24 Hours Security. Pop Ceiling. 24 Hours Electricity. ...,lekki,1,1,0,1,lekki7,6000000.0,6800000.0,6529999.999999999,3,56,10,6800000
1368, ocean breeze estate ologolo lekki lagos,9,5,4,5,For inspection pls call [redacted]/[redacted] ... Cheap. Renovated. Water Treatment. All Room Ensuit. 24 Hours Security. Fast Internet. Pop Ceiling. Boys Quater. Big Compound. ...,lekki,0,0,0,1,lekki5,3500000.0,5000000.0,4000000.0,1,48,9,3500000
1369, oral estate chevron lekki lagos,2,1,1,1,"It has a service charge of 150k,for inspection pls call 08089633335/08168285322 ... Serviced. Cheap. Renovated. Water Treatment. 24 Hours Security. Fast Internet. Boys Quater. Big Compound. ...",lekki,0,0,0,0,lekki1,800000.0,1300000.0,1169999.9999999988,0,21,4,400000
1370, off fola osibo lekki phase 1 lekki lagos,7,4,3,4,FOR RENT Feature: +Fitted Kitchen +Fitted AC +All rooms en-suite Suitable for office use or residential purposes ... ...,lekki,1,1,1,1,lekki4,2500000.0,3500000.0,3000000.0,4,39,7,4300000
1371, bera estate chevron lekki lagos,9,5,4,5,Beautiful newly 4units of 4bedroom semi detached duplex with bq Rent 4million ... Serviced. New. Parking Space. Water Treatment. All Room Ensuit. 24 Hours Security. Pop Ceiling. Boys Quater. Big Compound. ...,lekki,1,0,0,1,lekki5,3500000.0,5000000.0,4000000.0,2,48,9,4000000
1372, eleganzer garden vgc lekki lagos,11,6,5,6,For inspection pls call 08089633335/08168285322 ... ...,lekki,0,0,0,0,lekki6,5500000.0,6200000.0,6200000.0,0,54,10,4700000
1373," orchid road, 2nd toll gate, lekki, lagos lekki phase 2 lekki lagos",9,5,4,5,">>Letting<< 4 bedroom fully serviced semi detached duplex with a Bq Amenities: >24hrs power, >Fitted Kitchen, >Tight security with CCTV, >Excellent drainage, >Good road network, >Parking space (for at least 3cars), >Swimming pool, >Kids play area (football field), >Gym, >Lounge Etc. Location: 2nd Toll Gate, Lekki, ... Serviced. New. Children Play Ground. Parking Space. Street Lights. Security Doors. All Room Ensuit. Pop Ceiling. Restaurants Nearby. Drainage System. 24 Hours Electricity. Cctv Cameras. Water Treatment. Swimming Pool. Supermarket Nearby. Security. 24 Hours Security. ...",lekki,1,0,0,1,lekki5,3500000.0,5000000.0,4000000.0,2,48,9,4000000
1374, gated community ikate lekki lagos,11,6,5,6,A tastefully built brand new 5 bedroom fully detached house for rent Location- Ikate Lekki Lagos Price- N5.5million Features- â€¢ All rooms en-suite â€¢ 2living rooms â€¢ 1room bq â€¢ Box room â€¢ Fitted kitchen â€¢ Ample parking â€¢ theater room â€¢ Walk- in ... New. All Room Ensuit. 24 Hours Security. Boys Quater. Big Compound. ...,lekki,0,0,0,1,lekki6,5500000.0,6200000.0,6200000.0,1,54,10,5500000
1375, gated community ikate lekki lagos,11,6,5,6,A tastefully built brand new 5 bedroom fully detached house for rent Location- Ikate Lekki Lagos Price- N6million Features- â€¢ All rooms en-suite â€¢ 2living rooms â€¢ 1room bq â€¢ Box room â€¢ Fitted kitchen â€¢ Ample parking â€¢ theater room â€¢ Walk- ... New. ...,lekki,0,0,0,1,lekki6,5500000.0,6200000.0,6200000.0,1,54,10,6000000
1376, ologolo lekki lagos,11,6,5,6,"For Rent Newly built 5 bedroom fully detached duplex (all en-suite) Stylish And Tastefully Finished Offering An Exquisite, Spacious And Bright Interior Combining Beautiful Period Features With Stunning Contemporary, 2 balconies, 2 living rooms, a ... Cheap. New. Cctv Cameras. Parking Space. Water Treatment. Street Lights. Supermarket Nearby. Security Doors. All Room Ensuit. 24 Hours Security. Governor's Consent. Restaurants Nearby. Big Compound. Drainage System. ...",lekki,1,1,0,1,lekki6,5500000.0,6200000.0,6200000.0,3,54,10,6200000
1377, lekki county road ikota lekki lagos,9,5,4,5,For inspection pls call 08089633335/08168285322 ... Cheap. Renovated. Excision. Water Treatment. Supermarket Nearby. All Room Ensuit. 24 Hours Security. Fast Internet. Pop Ceiling. ...,lekki,0,0,0,1,lekki5,3500000.0,5000000.0,4000000.0,1,48,9,3500000
1378, megamound ikota lekki lagos,9,5,4,5,"The Semi Detached Duplex is well built to taste ,it has a Bq self-contained that can be rented for 500k for inspection pls call 08089633335/08168285322 ... Renovated. New. Water Treatment. All Room Ensuit. 24 Hours Security. Fast Internet. Pop Ceiling. ...",lekki,0,0,0,1,lekki5,3500000.0,5000000.0,4000000.0,1,48,9,3500000
1379, off road 14 lekki phase 1 lekki lagos,12,7,5,7,Nicely built 5 bedroom detached house located in Lekki phase 1. . . Features: Easily accessible Nicely finished Fitted with ACs Water treatment plant Spacious parking space . . Rent price: 10 million per year . . ... ...,lekki,1,1,0,1,lekki7,6000000.0,6800000.0,6529999.999999999,3,56,10,6800000
1380, - ilasan lekki lagos,7,4,3,4,For inspection pls call [redacted]/[redacted] ... New. Water Treatment. All Room Ensuit. 24 Hours Security. Fast Internet. Pop Ceiling. Big Compound. ...,lekki,0,0,0,0,lekki4,2500000.0,3500000.0,3000000.0,0,39,7,2000000
1381, bera estate chevron lekki lagos,9,5,4,5,Direct brief. For rent: Newly built 4 bedroom semi detached duplex with Bq. Located at Bera estate lekki. Price: N4m per annum. 2yrs 3.5m For more information ... New. ...,lekki,0,0,0,1,lekki5,3500000.0,5000000.0,4000000.0,1,48,9,3500000
1382, lekki scheme 2 ogombo ajah lagos,9,5,4,5,"4 Nos. Of 4 Bedroom semi detached house With A Room Servant Quarters Road 12, Lekki Scheme 2 Ogombo Ajah Lagos? 2,000,000 / year ... Parking Space. Water Treatment. Security. Security Doors. All Room Ensuit. 24 Hours Security. Pop Ceiling. Boys Quater. Big Compound. ...",lekki,0,0,0,1,lekki5,3500000.0,5000000.0,4000000.0,1,48,9,3500000
1383, road 14 lekki phase 1 lekki lagos,11,6,5,6,5 bedroom Detached Duplex House for rent Road 14 Lekki Phase 1 Lekki Lagos ... ...,lekki,1,1,0,1,lekki6,5500000.0,6200000.0,6200000.0,3,54,10,6200000
1384, eleganzer garden vgc lekki lagos,11,6,5,6,"For inspection pls call ,08089633335/08168285322 ... ...",lekki,0,0,0,0,lekki6,5500000.0,6200000.0,6200000.0,0,54,10,4700000
1385, atlantic view estate igbo efon lekki lagos,2,1,1,1,Self serviced Self contained with a very spacious room with kitchen in a very secured estate Total Package 500k ... Cheap. ...,lekki,0,0,0,0,lekki1,800000.0,1300000.0,1169999.9999999988,0,21,4,400000
1386, chief collins street. lekki phase 1 lekki lagos,2,1,1,1,1 bedroom mini flat Self Contain Flat / Apartment for rent Chief Collins street. Lekki Phase 1 Lekki Lagos ... Renovated. ...,lekki,0,0,0,1,lekki1,800000.0,1300000.0,1169999.9999999988,1,21,4,800000
1387, awkulu street off providence street lekki phase 1 lekki phase 1 lekki lagos,3,2,1,2,1 bedroom mini flat Mini flat Flat / Apartment for rent Awkulu street off Providence street lekki phase 1 Lekki Phase 1 Lekki Lagos ... Renovated. ...,lekki,0,0,0,0,lekki2,1500000.0,2000000.0,1700000.0,0,34,6,1100000
1388, ikate lekki lagos,9,5,4,5,"NEW LISTINGS!!! â€¢ â€¢ Detail: 4 bedroom terrace duplex for rent Location: Ikate, Lekki Price: 3M/p.a â€¢ â€¢ Features: - New - All Rooms Ensuite - interlocked Floor - Fitted Kitchen - Pop Ceiling - Clean water - Walk-in Shower - Water Heater -Fully serviced â€¢â€¢â€¢â€¢â€¢â€¢â€¢â€¢â€¢â€¢â€¢â€¢â€¢â€¢â€¢â€¢â€¢â€¢â€¢â€¢â€¢â€¢â€¢â€¢â€¢â€¢â€¢â€¢â€¢â€¢â€¢â€¢â€¢â€¢â€¢â€¢â€¢â€¢â€¢â€¢â€¢â€¢ For enquiries: ... New. ...",lekki,0,0,0,1,lekki5,3500000.0,5000000.0,4000000.0,1,48,9,3500000
1389, oba amunsan estate idado lekki lagos,11,6,5,6,For inspection pls call 08089633335/08168285322 ... Cheap. Renovated. Water Treatment. All Room Ensuit. 24 Hours Security. Fast Internet. Pop Ceiling. Boys Quater. ...,lekki,0,0,0,0,lekki6,5500000.0,6200000.0,6200000.0,0,54,10,4700000
1390, osapa london osapa london lekki lagos,3,2,1,2,For inspection pls call [redacted]/[redacted] ... Cheap. Renovated. Water Treatment. All Room Ensuit. 24 Hours Security. Fast Internet. Pop Ceiling. ...,lekki,0,0,0,0,lekki2,1500000.0,2000000.0,1700000.0,0,34,6,1000000
1391, - ilasan lekki lagos,9,5,4,5,For inpection pls call [redacted]/[redacted] ... Cheap. New. Water Treatment. All Room Ensuit. 24 Hours Security. Fast Internet. Boys Quater. Big Compound. ...,lekki,0,0,0,1,lekki5,3500000.0,5000000.0,4000000.0,1,48,9,3500000
1392, gated estate @ologolo ologolo lekki lagos,9,5,4,5,For inspection old call 08168285322/08089633335 ... Cheap. New. Mosques Nearby. All Room Ensuit. 24 Hours Security. Pop Ceiling. Boys Quater. Big Compound. 24 Hours Electricity. ...,lekki,0,0,0,1,lekki5,3500000.0,5000000.0,4000000.0,1,48,9,3500000
1393, road16 ikota lekki lagos,3,2,1,2,Selfcon in a serene estate Rent 700 Legal 70 Agency 70 Caution 50 ... Renovated. Parking Space. Water Treatment. Street Lights. Security. Security Doors. All Room Ensuit. 24 Hours Security. Pop Ceiling. Big Compound. ...,lekki,0,0,0,0,lekki2,1500000.0,2000000.0,1700000.0,0,34,6,900000
1394, ikota villa ikota lekki lagos,9,5,4,5,"NEW LISTING!!! â€¢ â€¢ Detail: 4 bedroom semi detached duplex for rent Location: Ikota Villa, Lekki Price: 3.5M/p.a â€¢ â€¢ Features: - New - All Rooms Ensuite - Stamp Concrete Floor - Fitted Kitchen - Pop Ceiling - Clean water - Shower - Water Heater - Self Serviced - Jacuzzi â€¢â€¢â€¢â€¢â€¢â€¢â€¢â€¢â€¢â€¢â€¢â€¢â€¢â€¢â€¢â€¢â€¢â€¢â€¢â€¢â€¢â€¢â€¢â€¢â€¢â€¢â€¢â€¢â€¢â€¢â€¢â€¢â€¢â€¢â€¢â€¢â€¢â€¢â€¢â€¢â€¢â€¢ For enquiries: ... New. Water Treatment. ...",lekki,0,0,0,1,lekki5,3500000.0,5000000.0,4000000.0,1,48,9,3500000
1395, megamound ikota lekki lagos,11,6,5,6,For inspection pls call 08089633335/08168285322 ... Cheap. New. Water Treatment. All Room Ensuit. 24 Hours Security. Fast Internet. Big Compound. ...,lekki,0,0,0,0,lekki6,5500000.0,6200000.0,6200000.0,0,54,10,4700000
1396, ikate ikate lekki lagos,7,4,3,4,">>Letting<< 3 bedroom apartment with a room bq fully serviced with 24hrs power and elevator Rent:N3.5m Service charge: N1m (excluding electricity and diesel) Caution fee N292k Agency 10% Legal 5% Diesel deposit, minimum of N300k ... Serviced. New. Parking Space. Water Treatment. Elevator. Supermarket Nearby. All Room Ensuit. 24 Hours Security. Pop Ceiling. Big Compound. 24 Hours Electricity. ...",lekki,1,1,1,1,lekki4,2500000.0,3500000.0,3000000.0,4,39,7,3500000
1397," napier garden estate, beside manor garden, ikota, lekki, lagos ikota lekki lagos",9,5,4,5,"NAPIER GARDENS ESTATE IS A WELL SECURED ESTATE WITH 24 HOURS POWER SUPPLY, FULLY SERVICED AND A SERENE ENVIRONMENT ... Serviced. Cheap. Children Play Ground. Parking Space. Street Lights. Security Doors. All Room Ensuit. Pop Ceiling. Boys Quater. Restaurants Nearby. Drainage System. 24 Hours Electricity. Water Treatment. Supermarket Nearby. Security. 24 Hours Security. ...",lekki,0,0,0,1,lekki5,3500000.0,5000000.0,4000000.0,1,48,9,3800000
1398, kensular ikate lekki lagos,9,5,4,5,"The Bq of the flat can be rented for a minimum of 400k,it has a serviced charge of 500k,for inspection pls call 08089633335/08168285322 ... Cheap. Renovated. Elevator. All Room Ensuit. 24 Hours Security. Pop Ceiling. Big Compound. ...",lekki,0,0,0,1,lekki5,3500000.0,5000000.0,4000000.0,1,48,9,3500000
1399, osapa london osapa london lekki lagos,9,5,4,5,NEW LISTING!!! â€¢ â€¢ Detail: 4 bedroom semi detached duplex for rent Location: osapa London Lekki Price: 4m p.a â€¢ â€¢ Features: - New - All Rooms Ensuite - Stamp Concrete Floor - Fitted Kitchen - Pop Ceiling - Clean water - Shower - Water Heater - Self-Serviced â€¢â€¢â€¢â€¢â€¢â€¢â€¢â€¢â€¢â€¢â€¢â€¢â€¢â€¢â€¢â€¢â€¢â€¢â€¢â€¢â€¢â€¢â€¢â€¢â€¢â€¢â€¢â€¢â€¢â€¢â€¢â€¢â€¢â€¢â€¢â€¢â€¢â€¢â€¢â€¢â€¢â€¢ For enquiries: ... New. ...,lekki,1,0,0,1,lekki5,3500000.0,5000000.0,4000000.0,2,48,9,4000000
1400," lafiaji, lekki lagos",9,5,4,5,FOR RENT ____ FEATURES: +Fully fitted large kitchen +Intercom +Central Speakers +CCTV +DSTV Connection +Large Parking space ... ...,lekki,0,0,0,1,lekki5,3500000.0,5000000.0,4000000.0,1,48,9,3800000
1401, oral estate chevron lekki lagos,7,4,3,4,For inspection pls call [redacted]/[redacted] ... Cheap. Dry. New. Water Treatment. All Room Ensuit. 24 Hours Security. Fast Internet. Pop Ceiling. Boys Quater. Big Compound. ...,lekki,0,0,0,0,lekki4,2500000.0,3500000.0,3000000.0,0,39,7,2000000
1402, chevron axis lekki lagos,7,4,3,4,"_____ ONLY FOR SALE| _____ 3BEDROOMS | 3BATHROOMS | 4 TOILETS| PROPERTY TYPE: BLOCKS OF FLAT |PRICE: N2,200,000|N2.2M LOCATION: CHEVRON AXIS,LEKKI,LAGOS ???â€¢ _____ ___ The home features Large KITCHEN with partly fitted appliances,Intercom,large parking space,Fire alarm,Central Speaker,and rooms with grand scale proportions. ____ This simplex Property is ... ...",lekki,0,0,0,0,lekki4,2500000.0,3500000.0,3000000.0,0,39,7,2200000
1403, off kensular ikate lekki lagos,7,4,3,4,"Spacious 3bedeoom with a separate entrance,for inspection pls call 08089633335/08168285322 ... Renovated. Jacuzzi. Water Treatment. Security Doors. Pop Ceiling. ...",lekki,0,0,0,0,lekki4,2500000.0,3500000.0,3000000.0,0,39,7,2200000
1404," tam ogboi street,off freedom way lekki phase 1 lekki phase 1 lekki lagos",7,4,3,4,This terrace duplex is in a gated estate ... Dry. New. Parking Space. Church Nearby. Security. All Room Ensuit. Pop Ceiling. Boys Quater. Drainage System. ...,lekki,1,0,0,1,lekki4,2500000.0,3500000.0,3000000.0,2,39,7,3000000
1405, lekki phase1 lekki phase 1 lekki lagos,7,4,3,4,"FULLY SERVICED 3 BEDROOM FLAT FOR RENT!!! - - Lekki Phase 1, Lekki, Lagos Price: 6M per annum SC: 1M Features: - New - All Rooms Ensuite - Carport - CCTV Cameras - Gym - Fully Fitted Kitchen - Swimming Pool - Interlocked Floor - Sound System - Elevator ... Serviced. New. Cctv Cameras. Parking Space. Water Treatment. Elevator. Swimming Pool. 24 Hours Security. 24 Hours Electricity. ...",lekki,1,1,1,1,lekki4,2500000.0,3500000.0,3000000.0,4,39,7,4300000
1406, off admiralty road lekki phase 1 lekki lagos,2,1,1,1,It has mordern facilities and serviced ... New. 24 Hours Security. 24 Hours Electricity. ...,lekki,1,0,0,1,lekki1,800000.0,1300000.0,1169999.9999999988,2,21,4,1200000
1407, ikate lekki lagos,11,6,5,6,Brand new 5bedroom duplex +bq self serviced apartment Rent 4m Legal 200k Agency 400k Caution 200k Service charge 400k Tenants come with there Generator ... New. Cctv Cameras. Parking Space. Water Treatment. Street Lights. Security. Security Doors. All Room Ensuit. 24 Hours Security. Pop Ceiling. Boys Quater. Big Compound. Drainage System. ...,lekki,0,0,0,0,lekki6,5500000.0,6200000.0,6200000.0,0,54,10,4700000
1408, the address estate osapa london lekki lagos,9,5,4,5,"A Tastefully Finished 4 Bedroom House with all Rooms ensuites located at The Address Estate, Jakande, Lekki Lagos. Rent: 5.5M x 1 Year or 5M x 2 Years SERVICES * 24 Hours Power Supply * 24 Hours Security * Cleaning ... Serviced. Cctv Cameras. All Room Ensuit. 24 Hours Security. Boys Quater. 24 Hours Electricity. ...",lekki,1,1,1,1,lekki5,3500000.0,5000000.0,4000000.0,4,48,9,5500000
1409, eleganzer garden vgc lekki lagos,9,5,4,5,For inspection pls call [redacted]/[redacted] ... Cheap. Renovated. Children Play Ground. Parking Space. Jacuzzi. All Room Ensuit. Fast Internet. Pop Ceiling. Boys Quater. Big Compound. Drainage System. Church Nearby. Water Treatment. Supermarket Nearby. 24 Hours Security. ...,lekki,0,0,0,1,lekki5,3500000.0,5000000.0,4000000.0,1,48,9,3500000
1410, gated estate lekki phase 1 lekki lagos,11,6,5,6,FOR RENT 5 bedroom detached duplex with 2 bqs for rent Location: Lekki Phase 1 Price: N15m ($42k) Features: - All Rooms Ensuite - 24hrs Security - 2 Boyâ€™s Quarter - Big Compound - Solar Panels - CCTV Cameras - Bathtub - Smoke Detectors - Cinema - Fully ... New. Cctv Cameras. Parking Space. Water Treatment. Gym. Swimming Pool. All Room Ensuit. 24 Hours Security. Pop Ceiling. Boys Quater. Big Compound. 24 Hours Electricity. ...,lekki,1,1,0,1,lekki6,5500000.0,6200000.0,6200000.0,3,54,10,6200000
1411, igbo efon lekki lagos,5,3,2,3,For inspection pls call 08089633335/08158285322 ... Cheap. Water Treatment. All Room Ensuit. ...,lekki,0,0,0,0,lekki3,2000000.0,2500000.0,2500000.0,0,38,7,1000000
1412, oral estate oral estate lekki lagos,2,1,1,1,1 bedroom mini flat Self Contain Flat / Apartment for rent Osapa london Osapa london Lekki Lagos ... Cheap. Renovated. Serviced. Water Treatment. Big Compound. Supermarket Nearby. All Room Ensuit. Security Doors. Street Lights. ...,lekki,0,0,0,0,lekki1,800000.0,1300000.0,1169999.9999999988,0,21,4,550000
1413, kusenla ikate lekki lagos,9,4,5,4,FOR RENT Newly built 4bedroom Terrace Duplex within a fully Serviced Estate Location: ikate Elegushi PRICE: 4.5Million The project comprise of: â€¢All En-suite Bedrooms. â€¢1 Room boys Quarters. â€¢Living room Areas & Dining area. â€¢2 parking Ports. â€¢1 Fitted Kitchen ... Serviced. New. Furnished. Water Treatment. Gym. Swimming Pool. Pop Ceiling. 24 Hours Security. Security. Security Doors. Parking Space. Boys Quater. Drainage System. 24 Hours Electricity. Street Lights. Child Care. All Room Ensuit. ...,lekki,1,1,1,1,lekki4,2500000.0,3500000.0,3000000.0,4,39,7,4300000
1414, lekki right lekki phase 1 lekki lagos,9,5,4,5,"This is an exquisite 4 bedroom semi detached terrace duplex located in a very secure estate within Lekki Phase 1. The rooms are neatly tiled, spacious and fitted with modern wardrobes. The kitchen is fully ... ...",lekki,1,1,1,1,lekki5,3500000.0,5000000.0,4000000.0,4,48,9,5200000
1415, ikate lekki lagos,3,2,1,2,"It has a service charge of 350k,for inspection pls call 08089633335/08168285322 ... Serviced. Cheap. Renovated. Water Treatment. Fast Internet. All Room Ensuit. 24 Hours Security. ...",lekki,0,0,0,0,lekki2,1500000.0,2000000.0,1700000.0,0,34,6,900000
1416, primewaterview estate lekki phase 1 lekki lagos,10,5,5,5,"Nicely finished 3bedroom flats with bq. Pool gym lift CCTV, tennis courts, basketball, laundry,mall ,24hrs power etc ... Serviced. New. Boys Quater. Security. Street Lights. Church Nearby. Fast Internet. Children Play Ground. Big Compound. Drainage System. Swimming Pool. Gym. 24 Hours Electricity. 24 Hours Security. Ocean View. Cctv Cameras. Elevator. Pop Ceiling. Water Treatment. Supermarket Nearby. Security Doors. Child Care. ...",lekki,0,0,0,1,lekki5,3500000.0,5000000.0,4000000.0,1,48,9,3500000
1417, free trade zone ibeju lekki lagos,12,6,6,6,Duplex ... New. Parking Space. Boys Quater. Big Compound. All Room Ensuit. Pop Ceiling. 24 Hours Security. ...,lekki,0,0,0,0,lekki6,5500000.0,6200000.0,6200000.0,0,54,10,4700000
1418, lekki phase 2 lekki lagos,10,5,5,5,"FOR RENT!!! Detail: 4 bedroom semi-detached duplex for rent Location: Lekki County Homes, Lekki Price: 3M/p.a â€¢ â€¢ Features: - New - All Rooms Ensuite - Stamp Concrete Floor - Fitted Kitchen - Pop Ceiling - Clean water - Shower - Water Heater - Water treatment plant - â€¢â€¢â€¢â€¢â€¢â€¢â€¢â€¢â€¢â€¢â€¢â€¢â€¢â€¢â€¢â€¢â€¢â€¢â€¢â€¢â€¢â€¢â€¢â€¢â€¢â€¢â€¢â€¢â€¢â€¢â€¢â€¢â€¢â€¢â€¢â€¢â€¢â€¢â€¢â€¢â€¢â€¢ For ... Dry. New. Cheap. Furnished. Water Treatment. Boys Quater. Street Lights. Children Play Ground. Governor's Consent. Restaurants Nearby. Security Doors. All Room Ensuit. Pop Ceiling. Jacuzzi. Parking Space. Cctv Cameras. Supermarket Nearby. Survey. Fast Internet. Drainage System. Security. Church Nearby. Gym. Big Compound. 24 Hours Security. ...",lekki,0,0,0,1,lekki5,3500000.0,5000000.0,4000000.0,1,48,9,3500000
1419, lekki phase 1 lekki lagos,8,4,4,4,Very Clean furnished apartment in Lekki phase 1 Rent: ?10m SC:?2m Legal:10% Agency:10% For the of luxury and comfort ?? ... Serviced. Dry. Furnished. 24 Hours Electricity. Street Lights. Drainage System. Security. Water Treatment. Restaurants Nearby. Big Compound. Parking Space. C Of O. Pop Ceiling. Supermarket Nearby. 24 Hours Security. Security Doors. Fast Internet. Child Care. All Room Ensuit. Cctv Cameras. ...,lekki,1,1,1,1,lekki4,2500000.0,3500000.0,3000000.0,4,39,7,4300000
1420, ikota lekki lagos,7,4,3,4,Luxury 3bed apartment Rent: 2.2m SC: 700k ... New. Serviced. Big Compound. Pop Ceiling. 24 Hours Security. Boys Quater. All Room Ensuit. Water Treatment. ...,lekki,0,0,0,0,lekki4,2500000.0,3500000.0,3000000.0,0,39,7,2200000
1421, ikota lekki lagos,9,5,4,5,4 bedroom Semi Detached Duplex House for rent Ikota Lekki Lagos ... New. Cheap. Dry. Street Lights. Drainage System. Church Nearby. Boys Quater. Security. Water Treatment. Restaurants Nearby. Big Compound. Parking Space. Pop Ceiling. Supermarket Nearby. 24 Hours Security. All Room Ensuit. Cctv Cameras. Mosques Nearby. Jacuzzi. ...,lekki,0,0,0,1,lekki5,3500000.0,5000000.0,4000000.0,1,48,9,3500000
1422, - chevron lekki lagos,9,5,4,5,"Impressive 4Bedroom semi Detached duplex with bq located at Chevron Alternative, Lekki. Price : N3.5 Million ________________________________ Features 1. All rooms ensuite 2. 2 Family Lounge 3. Swimming Pool 4. Fitted kitchen 5. Stamped Concrete Floor 7. Inbuilt Sound System 8. Closet 9. CCTV 10. ... Renovated. Big Compound. Parking Space. Pop Ceiling. Street Lights. Printing Service. Supermarket Nearby. 24 Hours Security. Security Doors. Boys Quater. All Room Ensuit. Water Treatment. Restaurants Nearby. ...",lekki,0,0,0,1,lekki5,3500000.0,5000000.0,4000000.0,1,48,9,3500000
1423, opposite mega chicken ikota ikota lekki lagos,10,5,5,5,Clean 3bed apartment with BQ Rent: 1.7m ... Cheap. Dry. Big Compound. C Of O. Pop Ceiling. Supermarket Nearby. 24 Hours Security. Boys Quater. All Room Ensuit. Water Treatment. Cctv Cameras. ...,lekki,0,0,0,1,lekki5,3500000.0,5000000.0,4000000.0,1,48,9,3500000
1424, chevron lekki lagos,9,5,4,5,"Nicely Built 4 Bedroom Terraced Duplex with Location: Chevron Alternative Route Price: 3M Serviced: Not Determined yet Features: - All Ensuite - Stamp Concrete Floor - Kitchen store - Fully Fitted Kitchen - Bathtub - Easily accessible Agency: 10% Legal:5% FOR MORE INFORMATION CONTACT US ON: 08101672746, 09072914906 ... New. Big Compound. Parking Space. Street Lights. Security Doors. All Room Ensuit. Security. Water Treatment. ...",lekki,0,0,0,1,lekki5,3500000.0,5000000.0,4000000.0,1,48,9,3500000
1425, lekki phase 1 lekki lagos,11,6,5,6,"Luxury exquisitely crafted serviced 3bed apartment with BQ Rent: 7m; two years 12m then ground floor two years 11m SC: 2.5m 24hrs light For the love of space and beauty, this apartment is awesome. ... New. Serviced. 24 Hours Electricity. Street Lights. Drainage System. Boys Quater. Water Treatment. Restaurants Nearby. Gym. C Of O. Pop Ceiling. Supermarket Nearby. 24 Hours Security. Fast Internet. Child Care. All Room Ensuit. Cctv Cameras. ...",lekki,1,1,0,1,lekki6,5500000.0,6200000.0,6200000.0,3,54,10,6200000
1426, jakande jakande lekki lagos,5,3,2,3,Well finished 2bedroom flat for rent in a well gated and secure estate ... Serviced. Renovated. Big Compound. Parking Space. Street Lights. Supermarket Nearby. 24 Hours Security. Security Doors. Drainage System. All Room Ensuit. Security. Water Treatment. Jacuzzi. ...,lekki,0,0,0,1,lekki3,2000000.0,2500000.0,2500000.0,1,38,7,2000000
1427, lekki lagos,10,5,5,5,Clean 4bedroom apartment with BQ Rent: 3m Self Service ... Cheap. Dry. C Of O. Pop Ceiling. 24 Hours Security. Boys Quater. Water Treatment. ...,lekki,0,0,0,1,lekki5,3500000.0,5000000.0,4000000.0,1,48,9,3500000
1428, lekki lekki phase 1 lekki lagos,9,5,4,5,Well finished 4bedroom terrace duplex located in a well gated Estate in lekki phase1 ... Renovated. Big Compound. Street Lights. Supermarket Nearby. 24 Hours Security. Security Doors. All Room Ensuit. Security. Water Treatment. ...,lekki,0,0,0,1,lekki5,3500000.0,5000000.0,4000000.0,1,48,9,3500000
1429, osapa london lekki lagos,9,5,4,5,4 bedroom Terraced Duplex House for rent Osapa london Lekki Lagos ... Cheap. Serviced. Dry. 24 Hours Electricity. Children Play Ground. Street Lights. Drainage System. Church Nearby. Boys Quater. Security. Water Treatment. Restaurants Nearby. Big Compound. Parking Space. Pop Ceiling. Supermarket Nearby. 24 Hours Security. Security Doors. All Room Ensuit. Swimming Pool. Cctv Cameras. ...,lekki,0,0,0,1,lekki5,3500000.0,5000000.0,4000000.0,1,48,9,3500000
1430, ikate lekki lagos,9,5,4,5,4 bedroom Terraced Duplex House for rent Ikate Lekki Lagos ... New. Cheap. Serviced. Dry. 24 Hours Electricity. Children Play Ground. Street Lights. Drainage System. Boys Quater. Governor's Consent. Security. Water Treatment. Restaurants Nearby. Gym. Big Compound. Parking Space. Pop Ceiling. Supermarket Nearby. 24 Hours Security. Security Doors. All Room Ensuit. Swimming Pool. Cctv Cameras. Mosques Nearby. Jacuzzi. ...,lekki,1,1,1,1,lekki5,3500000.0,5000000.0,4000000.0,4,48,9,5600000
1431, lekki phase 1 lekki lagos,8,4,4,4,Very decent 3bedroom flat for rent in Lekki Phase1 Rent: ?3.5m ... Dry. Big Compound. Street Lights. Supermarket Nearby. 24 Hours Security. Security Doors. Drainage System. Fast Internet. Child Care. Security. Water Treatment. Cctv Cameras. Restaurants Nearby. ...,lekki,1,1,1,1,lekki4,2500000.0,3500000.0,3000000.0,4,39,7,3500000
1432, arcadia groove estate osapa london lekki lagos,11,6,5,6,Nicely Built 5 Bedroom Detached Duplex with a BQ for Rent Location: Arcadia Groove Estate Price: 10million Features: â€¢ All Ensuite â€¢ Stamp Concrete Floor â€¢ Kitchen store â€¢ Fully Fitted Kitchen â€¢ Bathtub â€¢ Easily accessible .Gym Room Agency: 10% Legal:5% FOR MORE INFORMATION AND INSPECTION CONTACT ... New. Gym. Big Compound. Parking Space. Boys Quater. All Room Ensuit. Security. Water Treatment. Cctv Cameras. ...,lekki,1,1,0,1,lekki6,5500000.0,6200000.0,6200000.0,3,54,10,6200000
1433, osapa osapa london lekki lagos,5,3,2,3,Well finished 2bedroom flat for rent in a well gated estate with good road and clean water self serviced apartment ... ...,lekki,0,0,0,1,lekki3,2000000.0,2500000.0,2500000.0,1,38,7,2000000
1434, - lekki phase 1 lekki lagos,9,5,4,5,Newly Built 3bed apartment in a serene environment Rent: 4m SC:1.5m Comes with; Pool Elevator CCTV POP finish And a lot more ... New. Serviced. 24 Hours Electricity. Drainage System. Boys Quater. Elevator. Security. Water Treatment. Restaurants Nearby. Big Compound. Parking Space. C Of O. Pop Ceiling. Supermarket Nearby. 24 Hours Security. Security Doors. Fast Internet. Child Care. All Room Ensuit. Swimming Pool. Cctv Cameras. Jacuzzi. ...,lekki,0,0,0,1,lekki5,3500000.0,5000000.0,4000000.0,1,48,9,3500000
1435, lekki phase 1 lekki lagos,8,4,4,4,Very clean 3bedroom apartment with a room BQ Rent: 3m SC: 500k excluding dies deposit ... Cheap. Serviced. Renovated. 24 Hours Electricity. Pop Ceiling. 24 Hours Security. Drainage System. Fast Internet. Boys Quater. Security. Water Treatment. ...,lekki,1,0,0,1,lekki4,2500000.0,3500000.0,3000000.0,2,39,7,3000000
1436, chevron lekki lagos,10,5,5,5,Very Clean 3bed apartment Rent: 2m SC:200k Note: This will be ready January 2020 ... New. Dry. Big Compound. Parking Space. Pop Ceiling. Supermarket Nearby. 24 Hours Security. All Room Ensuit. Water Treatment. ...,lekki,0,0,0,1,lekki5,3500000.0,5000000.0,4000000.0,1,48,9,3500000
1437, lekki phase 1 lekki lagos,5,3,2,3,2 bedroom Penthouse Flat / Apartment for rent Lekki Phase 1 Lekki Lagos ... Serviced. Furnished. Street Lights. Drainage System. Boys Quater. Security. Water Treatment. Restaurants Nearby. Big Compound. Parking Space. Pop Ceiling. Supermarket Nearby. 24 Hours Security. Security Doors. All Room Ensuit. ...,lekki,1,1,1,1,lekki3,2000000.0,2500000.0,2500000.0,4,38,7,3500000
1438, lekki phase 1 lekki lagos,8,4,4,4,Very Neat 3bedroom apartment Rent: 3.5m Self service ... Dry. Big Compound. Pop Ceiling. 24 Hours Security. Boys Quater. All Room Ensuit. Water Treatment. ...,lekki,1,1,1,1,lekki4,2500000.0,3500000.0,3000000.0,4,39,7,3500000
1439, ikota villa ikota lekki lagos,7,4,3,4,Well finished Tastefully 3bedroom flat available in a gated estate with good road and clean water for rent ... Renovated. Big Compound. Parking Space. Pop Ceiling. Street Lights. Supermarket Nearby. 24 Hours Security. Security Doors. Drainage System. All Room Ensuit. Security. Water Treatment. Jacuzzi. ...,lekki,0,0,0,0,lekki4,2500000.0,3500000.0,3000000.0,0,39,7,2000000
1440, mobolaji johnson estate lekki phase 1 lekki lagos,9,5,4,5,Well finished 4bedroom semi detached duplex available for rent in a well gated and secure estate with good road and clean water at lekki phase1 ... Renovated. Big Compound. Parking Space. Street Lights. 24 Hours Security. Security Doors. All Room Ensuit. Security. Water Treatment. ...,lekki,0,0,0,1,lekki5,3500000.0,5000000.0,4000000.0,1,48,9,3500000
1441, chevron drive chevron lekki lagos,9,5,4,5,24hours electricity 24hours security Very clean water Good road ... New. Serviced. 24 Hours Electricity. Children Play Ground. 24 Hours Security. All Room Ensuit. Security. Swimming Pool. Water Treatment. ...,lekki,0,0,0,1,lekki5,3500000.0,5000000.0,4000000.0,1,48,9,3500000
1442, ologolo lekki lagos,10,5,5,5,"Very Clean 4bedroom duplex with a room BQ In a very secure and clean estate, well managed drainage system for rent. Rent: ?3.5m Agency:10% Legal:10% ... Dry. Drainage System. Boys Quater. Security. Water Treatment. Big Compound. Parking Space. Pop Ceiling. Supermarket Nearby. 24 Hours Security. Fast Internet. Child Care. All Room Ensuit. Cctv Cameras. Jacuzzi. ...",lekki,0,0,0,1,lekki5,3500000.0,5000000.0,4000000.0,1,48,9,3500000
1443, lekki lekki phase 1 lekki lagos,7,4,3,4,Well finished 3bedroom flat with a Bq available for rent in a well secure and gated estate ... Serviced. Renovated. 24 Hours Electricity. Children Play Ground. Street Lights. Boys Quater. Elevator. Security. Water Treatment. Restaurants Nearby. Big Compound. Parking Space. Pop Ceiling. Supermarket Nearby. 24 Hours Security. Security Doors. All Room Ensuit. Swimming Pool. Cctv Cameras. Jacuzzi. ...,lekki,1,1,1,1,lekki4,2500000.0,3500000.0,3000000.0,4,39,7,4300000
1444, chevron lekki lagos,11,6,5,6,Nicely Built 5 Bedroom Detached Duplex with a BQ for Rent Location: chevron Features: - All Ensuite - Stamp Concrete Floor - Kitchen store - Fully Fitted Kitchen - Bathtub - Easily accessible .Gym Room Price: 4Million Agency: 10% Legal:5% Refundable Caution Deposit: 200k FOR MORE INFORMATION CONTACT ... New. Big Compound. Parking Space. Street Lights. Boys Quater. All Room Ensuit. Water Treatment. Jacuzzi. ...,lekki,0,0,0,0,lekki6,5500000.0,6200000.0,6200000.0,0,54,10,4700000
1445, chevron lekki lagos,7,4,3,4,"Very Neat 3bed apartment in an estate Rent: 1.8m Self service Very decent apartment, Hurry now it just came out ... Dry. Big Compound. Street Lights. Supermarket Nearby. 24 Hours Security. Security Doors. All Room Ensuit. Security. Water Treatment. ...",lekki,0,0,0,0,lekki4,2500000.0,3500000.0,3000000.0,0,39,7,2000000
1446, osapa osapa london lekki lagos,3,1,2,1,Very spacious office space. Service charge is 300000. ... ...,lekki,1,1,1,1,lekki1,800000.0,1300000.0,1169999.9999999988,4,21,4,2000000
1447, off freedom way ikate lekki lagos,2,1,1,1,"Shared apartment in Ikate... Only 2 rooms available NOTE: It's open for only working class... Rent: 700k, 650k and 600k SC: 5k to 10k monthly( covers water and security) Agency: 10% Legal: 10% Caution: 25k ... Cheap. Dry. Big Compound. Parking Space. Pop Ceiling. 24 Hours Security. All Room Ensuit. ...",lekki,0,0,0,0,lekki1,800000.0,1300000.0,1169999.9999999988,0,21,4,700000
1448, chevron lekki lagos,10,5,5,5,Clean 4bed terrace duplex with BQ Rent: 2m Professional fee: 200k Legal fee:100k ... Dry. Parking Space. Pop Ceiling. 24 Hours Security. All Room Ensuit. Water Treatment. ...,lekki,0,0,0,1,lekki5,3500000.0,5000000.0,4000000.0,1,48,9,3500000
1449, chevron lekki lagos,9,5,4,5,"Nicely Built 4 Bedroom Terraced Duplex Location: Chevron Alternative Route Price: 2.5M Serviced: Not Determined yet Features: - All Ensuite - Stamp Concrete Floor - Kitchen store - Fully Fitted Kitchen - Bathtub - Easily accessible Agency: 10% Legal:5% FOR MORE INFORMATION CONTACT US ON: 08101672746, 09072914906 ... New. Big Compound. Parking Space. Street Lights. All Room Ensuit. Security. Water Treatment. Cctv Cameras. ...",lekki,0,0,0,1,lekki5,3500000.0,5000000.0,4000000.0,1,48,9,3500000
1450, osapa london lekki lagos,7,4,3,4,3 Bedroom flat for Rent Location: Osapa Features: - All Ensuite - Bathtub - Easily accessible Price: 2Million Self seviced Agency: 10% Legal:5% FOR MORE INFORMATION AND INSPECTION CONTACT US ON: 08101672746 ... ...,lekki,0,0,0,0,lekki4,2500000.0,3500000.0,3000000.0,0,39,7,2000000
1451, megamounds estates ikota lekki lagos,11,6,5,6,"Spacious 5BR Duplex with a room BQ located in a serene compound available for lease at Megamounds estate, Ikota,Lekki. Rent:N5M Agreement :10% Agency:10% Caution deposit :N300k. ... New. Big Compound. 24 Hours Electricity. Pop Ceiling. Supermarket Nearby. 24 Hours Security. Security Doors. Boys Quater. All Room Ensuit. Security. Water Treatment. ...",lekki,0,0,0,0,lekki6,5500000.0,6200000.0,6200000.0,0,54,10,5000000
1452, lekki phase 1 lekki lagos,9,5,4,5,Exquisitely designed 3bedroom serviced apartment Rent: ?4m SC:1.5m ... New. Serviced. Dry. 24 Hours Electricity. Drainage System. Boys Quater. Security. Water Treatment. Pop Ceiling. Supermarket Nearby. 24 Hours Security. Security Doors. Child Care. All Room Ensuit. Cctv Cameras. Jacuzzi. ...,lekki,1,0,0,1,lekki5,3500000.0,5000000.0,4000000.0,2,48,9,4000000
1453, chevron lekki lagos,8,4,4,4,"Serviced 3bedroom apartment Rent:1.5m SC: 480k Professional fee: 10% Legal fees: 10% Desiel deposit decided by the Tennants according to the proportion needed, can be as low as 10k monthly, there is constant light because they ... Cheap. Serviced. Parking Space. 24 Hours Electricity. Pop Ceiling. Supermarket Nearby. 24 Hours Security. Water Treatment. ...",lekki,0,0,0,0,lekki4,2500000.0,3500000.0,3000000.0,0,39,7,2000000
1454, lekki phase 1 lekki lagos,7,4,3,4,3 bedroom Flat / Apartment for rent Lekki Phase 1 Lekki Lagos ... Serviced. Renovated. Dry. Big Compound. Parking Space. Pop Ceiling. Supermarket Nearby. 24 Hours Security. Drainage System. All Room Ensuit. Security. ...,lekki,1,1,1,1,lekki4,2500000.0,3500000.0,3000000.0,4,39,7,4000000
1455, lekki phase 1 lekki lagos,10,5,5,5,Neatly Built 4Bedroom terrace duplex for rent Features POP finish Serviced Gated mini estate Parking Space Rent:?4m SC: 500k Agency:10% Legal: 10% ... New. Cheap. Serviced. Big Compound. Pop Ceiling. Supermarket Nearby. 24 Hours Security. Drainage System. Boys Quater. All Room Ensuit. Water Treatment. Cctv Cameras. Restaurants Nearby. ...,lekki,0,0,0,1,lekki5,3500000.0,5000000.0,4000000.0,1,48,9,3800000
1456, lekki phase 1 lekki lagos,5,3,2,3,Service charge- 1M inclusive of diesel deposit ... Cheap. Serviced. Dry. Big Compound. Parking Space. 24 Hours Electricity. Pop Ceiling. Street Lights. Supermarket Nearby. 24 Hours Security. Drainage System. Church Nearby. All Room Ensuit. Security. Water Treatment. ...,lekki,1,1,0,1,lekki3,2000000.0,2500000.0,2500000.0,3,38,7,2500000
1457, ikota lekki lagos,7,4,3,4,"RENT: 2.5M Service Charge: 650k per annum (covers security, cleaning of common areas, lawma, pool maintenance, sewage disposal and water treatment) 24 hrs power BQ Swimming Pool Fitted Kitchen Ample Parking Space... Agency: 10% Legal:5 % FOR MORE INFORMATION CONTACT US ON: 08101672746, 09072914906 ... New. Serviced. 24 Hours Electricity. 24 Hours Security. Boys Quater. All Room Ensuit. Swimming Pool. ...",lekki,0,0,0,1,lekki4,2500000.0,3500000.0,3000000.0,1,39,7,2500000
1458, chevron lekki lagos,12,6,6,6,Clean 3bed semi-detached Rent: ?3m Self service Location: Chevy View ... New. Serviced. Big Compound. Pop Ceiling. Street Lights. Supermarket Nearby. 24 Hours Security. Drainage System. Fast Internet. Boys Quater. Child Care. All Room Ensuit. Water Treatment. Jacuzzi. ...,lekki,0,0,0,0,lekki6,5500000.0,6200000.0,6200000.0,0,54,10,4700000
1459, chevron drive chevron lekki lagos,7,4,3,4,Brand new 3bedroom flat available for rent in a well secure and gated estate with 24hours electricity and good road with clean water ... New. Serviced. 24 Hours Electricity. Children Play Ground. Street Lights. Drainage System. Security. Water Treatment. Restaurants Nearby. Big Compound. Parking Space. Pop Ceiling. Supermarket Nearby. 24 Hours Security. Security Doors. All Room Ensuit. Swimming Pool. ...,lekki,0,0,0,1,lekki4,2500000.0,3500000.0,3000000.0,1,39,7,2500000
1460, lekki lekki phase 1 lekki lagos,13,7,6,7,Well finished 5bedroom last semi detached duplex with a two rooms Bq located in a very secure and busy area off admiralty with clean water and good road ... Renovated. Big Compound. Parking Space. Pop Ceiling. Street Lights. Supermarket Nearby. 24 Hours Security. Security Doors. Boys Quater. All Room Ensuit. Security. Water Treatment. ...,lekki,0,0,0,1,lekki7,6000000.0,6800000.0,6529999.999999999,1,56,10,6000000
1461, lekki phase 1 lekki lagos,9,5,4,5,"Four bedroom terrace duplex with two rooms boys quarters, located in a serene flood free area. ... Serviced. Dry. Furnished. 24 Hours Electricity. Street Lights. Drainage System. Boys Quater. Security. Restaurants Nearby. Big Compound. Parking Space. Pop Ceiling. Supermarket Nearby. 24 Hours Security. All Room Ensuit. Jacuzzi. ...",lekki,1,1,1,1,lekki5,3500000.0,5000000.0,4000000.0,4,48,9,5600000
1462, ikota villa estates ikota lekki lagos,9,5,4,5,"Well finished 4Bedroom terraced duplex with bq located at Ikota Villa estates,Lekki available for lease Price : N2.7 Million(P/A) ________________________________ Features 1. All rooms ensuite 2. 2 Family Lounge 3. Swimming Pool 4. Fitted kitchen 5. Stamped Concrete Floor 8. Closet 10. POP Ceilings 11. ... New. Big Compound. Parking Space. 24 Hours Electricity. Pop Ceiling. Printing Service. 24 Hours Security. Church Nearby. Boys Quater. All Room Ensuit. Water Treatment. Restaurants Nearby. ...",lekki,0,0,0,1,lekki5,3500000.0,5000000.0,4000000.0,1,48,9,3500000
1463, pinnock estate jakande lekki lagos,13,7,6,7,Well finished 6bedroom semi detached house with a Bq in a well gated estate with good road and clean water. ... New. Serviced. Big Compound. Parking Space. Pop Ceiling. Street Lights. Supermarket Nearby. 24 Hours Security. Security Doors. Drainage System. Boys Quater. All Room Ensuit. Security. Water Treatment. ...,lekki,0,0,0,1,lekki7,6000000.0,6800000.0,6529999.999999999,1,56,10,6500000
1464, ikate ikate lekki lagos,7,4,3,4,Brand new 4bedroom terrace duplex available for rent in a gated estate with 20hours electricity power supply in a good environment with a good road and clean water ... New. Serviced. Big Compound. Parking Space. Pop Ceiling. Street Lights. Supermarket Nearby. 24 Hours Security. Security Doors. Drainage System. All Room Ensuit. Security. Water Treatment. Jacuzzi. ...,lekki,1,0,0,1,lekki4,2500000.0,3500000.0,3000000.0,2,39,7,3000000
1465, osapa london lekki lagos,9,5,4,5,Nicely Built 4 Bedroom Detached Duplex with a BQ for Rent Location: Osapa Estate Price: 3.5million Features: â€¢ All Ensuite â€¢ Kitchen store â€¢ Fully Fitted Kitchen â€¢ Bathtub â€¢ Easily accessible .Gym Room Agency: 10% Legal:5% FOR MORE INFORMATION AND INSPECTION CONTACT US ON: 08101672746 ... New. Parking Space. 24 Hours Electricity. Supermarket Nearby. Security Doors. Boys Quater. All Room Ensuit. Water Treatment. Cctv Cameras. ...,lekki,0,0,0,1,lekki5,3500000.0,5000000.0,4000000.0,1,48,9,3500000
1466, located in lekki county homes ikota lekki lagos nigeria ikota lekki lagos,11,6,5,6,Best Swimming Pool Offer NEW LISTING ALERT!!! Neatly finished & Spacious 5Bedroom Fully Detached Duplex with Swimming Pool & BQ for sale! Swimming Pool Spacious Compound Location: Ikota Lekki Price: N75m Title: Governors Consent Enquiries|| inspection|| purchases|| call/whatsapp worldmarks properties ... New. Cheap. Dry. Furnished. 24 Hours Electricity. Children Play Ground. Street Lights. Drainage System. Boys Quater. Governor's Consent. Security. Water Treatment. Restaurants Nearby. Gym. Big Compound. Parking Space. Pop Ceiling. Supermarket Nearby. 24 Hours Security. Security Doors. All Room Ensuit. Swimming Pool. Cctv Cameras. Jacuzzi. Survey. ...,lekki,1,1,0,1,lekki6,5500000.0,6200000.0,6200000.0,3,54,10,6200000
1467, osapa london lekki lagos,10,5,5,5,Very Clean 3bed Apartment with a BQ Rent : 3m Professional fee: 10% Legal fee: 10% Caution deposit: 200k Grand total: 3.8m ... New. Dry. Big Compound. Pop Ceiling. Supermarket Nearby. 24 Hours Security. Boys Quater. All Room Ensuit. Water Treatment. Restaurants Nearby. ...,lekki,0,0,0,1,lekki5,3500000.0,5000000.0,4000000.0,1,48,9,3500000
1468," admiralty way,lekki phase one lekki phase 1 lekki lagos",5,3,2,3,"Newly built 2 bedroom serviced apartment for rent at admiralty way just beside Ebeano Supermarket... Features include 24hrs light,ample parking ,borehole,water treatment plant,all rooms en-suite and elevator.24 hours security. Reason To Rent: Well developed infrastructure,High level ... New. Serviced. 24 Hours Electricity. Church Nearby. Elevator. Water Treatment. Restaurants Nearby. Big Compound. C Of O. Supermarket Nearby. 24 Hours Security. Security Doors. All Room Ensuit. Cctv Cameras. Mosques Nearby. ...",lekki,1,1,1,1,lekki3,2000000.0,2500000.0,2500000.0,4,38,7,3500000
1469, lekki phase 1 lekki lagos,13,7,6,7,Clean luxury 4bedroom duplex with two BQs Rent:6m SC: 2.5m: covers for bought light and Diesel deposit 24hrs light ... Serviced. Dry. 24 Hours Electricity. Drainage System. Boys Quater. Water Treatment. Gym. Big Compound. C Of O. Pop Ceiling. Supermarket Nearby. 24 Hours Security. Fast Internet. Child Care. All Room Ensuit. Swimming Pool. Cctv Cameras. Jacuzzi. ...,lekki,0,0,0,1,lekki7,6000000.0,6800000.0,6529999.999999999,1,56,10,6000000
1470, chevron lekki lagos,10,5,5,5,Very Neat 3bedroom apartment with room BQ Rent:?2.2m SC: 350k Caution fee: 150k ... New. Dry. Drainage System. Boys Quater. Governor's Consent. Security. Water Treatment. Restaurants Nearby. Parking Space. Pop Ceiling. Supermarket Nearby. 24 Hours Security. Fast Internet. Child Care. All Room Ensuit. ...,lekki,0,0,0,1,lekki5,3500000.0,5000000.0,4000000.0,1,48,9,3500000
1471, osapa osapa london lekki lagos,5,3,2,3,Well finished 2bedroom flat located at Osapa London lekki in well secure environment and good road ... New. Big Compound. Street Lights. Supermarket Nearby. Security Doors. All Room Ensuit. Security. Water Treatment. ...,lekki,0,0,0,1,lekki3,2000000.0,2500000.0,2500000.0,1,38,7,2000000
1472, osapa osapa london lekki lagos,5,3,2,3,Well finished 2bedroom flat for rent in a well gated estate with good road and clean water self serviced apartment ... ...,lekki,0,0,0,1,lekki3,2000000.0,2500000.0,2500000.0,1,38,7,2000000
1473, chevron lekki lagos,11,6,5,6,Clean 3bedroom flat with a BQ Rent :?2.350m Serviced ... Cheap. Serviced. Dry. Street Lights. Drainage System. Boys Quater. Security. Water Treatment. Restaurants Nearby. Parking Space. C Of O. Pop Ceiling. Supermarket Nearby. 24 Hours Security. Child Care. All Room Ensuit. ...,lekki,0,0,0,0,lekki6,5500000.0,6200000.0,6200000.0,0,54,10,4700000
1474, lekki phase 1 lekki lagos,7,4,3,4,3 bedroom Flat / Apartment for rent Lekki Phase 1 Lekki Lagos ... Cheap. Renovated. Dry. Big Compound. Parking Space. Pop Ceiling. Street Lights. Supermarket Nearby. 24 Hours Security. Security Doors. Drainage System. All Room Ensuit. Security. Water Treatment. Restaurants Nearby. ...,lekki,0,0,0,1,lekki4,2500000.0,3500000.0,3000000.0,1,39,7,2800000
1475, chevron lekki lagos,8,4,4,4,"Decent 3bedroom apartment 2nd floor Rent: 1.8m SC:250k The rooms are spacious, one room is ensuite while two share a very convenient toilet and bathroom, then a visitors toilet Each Tennant comes with his/her own ... Cheap. Dry. Big Compound. Supermarket Nearby. 24 Hours Security. Water Treatment. ...",lekki,0,0,0,0,lekki4,2500000.0,3500000.0,3000000.0,0,39,7,2000000
1476, chevron drive chevron lekki lagos,9,5,4,5,Tastefully finished 4bedroom semi detached duplex available for rent in a well gated and secure estate on chevron drive with clean water and good road ... New. Serviced. 24 Hours Electricity. Children Play Ground. Street Lights. Security. Water Treatment. Restaurants Nearby. Big Compound. Parking Space. Pop Ceiling. Supermarket Nearby. 24 Hours Security. Security Doors. Fast Internet. All Room Ensuit. Swimming Pool. ...,lekki,0,0,0,1,lekki5,3500000.0,5000000.0,4000000.0,1,48,9,3500000
1477, lekki county estate ikota lekki lagos,6,3,3,3,Newly built 2bedroom out for rent and for sale Rent:1.6m SC:650k Price: 25m 24hrs light ... New. Cheap. Serviced. Parking Space. 24 Hours Electricity. Pop Ceiling. Supermarket Nearby. 24 Hours Security. Security. Water Treatment. Restaurants Nearby. ...,lekki,0,0,0,0,lekki3,2000000.0,2500000.0,2500000.0,0,38,7,1600000
1478, lekki phase 1 lekki lagos,13,7,6,7,"Luxury serviced Duplex with two BQ Rent: ?5.5m SC:?1.5m Diesel deposit: 750k Located in a serene environment, gated mini estate in Lekki Phase1. ... Serviced. 24 Hours Electricity. Children Play Ground. Street Lights. Boys Quater. Security. Water Treatment. Restaurants Nearby. Big Compound. Parking Space. C Of O. Pop Ceiling. Supermarket Nearby. 24 Hours Security. Security Doors. Fast Internet. Child Care. All Room Ensuit. Cctv Cameras. Jacuzzi. ...",lekki,0,0,0,0,lekki7,6000000.0,6800000.0,6529999.999999999,0,56,10,5500000
1479, ikate lekki lagos,8,4,4,4,Very Clean 3bedroom flat in Ikate for rent Features: Perfect water treatment plant POP finish Spacious rooms Interlocked compound Fitted kitchen Automated Gate Etc Rent:?2.5m Service Charge: ?300k Agency :10% Legal: 10% No Central Generator ... New. Cheap. Serviced. Big Compound. Pop Ceiling. 24 Hours Security. Drainage System. Boys Quater. All Room Ensuit. Security. Water Treatment. ...,lekki,0,0,0,1,lekki4,2500000.0,3500000.0,3000000.0,1,39,7,2700000
1480, lekki phase 1 lekki lagos,7,4,3,4,Nicely built 3 Bedroom flat with a BQ for rent Location: lekki phase 1 Price: 6million Features: â€¢ All Ensuite â€¢ Stamp Concrete Floor â€¢ Kitchen store â€¢ Fully Fitted Kitchen â€¢ Bathtub â€¢ easily accessible Swimming pool Gym 24 hours light Service charge: 1m FOR MORE INFORMATION AND ... New. Serviced. 24 Hours Electricity. Children Play Ground. Street Lights. Boys Quater. Elevator. Security. Water Treatment. Restaurants Nearby. Gym. Big Compound. Parking Space. 24 Hours Security. Security Doors. Fast Internet. All Room Ensuit. Swimming Pool. Cctv Cameras. ...,lekki,1,1,1,1,lekki4,2500000.0,3500000.0,3000000.0,4,39,7,4300000
1481, chevron chevron lekki lagos,9,5,4,5,Tastefully finished 4bedroom semi detached duplex with a Bq located in a well secure estate ... Serviced. Renovated. Children Play Ground. Street Lights. Drainage System. Boys Quater. Security. Water Treatment. Restaurants Nearby. Big Compound. Pop Ceiling. Supermarket Nearby. 24 Hours Security. Security Doors. Fast Internet. All Room Ensuit. ...,lekki,0,0,0,1,lekki5,3500000.0,5000000.0,4000000.0,1,48,9,3500000
1482, chevron alternative route lekki phase 1 lekki lagos,11,6,5,6,FURNISHED 5 BEDROOM FULLY DETACHED WITH A ROOM BQ All room en suite Fitted kitchen Water treatment Parking space Complete furniture 30 KVA new generator Inverter RENT:8M AGENCY: 10% OF THE RENT PAID LEGAL: 5% OF THE RENT PAID FOR MORE INFORMATION AND INSPECTION CONTACT ... ...,lekki,1,1,0,1,lekki6,5500000.0,6200000.0,6200000.0,3,54,10,6200000
1483, ikota ikota lekki lagos,9,5,4,5,Brand new 4bedroom fully detached duplex with a Bq available for rent in a well secure and gated estate with good road and clean water ... New. Serviced. 24 Hours Electricity. Children Play Ground. Street Lights. Drainage System. Boys Quater. Security. Water Treatment. Restaurants Nearby. Big Compound. Parking Space. Pop Ceiling. Supermarket Nearby. 24 Hours Security. Security Doors. Fast Internet. Child Care. All Room Ensuit. Cctv Cameras. Jacuzzi. ...,lekki,1,0,0,1,lekki5,3500000.0,5000000.0,4000000.0,2,48,9,4000000
1484, chevron lekki lagos,10,5,5,5,"Clean 4bedroom terrace duplex Rent: 3m SC: 380k 24hrs light, pay as you use ... New. Cheap. Serviced. 24 Hours Electricity. Street Lights. Security. Water Treatment. Restaurants Nearby. Big Compound. Parking Space. C Of O. Pop Ceiling. Supermarket Nearby. 24 Hours Security. Security Doors. All Room Ensuit. Cctv Cameras. ...",lekki,0,0,0,1,lekki5,3500000.0,5000000.0,4000000.0,1,48,9,3500000
1485, orchid road ikota lekki lagos,9,5,4,5,"RENT: 3.2M Security Gate CCTV Camera Water Heater Fitted Kitchen Ample Parking Space... Agency: 10% Legal:5 % FOR MORE INFORMATION CONTACT US ON: 08101672746, 09072914906 ... New. Parking Space. All Room Ensuit. Water Treatment. Cctv Cameras. ...",lekki,0,0,0,1,lekki5,3500000.0,5000000.0,4000000.0,1,48,9,3500000
1486, chevron lekki lagos,12,6,6,6,Luxury Massive 4bedroom duplex Rent: 3.5m Professional fee: 10% Legal fee: 10% Caution deposit: 200k ... Dry. Big Compound. Pop Ceiling. Supermarket Nearby. 24 Hours Security. Security Doors. Boys Quater. Child Care. All Room Ensuit. Water Treatment. ...,lekki,0,0,0,0,lekki6,5500000.0,6200000.0,6200000.0,0,54,10,4700000
1487, marwa lekki phase 1 lekki lagos,9,5,4,5,4 bedroom terrace duplex for rent RENT: 4.5M AGENCY: 10% OF THE RENT PAID LEGAL: 5% OF THE RENT PAID FOR MORE INFORMATION AND INSPECTION CONTACT US ON: 09072914906 ... ...,lekki,1,0,1,1,lekki5,3500000.0,5000000.0,4000000.0,3,48,9,4500000
1488, lekki phase 1 lekki lagos,7,4,3,4,3 bedroom Flat / Apartment for rent Lekki Phase 1 Lekki Lagos ... New. Cheap. Serviced. Dry. 24 Hours Electricity. Street Lights. Drainage System. Boys Quater. Elevator. Security. Water Treatment. Gym. Big Compound. Parking Space. Pop Ceiling. Supermarket Nearby. 24 Hours Security. Security Doors. All Room Ensuit. Cctv Cameras. Jacuzzi. ...,lekki,1,1,1,1,lekki4,2500000.0,3500000.0,3000000.0,4,39,7,4300000
1489, lekki phase 1 lekki lagos,11,6,5,6,"Spacious 5br semi- duplex with a room bq available for lease in lekki phase 1,lekki. Rent:n6m agreement :10% agency:10% caution deposit :n300k. ... New. Big Compound. Pop Ceiling. Supermarket Nearby. Water Treatment. Restaurants Nearby. ...",lekki,0,0,0,1,lekki6,5500000.0,6200000.0,6200000.0,1,54,10,6000000
1490, chevron drive chevron lekki lagos,7,4,3,4,"Tastefully finished 3bedroom flat available for rent at lekki paradise3 estate chevron drive lekki in a well secure and gated estate with 24hours electricity and clean water, and also good road ... New. Serviced. Big Compound. Parking Space. 24 Hours Electricity. Pop Ceiling. Street Lights. Supermarket Nearby. 24 Hours Security. Security Doors. All Room Ensuit. Security. Water Treatment. Restaurants Nearby. ...",lekki,0,0,0,0,lekki4,2500000.0,3500000.0,3000000.0,0,39,7,2300000
1491, idado lekki lagos,9,5,4,5,"For Rent Property type: Spacious 4 bedroom semi detached duplex for rent (NO BQ ). Property needs little renovation which will be done by landlord. Location: idado estate, before Chevron. Rent: #3million Net Note -Owner want ... 24 Hours Security. Security. Pop Ceiling. All Room Ensuit. Security Doors. Parking Space. Big Compound. ...",lekki,0,0,0,1,lekki5,3500000.0,5000000.0,4000000.0,1,48,9,3500000
1492, eputu ibeju lekki lagos,2,1,1,1,"The house rent i #350,000 The caution, deposit and agent fee is 10% each The total package is #455,000 A mini flat with balcony Clean Environment Good light supply 24/7 water supply A married couple or single office worker ... New. ...",lekki,0,0,0,0,lekki1,800000.0,1300000.0,1169999.9999999988,0,21,4,455000
1493, beside prime waters ikate lekki lagos,2,1,1,1,Serviced room in a shared apartment ... Serviced. ...,lekki,0,0,0,1,lekki1,800000.0,1300000.0,1169999.9999999988,1,21,4,815000
1494, located at west end estate off lekki county estate ikota lekki lagos,9,5,4,5,"For Rent!!! Brand new 4 bedroom semi detached duplex with I room bq Location- Westend estate, Ikota Lekki Rent - 3M/Annum Agreement 10% Agency 10% caution 200k If my number is not going please call my WhatsApp number ... New. Boys Quater. 24 Hours Security. Restaurants Nearby. Big Compound. Parking Space. Jacuzzi. Security. Supermarket Nearby. Street Lights. All Room Ensuit. Water Treatment. Security Doors. Pop Ceiling. ...",lekki,0,0,0,1,lekki5,3500000.0,5000000.0,4000000.0,1,48,9,3500000
1495, safe court apartments lekki phase 1 lekki lagos,7,4,3,4,"Three Bedroom apartment in a serene and secure environment, property is serviced and on a top floor. Features: -1 Room Boys Quarters -Ample Parking - Very spacious bedrooms and living room -Bath tub and bathroom cubicles - Fitted wardrobes - Fitted ... ...",lekki,1,0,0,1,lekki4,2500000.0,3500000.0,3000000.0,2,39,7,3000000
1496, lekki phase 1 lekki lagos,10,5,5,5,"Exquisitely and Massive 4bedroom duplex at lekki phase 1 -5m Very tasteful, gated, round with fence, security incline area, clean environment, enormous car park, good tap water and borehole, tiled, all axis motorable, academically inclined ... New. Furnished. 24 Hours Electricity. 24 Hours Security. Big Compound. ...",lekki,1,1,1,1,lekki5,3500000.0,5000000.0,4000000.0,4,48,9,5000000
1497, femi okunu estate lekki phase 1 lekki lagos,10,5,5,5,"very lovely 4 bedrooms with 2 rooms bq, gated estate,secured and very serene with good neighbourhood access.ine if the best around for now ... ...",lekki,0,0,0,1,lekki5,3500000.0,5000000.0,4000000.0,1,48,9,3500000
1498, lekki phase 1 lekki lagos,7,4,3,4,Three Bedroom Pent house in a serene and secure environment. Property is serviced and on a top floor. Features: -1 Room Boys Quarters -Ample Parking - Very spacious bedrooms and living room -Bath tub and bathroom cubicles - Fitted wardrobes -Swimming ... Serviced. Security. All Room Ensuit. Parking Space. Boys Quater. Security Doors. Drainage System. 24 Hours Security. Big Compound. Supermarket Nearby. Street Lights. Swimming Pool. Water Treatment. Restaurants Nearby. Pop Ceiling. ...,lekki,1,1,1,1,lekki4,2500000.0,3500000.0,3000000.0,4,39,7,3500000
1499, lekki phase 1 lekki lagos,4,2,2,2,"Very tasteful and lovely mini flat at lekki phase 1 with ultra modern facilities used, very accessible and tied road network, it has unit dedicated prepaid metre, it is simply one of the best apartment ... ...",lekki,0,0,0,1,lekki2,1500000.0,2000000.0,1700000.0,1,34,6,1500000
1500, lekki phase 1 lekki lagos,6,3,3,3,"Exquisitely finished 2 bedroom apartment at lekki phase 1 Very tasteful, gated, round with fence, security incline area, clean environment, enormous car park, good tap water and borehole, tiled, all axis motorable, academically inclined environment, ... ...",lekki,0,0,0,1,lekki3,2000000.0,2500000.0,2500000.0,1,38,7,2000000
1501, lekki phase 1 lekki phase 1 lekki lagos,12,6,6,6,"Tastefully Finished & Furnished 5 Bedroom Duplex off Admiralty road, Lekki Phase 1. Daily Rate: N40,000/RM/night, Weekly Rate: N35,000/RM/night (2ndfloor), N30,000/RM/night (1stfloor), Monthly Rate: N28,000/RM/night(2ndfloor), N25,000/RM/night(1stfloor). ... Serviced. Renovated. Furnished. Security. All Room Ensuit. Parking Space. Security Doors. 24 Hours Electricity. Drainage System. Water Treatment. 24 Hours Security. Restaurants Nearby. Pop Ceiling. Big Compound. ...",lekki,1,1,0,1,lekki6,5500000.0,6200000.0,6200000.0,3,54,10,6200000
1502, idado lekki lagos,9,5,4,5,Agency- 5% ... New. Governor's Consent. Pop Ceiling. All Room Ensuit. Big Compound. Parking Space. ...,lekki,1,0,0,1,lekki5,3500000.0,5000000.0,4000000.0,2,48,9,4000000
1503, lekki lagos,4,2,2,2,Brand new 2 bedroom flat at Lekki Rent 650k Agency fee 10% Agreement fee 10% Caution fee 10% Service charge 10% ... ...,lekki,0,0,0,0,lekki2,1500000.0,2000000.0,1700000.0,0,34,6,900000
1504, lekki lagos,4,2,2,2,Brand new 2 bedroom flat at Lekki Rent 800k Agency fee 80k Agreement fee 80k Caution fee 80k Service charge not yet fixed ... ...,lekki,0,0,0,0,lekki2,1500000.0,2000000.0,1700000.0,0,34,6,900000
1505, located at chisco at ikate lekki inside an estate ikate lekki lagos,7,4,3,4,"A Terrace Duplex with all Rooms en suit with a Guest toilet,,24hrs Light,,Massive Rooms with fitted wardrobes,,water heater,,Fully Fitted Kitchen,, Large Living room with a Dining Area,,Maximum Security Guaranteed,,Enough Packing Space etc... Service charge call for ... Serviced. Furnished. New. All Room Ensuit. Big Compound. Boys Quater. Supermarket Nearby. Parking Space. 24 Hours Security. Restaurants Nearby. Pop Ceiling. Swimming Pool. Jacuzzi. Water Treatment. 24 Hours Electricity. Security. Street Lights. Security Doors. ...",lekki,1,1,1,1,lekki4,2500000.0,3500000.0,3000000.0,4,39,7,3500000
1506, osapa london lekki lagos,8,4,4,4,"2bedroom flat with Very spacious BQ The rent is 2.2million, Service charge is 500k.Diesel is pay as you use, so tenants contribute according to usage but itâ€™s coordinated by the management office Location: Osapa London Features: - New - All ... Cheap. Serviced. Furnished. New. Dry. All Room Ensuit. Big Compound. Excision. Boys Quater. Supermarket Nearby. Drainage System. Survey. 24 Hours Security. Gym. Restaurants Nearby. Governor's Consent. Pop Ceiling. Swimming Pool. Jacuzzi. Water Treatment. Cctv Cameras. Free Wifi. 24 Hours Electricity. Fast Internet. Church Nearby. Security. Street Lights. Security Doors. ...",lekki,0,0,0,0,lekki4,2500000.0,3500000.0,3000000.0,0,39,7,2200000
1507, lekki lagos,6,3,3,3,"Brand New 3 bedroom flat , attached with 1 room servants quarter,fully fitted kitchen and serviced with Generator powe bcr, swimming pool,gym, massive security etc Location: lekki phase 1 Rent : N3M per annum Service charge N1.2m diesel ... ...",lekki,1,1,1,1,lekki3,2000000.0,2500000.0,2500000.0,4,38,7,3000000
1508, lekki lagos,16,8,8,8,"A 8 bedroom duplex SUITABLE FOR EATERY, HOTEL, OFFICE , SCHOOL OR FACTORY USE. LOCATION:, lekki phase1 it has Six car park space PRICE: N7 MILLION Per Annum ... ...",lekki,1,1,0,1,lekki8,7000000.0,7000000.0,7000000.0,3,59,10,7000000
1509, lekki lagos,10,5,5,5," A Very Spacious 5 Bedroom Fully detached duplex ,It has spacious Swimming Pool and 200KV Gen etc. ... ...",lekki,1,1,1,1,lekki5,3500000.0,5000000.0,4000000.0,4,48,9,5600000
1510," ikota villa, behind mega chicken, lekki phase 2 lekki lagos",9,5,4,5,A luxury 4 bedroom detached duplex in a beautiful and well-secured estate. An estate where visitors have to call residence before allowed into the estate. ... ...,lekki,0,0,0,1,lekki5,3500000.0,5000000.0,4000000.0,1,48,9,3500000
1511," chevron, lekki, lagos chevron lekki lagos",8,4,4,4,Brand new 4 bedroom semi detached duplex with bq A beautiful 4 bedroom semi detached duplex with a rooms boys quarter Features : - Ample parking space - Water treatment plant. - Electric fence. - Fully fitted kitchen. ... Cheap. Serviced. New. Dry. Governor's Consent. All Room Ensuit. Big Compound. Jacuzzi. Water Treatment. Boys Quater. 24 Hours Electricity. Security. 24 Hours Security. Security Doors. Gym. ...,lekki,0,0,0,0,lekki4,2500000.0,3500000.0,3000000.0,0,39,7,2000000
1512," chevron, lekki lagos chevron lekki lagos",9,4,5,4,Brand new 4 bedroom semi detached duplex with bq A beautiful 4 bedroom semi detached duplex with a rooms boys quarter Features : - Installed solar panels with inverters - Ample parking space - Water treatment plant. - ... Cheap. Serviced. New. All Room Ensuit. Big Compound. Jacuzzi. Water Treatment. 24 Hours Electricity. Drainage System. 24 Hours Security. Street Lights. Security Doors. ...,lekki,0,0,0,0,lekki4,2500000.0,3500000.0,3000000.0,0,39,7,2000000
1513, value county estate near lagos business school off lekki epe expressway ajah lagos,8,4,4,4,A newly built 3 bedrooms flat is up for rent at a beautiful estate in Ajah. The said apartment is in Value County Estate just after the Lagos business School. The said apartment comes with ... Big Compound. All Room Ensuit. 24 Hours Security. 24 Hours Electricity. ...,lekki,0,0,0,0,lekki4,2500000.0,3500000.0,3000000.0,0,39,7,2000000
1514, lekki lagos,10,5,5,5,A tastefully finished 5 bedroom detached house Location :lekki Price :4m for rental 80m for sales ... ...,lekki,1,0,0,1,lekki5,3500000.0,5000000.0,4000000.0,2,48,9,4000000
1515, agungi lekki lagos,8,4,4,4,4 bedroom terrace duplex in an estate in Agungi (self-serviced) for N4m. ... ...,lekki,1,1,1,1,lekki4,2500000.0,3500000.0,3000000.0,4,39,7,4000000
1516, ologolo lekki lagos,7,4,3,4,"Massive Brand New 3 Bedroom Luxury Flat with a Bq There is a servant's quarter attached. This Apartment is massive in all sense. The kitchen is equipped with microwave, heat extractor, and oven. There is of course a big ... New. ...",lekki,0,0,0,1,lekki4,2500000.0,3500000.0,3000000.0,1,39,7,2500000
1517, osapa london lekki lagos,2,1,1,1,"It's a lovely accommodation. Annual rent #600k per annum, Caution #100k Service Charge #200k per annum Agency 10% of annual rent, Legal 10% of annual rent, Total Package: #1,020,000 We are ChimAa Realty...get in touch today ... New. ...",lekki,0,0,0,0,lekki1,800000.0,1300000.0,1169999.9999999988,0,21,4,600000
1518, after lbs in olokonla in ajah axis lekki. olokonla ajah lagos,7,4,3,4,"A Newly Built Superbly Spacious 3 Bedrooms Flat in a very cool, well gated, safely guarded and highly secured Estate with clean water, good light, good roads, easy access to the roads and good road ... Cheap. New. Supermarket Nearby. Parking Space. All Room Ensuit. Fast Internet. Street Lights. Water Treatment. Big Compound. Restaurants Nearby. Pop Ceiling. Drainage System. Security Doors. Security. 24 Hours Security. ...",lekki,0,0,0,0,lekki4,2500000.0,3500000.0,3000000.0,0,39,7,2000000
1519, opp ikota villa before ajah in lekki. lekki phase 2 lekki lagos,4,2,2,2,"A Brand New Mini Flat in a very serene, well gated, guarded and secured area with easy access to the express road, close to the express road, clean water, good light and good roads opposite ... Cheap. New. Supermarket Nearby. Parking Space. All Room Ensuit. Fast Internet. Street Lights. Water Treatment. Big Compound. Restaurants Nearby. Pop Ceiling. Drainage System. Security Doors. Security. 24 Hours Security. ...",lekki,0,0,0,0,lekki2,1500000.0,2000000.0,1700000.0,0,34,6,900000
1520, osapa london lekki lagos,6,3,3,3,"2 bedrooms self-serviced flat at Osapa London, Lekki Rent: #1.2million ... Dry. All Room Ensuit. Big Compound. Pop Ceiling. ...",lekki,0,0,0,0,lekki3,2000000.0,2500000.0,2500000.0,0,38,7,1200000
1521, lekki phase 1 lekki lagos,7,4,3,4,"Newly built and serviced 3 bedroom flat with bq is available for rent in ikate,lekki service charge #600k ... ...",lekki,0,0,0,0,lekki4,2500000.0,3500000.0,3000000.0,0,39,7,2000000
1522, lekki phase 1 lekki lagos,2,1,1,1,Standard room self contained at Lekki Phase 1 ... ...,lekki,0,0,0,0,lekki1,800000.0,1300000.0,1169999.9999999988,0,21,4,700000
1523, chevron lekki lagos,6,3,3,3,"Newly built 2 bedroom apartment with 24 hours power at Lekki Gardens Chevron Paradise. Rent: N2m Agency fee: N200k Legal fee: N200k Caution fee: N150k Services Charge: N240k Total: N2,790,000 ... Serviced. New. Cctv Cameras. 24 Hours Security. Water Treatment. Parking Space. 24 Hours Electricity. All Room Ensuit. ...",lekki,0,0,0,1,lekki3,2000000.0,2500000.0,2500000.0,1,38,7,2000000
1524, lekki phase 1 lekki phase 1 lekki lagos,2,1,1,1,"Very Clean All Round Tiled Big and Spacious Wardrobe Kitchen Cabinet Interlocked Compound Ample Parking Space Easy Proximity One Year Rent Accepted Serene and Secured Location The total package goes like this : Rent 1m, Agency 100k, Legal 100k, Caution 50k sub total =1,250,000. ... Serviced. Renovated. Water Treatment. Security. All Room Ensuit. Parking Space. 24 Hours Security. Drainage System. Street Lights. Big Compound. Security Doors. ...",lekki,0,0,0,1,lekki1,800000.0,1300000.0,1169999.9999999988,1,21,4,1000000
1525, igbo efon igbo efon lekki lagos,2,1,1,1,3 bedroom shared apartment ... Dry. All Room Ensuit. Big Compound. ...,lekki,0,0,0,0,lekki1,800000.0,1300000.0,1169999.9999999988,0,21,4,450000
1526, lekki lagos,8,4,4,4,4 Bedroom Terrace Duplex + 1 Room BQ -- House on 2 floors -- All rooms are en suite + visitors toilet -- P O P ceiling and nice wardrobe -- moderate kitchen with cabinet & ... ...,lekki,1,0,0,1,lekki4,2500000.0,3500000.0,3000000.0,2,39,7,3000000
1527, lekki lagos,6,3,3,3,"Serviced 3 bedroom Flat for rent Location: lekki phase 1 Features: All rooms en-suite, Ample parking space Price: 2.5 million ... ...",lekki,1,1,0,1,lekki3,2000000.0,2500000.0,2500000.0,3,38,7,2500000
1528, ikota lekki lagos,2,1,1,1,Brand New selfcontained at ikota bridge 400k rent ... New. Dry. Water Treatment. Security. Street Lights. Security Doors. Supermarket Nearby. ...,lekki,0,0,0,0,lekki1,800000.0,1300000.0,1169999.9999999988,0,21,4,400000
1529, lekki lagos,8,4,4,4,4 BEDROOM DUPLEX ( SELF COMPOUND ) IN LEKKI Rent : 3m ... ...,lekki,1,0,0,1,lekki4,2500000.0,3500000.0,3000000.0,2,39,7,3000000
1530, lekki lagos,8,4,4,4,"Note : Only corporate tenant please, married person preferably) Fully serviced with 24 hours power 4 bedroom terrace with bq available at Lekki Facilities; gym, pool, club house, event space, top notch security, cctv, 24hours ... ...",lekki,1,1,1,1,lekki4,2500000.0,3500000.0,3000000.0,4,39,7,3500000
1531, lekki lagos,8,4,4,4," well tiled, beautiful 4 bedroom Duplex is available for rent in Lekki It has a spacious living room and is very close to the main road. The house is located in a clean and secured ... ...",lekki,1,1,1,1,lekki4,2500000.0,3500000.0,3000000.0,4,39,7,4300000
1532, lekki phase 1 lekki lagos,3,2,1,2,1 bedroom mini flat Mini flat Flat / Apartment for rent Lekki Phase 1 Lekki Lagos ... Renovated. New. Parking Space. Restaurants Nearby. Cctv Cameras. Supermarket Nearby. All Room Ensuit. 24 Hours Electricity. 24 Hours Security. Water Treatment. Street Lights. Security. Security Doors. ...,lekki,0,0,0,0,lekki2,1500000.0,2000000.0,1700000.0,0,34,6,1200000
1533, lekki lagos,8,4,4,4,A decent 4 bedroom duplex available for rent in Lekki The house is located in a clean and secured environment. Its also very close to the main road. ... ...,lekki,1,1,1,1,lekki4,2500000.0,3500000.0,3000000.0,4,39,7,3500000
1534, lekki lagos,8,4,4,4,4 bedroom terrace apartment with a BQ.A classy structure. * LEKKI *3million per annum ... ...,lekki,1,0,0,1,lekki4,2500000.0,3500000.0,3000000.0,2,39,7,3000000
1535, lekki lagos,6,3,3,3,A three-bedroom apartments for short stay Lekki 150000 naira per month ... ...,lekki,0,0,0,0,lekki3,2000000.0,2500000.0,2500000.0,0,38,7,1000000
1536, osapa london osapa london lekki lagos,2,1,1,1,Sharp and clean self contain at osapa London.. Rent..500000 Agency..10% Agreement..10% Maintainance..150000 ... ...,lekki,0,0,0,0,lekki1,800000.0,1300000.0,1169999.9999999988,0,21,4,500000
1537, around blenco supermarket before sangotedo in ajah axis lekki. peninsula estate ajah lagos,3,2,1,2,"A Beautifully Finished Mini Flat in a very serene, highly secured, seriously guarded, well gated, well maintained and serviced Estate with clean water, good light, good roads, easy access to the express road, very close ... Serviced. Cheap. New. Drainage System. Parking Space. Fast Internet. 24 Hours Security. Security. Security Doors. Big Compound. Restaurants Nearby. Supermarket Nearby. All Room Ensuit. 24 Hours Electricity. Water Treatment. Pop Ceiling. Street Lights. ...",lekki,0,0,0,0,lekki2,1500000.0,2000000.0,1700000.0,0,34,6,900000
1538, after blenco supermarket before sangotedo market in ajah axis lekki. sangotedo ajah lagos,7,4,3,4,"A Very Fine 3 Bedrooms Flat in a gated, guarded and secured Estate that's very close to the express road, easy access roads, clean water, good light and good roads after Blenco Supermarket before Sangotedo ... Cheap. New. Drainage System. Parking Space. Fast Internet. 24 Hours Security. Security. Security Doors. Big Compound. Restaurants Nearby. Supermarket Nearby. All Room Ensuit. Water Treatment. Pop Ceiling. Street Lights. ...",lekki,0,0,0,0,lekki4,2500000.0,3500000.0,3000000.0,0,39,7,2000000
1539, fidiso estate in kingdom hall road in abijo in ajah axis lekki. abijo ajah lagos,2,1,1,1,"A Well Kept Room Self-contained in a gated and secured area with clean water, good light and easy access roads in Abijo in Ajah axis Lekki For Rent. ... Renovated. Cheap. Drainage System. Big Compound. Parking Space. Restaurants Nearby. Supermarket Nearby. All Room Ensuit. Fast Internet. 24 Hours Security. Water Treatment. Street Lights. Security. Security Doors. ...",lekki,0,0,0,0,lekki1,800000.0,1300000.0,1169999.9999999988,0,21,4,400000
1540, after blenco supermarket before sangotedo market in ajah axis lekki. sangotedo ajah lagos,9,5,4,5,"A Brand New 4 Bedrooms Duplex with a Mini Flat BQ in a very serene, well secured, gated and guarded Estate with easy access to the express road, clean water, easy access roads and good ... Cheap. New. Drainage System. Parking Space. Fast Internet. 24 Hours Security. Boys Quater. Security. Security Doors. Big Compound. Restaurants Nearby. Supermarket Nearby. All Room Ensuit. Water Treatment. Pop Ceiling. Street Lights. ...",lekki,0,0,0,1,lekki5,3500000.0,5000000.0,4000000.0,1,48,9,3500000
1541, majek sangotedo in ajah axis lekki. sangotedo ajah lagos,3,2,1,2,"A Very Nice New Mini Flat in a safe, guarded and secured area with clean water, good light and easy to access in Majek in Sangotedo in Ajah axis Lekki For Rent. ... Cheap. New. Drainage System. Parking Space. Fast Internet. 24 Hours Security. Security. Security Doors. Big Compound. Restaurants Nearby. Supermarket Nearby. All Room Ensuit. Water Treatment. Pop Ceiling. Street Lights. ...",lekki,0,0,0,0,lekki2,1500000.0,2000000.0,1700000.0,0,34,6,900000
1542, opp sangotedo market in ajah axis lekki. sangotedo ajah lagos,5,3,2,3,"A Very Sweet New 2 Bedrooms Flat in a well gated, guarded and secured Estate with clean water, good light and easy access to the express road Opposite Sangotedo Market in Ajah axis Lekki For ... Cheap. New. Drainage System. Big Compound. Parking Space. Supermarket Nearby. All Room Ensuit. Fast Internet. 24 Hours Security. Water Treatment. Pop Ceiling. Street Lights. Security. Security Doors. ...",lekki,0,0,0,0,lekki3,2000000.0,2500000.0,2500000.0,0,38,7,1000000
1543, opp sangotedo market in ajah axis lekki. sangotedo ajah lagos,7,4,3,4,"A Newly Finished 3 Bedrooms Flat in cool, guarded, secure and gated Estate with easy access roads, close to the express road, clean water and good light opposite Sangotedo Market in Sangotedo in Ajah axis ... Cheap. New. Drainage System. Parking Space. Fast Internet. 24 Hours Security. Security. Security Doors. Big Compound. Restaurants Nearby. Supermarket Nearby. All Room Ensuit. Water Treatment. Pop Ceiling. Street Lights. ...",lekki,0,0,0,0,lekki4,2500000.0,3500000.0,3000000.0,0,39,7,2000000
1544, orchid hotel road lekki phase 2 lekki lagos,10,5,5,5,"Fully serviced estate with amenities like swimming pool, gym,children play area,astroturf, cctv cameras and electric fence wire,uniform outfit security, and mobile police in the most serene and beautiful audience ... Serviced. Dry. New. Drainage System. Church Nearby. Parking Space. Fast Internet. 24 Hours Security. Swimming Pool. Boys Quater. Security. Security Doors. Big Compound. Restaurants Nearby. Cctv Cameras. Supermarket Nearby. All Room Ensuit. Jacuzzi. Gym. 24 Hours Electricity. Water Treatment. Pop Ceiling. Street Lights. Children Play Ground. ...",lekki,1,0,0,1,lekki5,3500000.0,5000000.0,4000000.0,2,48,9,4000000
1545, orchid hotel road. lekki phase 2 lekki lagos,10,5,5,5,"Fully serviced estate with amenities like swimming pool, gym,children play area,astroturf, cctv cameras and electric fence wire,uniform outfit security, and mobile police in the most serene and beautiful ambience ... Serviced. Dry. New. Parking Space. Fast Internet. 24 Hours Security. Swimming Pool. Security. Security Doors. Big Compound. Restaurants Nearby. Supermarket Nearby. All Room Ensuit. Gym. 24 Hours Electricity. Water Treatment. Pop Ceiling. Street Lights. ...",lekki,0,0,0,1,lekki5,3500000.0,5000000.0,4000000.0,1,48,9,3500000
1546, 18 ihuntayi street off palace road oniru estate lekki phase 1 lekki lagos,6,3,3,3,Is a 3bedroom flat with boys quarter. Swimming pool and packing spaces. ... New. Parking Space. 24 Hours Electricity. 24 Hours Security. Boys Quater. Street Lights. Security. ...,lekki,1,1,1,1,lekki3,2000000.0,2500000.0,2500000.0,4,38,7,3000000
1547, bera estate chevron lekki lagos,10,5,5,5,"5rooms duplex at Bera estate off chevron drive with jacuzzi, boys quarters and enough packing space. ... New. 24 Hours Electricity. 24 Hours Security. Street Lights. Security. ...",lekki,1,1,1,1,lekki5,3500000.0,5000000.0,4000000.0,4,48,9,5000000
1548, lekki lagos,4,2,2,2,Brand New 2 bedroom flat at Lekki All rooms en-suit CCTV camera Water treatment Security Services apartment Fit kitchen Good road Ac Good environment for family and friends to leave Rent 2m Services 300k ... ...,lekki,1,1,1,1,lekki2,1500000.0,2000000.0,1700000.0,4,34,6,2000000
1549, innocent street igbo efon igbo efon lekki lagos,2,1,1,1,Nice share apartment in an secure environment at igbo Efon the room is spacious and it has wardrobe and water and light ... Big Compound. Pop Ceiling. Parking Space. Water Treatment. Security. ...,lekki,0,0,0,0,lekki1,800000.0,1300000.0,1169999.9999999988,0,21,4,450000
1550, igbo efon igbo efon lekki lagos,2,1,1,1,Shared apartment at igbo efon..only kitchen to be shared..400..450 ... ...,lekki,0,0,0,0,lekki1,800000.0,1300000.0,1169999.9999999988,0,21,4,400000
1551, abraham adesanya estate ajah lagos,4,2,2,2,Spacious room and parlor in lekki scheme 2. 450k rent ... Security. Supermarket Nearby. Security Doors. Water Treatment. Street Lights. Restaurants Nearby. ...,lekki,0,0,0,0,lekki2,1500000.0,2000000.0,1700000.0,0,34,6,900000
1552, villa estate ikota lekki lagos,6,3,3,3,A 3 bedroom flat 2m for Rent N750 service charge. 24hrs light Location ikota Villa estate Agency 10% ... Serviced. New. Parking Space. 24 Hours Security. Pop Ceiling. All Room Ensuit. 24 Hours Electricity. Big Compound. ...,lekki,0,0,0,1,lekki3,2000000.0,2500000.0,2500000.0,1,38,7,2000000
1553, lekki garden estate phase 4 lekki gardens estate ajah lagos,9,5,4,5,Four bedroom duplex for rent located inside a well organised estate with 22 hours light guratee each day and 24/7 with a central water system. Along side a second to Non security. ... Furnished. Dry. Renovated. Serviced. 24 Hours Security. 24 Hours Electricity. C Of O. All Room Ensuit. ...,lekki,0,0,0,1,lekki5,3500000.0,5000000.0,4000000.0,1,48,9,3500000
1554," megamound estate by lekki county estate, ikota lekki lagos",11,6,5,6,"An Executive and well Maintain 5nedroom Fully Detached Duplex + BQ with all Rooms en suit with a Guest toilet,, All tiles,,fitted wardrobes,,water heaters,,Cross Ventilated,,Jacuzzi Shower,,Fully Fitted Kitchen with store,,Security House,,Interlocked Compound,,Nice Neighborhood,, Enough Packing ... ...",lekki,0,0,0,0,lekki6,5500000.0,6200000.0,6200000.0,0,54,10,4700000
1555, behind the new shoprite in sangotedo in ajah axis lekki. sangotedo ajah lagos,10,5,5,5,"A Brand New Luxury and Superbly Finished 4 Bedrooms Duplex in a very beautiful, serene, cool, well gated, seriously guarded and highly secured Estate with clean water, good light, street lights, good roads, easy access ... Serviced. New. Cheap. Boys Quater. Cctv Cameras. Big Compound. Free Wifi. Restaurants Nearby. Security Doors. Front Desk Service. 24 Hours Security. Drainage System. Street Lights. Jacuzzi. Security. All Room Ensuit. Supermarket Nearby. Fast Internet. Gym. Parking Space. 24 Hours Electricity. Swimming Pool. Pop Ceiling. Children Play Ground. Child Care. Water Treatment. ...",lekki,0,0,0,1,lekki5,3500000.0,5000000.0,4000000.0,1,48,9,3500000
1556, lekki phase 1 lekki phase 1 lekki lagos,10,5,5,5,A Super Luxury and expatriate standard terrace Duplex with the best of finish with premium quality and grade A facilities. It is a complete package ticking all the right boxes of luxury. - This ... New. Boys Quater. Cctv Cameras. Big Compound. 24 Hours Security. Drainage System. Jacuzzi. Security. All Room Ensuit. Gym. 24 Hours Electricity. Swimming Pool. Children Play Ground. Child Care. Water Treatment. ...,lekki,1,1,1,1,lekki5,3500000.0,5000000.0,4000000.0,4,48,9,5600000
1557, idado estate idado lekki lagos,7,4,3,4,A self serviced 3bedroom terrace duplex in a residential estate now available for letting. ... ...,lekki,0,0,0,1,lekki4,2500000.0,3500000.0,3000000.0,1,39,7,2500000
1558," behind cooplag garden, on orchid road ikota lekki lagos",6,3,3,3,"Clean 3 Bedroom Flat for Rent, Behind Cooplag Garden ... ...",lekki,0,0,0,0,lekki3,2000000.0,2500000.0,2500000.0,0,38,7,1000000
1559, beside french colony estate off agungi - ajiran road lekki agungi lekki lagos,5,3,2,3,Brand new 2 bedroom flat upstairs inside a gated Mini Estate Beside French Colony linking Osapa london and Agungi Lekki. Place is 90% completed. ... Serviced. New. All Room Ensuit. Supermarket Nearby. Pop Ceiling. 24 Hours Security. Water Treatment. ...,lekki,0,0,0,1,lekki3,2000000.0,2500000.0,2500000.0,1,38,7,2000000
1560, ik ikate lekki lagos,8,4,4,4,"FOR RENT!!! Serviced 4-Bedroom Terrace House with BQ FEATURES: Security Gatehouse, Borehole with Treatment Plant, BQ, Fitted Kitchen with Cabinets, All Rooms Ensuite, Swimming Pool, 24Hours Power Supply etc. LOCATION: Ikate Elegushi, Lekki RENT: N3.5m per annum SERVICE CHARGE: ... Boys Quater. All Room Ensuit. Big Compound. Swimming Pool. Pop Ceiling. 24 Hours Security. Water Treatment. ...",lekki,1,1,1,1,lekki4,2500000.0,3500000.0,3000000.0,4,39,7,3500000
1561, ikate elegushi ikate lekki lagos,9,5,4,5,Very sweet and lovely estate with good environment with plenty of play areas for children. Its newly built and rooms are spacious. 16-18hours light weekdays and 24hrs weekend ... ...,lekki,0,0,0,1,lekki5,3500000.0,5000000.0,4000000.0,1,48,9,3500000
1562, jakande 1st gate jakande lekki lagos,7,4,3,4,"This contemporary block of flats is generously built with massive rooms, large balcony in all rooms, ante area, massive bathrooms and kitchen. If you are a lover of space. Nicely fitted kitchen with beautiful ground ... ...",lekki,0,0,0,1,lekki4,2500000.0,3500000.0,3000000.0,1,39,7,2500000
1563, behind nigel office lekki phase 1 lekki lagos,10,5,5,5,"Newly built 5bedroom duplex with be each room ensure',pop,cctv,jacuzzi, gascooker ,microwav marblefloor, etc. ... ...",lekki,1,1,1,1,lekki5,3500000.0,5000000.0,4000000.0,4,48,9,5000000
1564," ikate elegushi, ikate lekki lagos",8,4,4,4,"Excellent 4 BedRoom apartment in the heart of Lagos, All rooms include newly installed air conditioning and very spacious, flat-screen tv with cable channels, a large kitchen, a dining area and a private bathroom in ... ...",lekki,0,0,0,0,lekki4,2500000.0,3500000.0,3000000.0,0,39,7,2000000
1565, ikate lekki lagos,6,3,3,3,"fully serviced two bedroom flat (ground floor) for rent at new lekki horizon phase 2,meadow hall school road, ikate before fourth round about*. 24 hours light agency 10% legal 5% caution 5% light 24hrs...#65 per kilowatt ... ...",lekki,0,0,0,1,lekki3,2000000.0,2500000.0,2500000.0,1,38,7,2200000
1566, chevy view estate chevron lekki lagos,7,4,3,4,"Very lovely and nice apartment in a lovely environment. Serene environment with great ambience, lot of schools nearby, shopping mall as etc ... ...",lekki,0,0,0,0,lekki4,2500000.0,3500000.0,3000000.0,0,39,7,2000000
1567," bera estate, chevron. lekki phase 1 lekki lagos",9,5,4,5,"Brand new luxury 4 bedroom terrace duplex with BQ in bera estate chevron . Service charge #37,500 monthly . inclusive of generator light 7pm to 8am daily. All rooms ensuite Guest toilet Ample parking space Fitted kitchen with cabinets Modern fitted ... ...",lekki,0,0,0,1,lekki5,3500000.0,5000000.0,4000000.0,1,48,9,3500000
1568, ikate lekki lagos,10,5,5,5,"A 5 bedroom detached duplex for rent Location: Ikate, Lekki Price: 6M/p.a Features: - New - All Rooms Ensuite - interlocked Floor - Fitted Kitchen - Pop Ceiling - Clean water - Walk-in Shower - Water Heater - Automated Gate ... New. All Room Ensuit. Cctv Cameras. Parking Space. 24 Hours Electricity. Pop Ceiling. 24 Hours Security. ...",lekki,1,1,1,1,lekki5,3500000.0,5000000.0,4000000.0,4,48,9,5600000
1569, lekki palm city estate off lekki epe expressway ajah lagos,7,4,3,4,"The apartment is a newly built 3 bedroom flat located in a gated, serene and secured estate. It is exquisitely painted both internally and externally. Floor is finished with vitrified tiles and ceiling with POP. ... New. Dry. All Room Ensuit. Water Treatment. ...",lekki,0,0,0,0,lekki4,2500000.0,3500000.0,3000000.0,0,39,7,2000000
1570, freedom way lekki phase 1 ikoyi lagos,10,5,5,5, For Sale - Detached 5 Bedroom (all ensuite) Duplex in Lekki Phase 1 Bedrooms â€“ 5; Bathrooms â€“ 5; Toilets â€“ 6; Parking spaces â€“ 6 Property title â€“ Lagos State Governorâ€™s Consent A piece ... Serviced. New. Furnished. Cheap. Dry. Boys Quater. Governor's Consent. Cctv Cameras. Big Compound. Restaurants Nearby. Security Doors. 24 Hours Security. Drainage System. Street Lights. Survey. Jacuzzi. Security. All Room Ensuit. Supermarket Nearby. Parking Space. 24 Hours Electricity. Pop Ceiling. Children Play Ground. C Of O. Water Treatment. ...,lekki,1,1,1,1,lekki5,3500000.0,5000000.0,4000000.0,4,48,9,5600000
1571," ikate lekki lagos, ikate lekki lagos",8,4,4,4,FOR RENT 4 BEDROOM FULLY DETACHED DUPLEX FOR SALE IN IKATE LEKKI LAGOS. Features: - All rooms ensuite - Fitted Kitchen with double door Refrigerator and washing machine - Ample Car Park for 5 cars - Electric remote control gate - ... ...,lekki,1,1,1,1,lekki4,2500000.0,3500000.0,3000000.0,4,39,7,4300000
1572, ologolo ologolo lekki lagos,5,3,2,3,Very lovely newly built unit of 2bedrooms flat apartment available for rent in a serene environment with proximity to VI and Ikoyi. Area is well secured and flood free. Apartment is neatly built with great ... ...,lekki,0,0,0,0,lekki3,2000000.0,2500000.0,2500000.0,0,38,7,1700000
1573, lekki lagos,2,1,1,1,"A newly built mini flat Location: lekki Rent: #1,600,000 Services charge:#150,000 Caution:#150k Agency and legal 5% each ... ...",lekki,1,1,1,1,lekki1,800000.0,1300000.0,1169999.9999999988,4,21,4,1600000
1574, ikate lekki lagos ikate lekki lagos,9,5,4,5,"Renovated 4 bedroom Terrace Duplex all rooms ensuite spacious sitting room and spacious fitted kitchen, POP ceiling masters bedroom with balcony facing interlocked road in Ikate. ... Cheap. Renovated. All Room Ensuit. Big Compound. Security Doors. Pop Ceiling. 24 Hours Security. Water Treatment. ...",lekki,0,0,0,1,lekki5,3500000.0,5000000.0,4000000.0,1,48,9,3500000
1575, kusenla road ikate lekki lagos,7,4,3,4,"Luxury 3 bedroom flat with excellent facilities in a serviced estate in Ikate Eleguishi with 24 hours electricity, treated water, ample parking space, standard security and armed mobile police etc. ... ...",lekki,1,0,0,1,lekki4,2500000.0,3500000.0,3000000.0,2,39,7,3000000
1576, lekki lagos,2,1,1,1,A decent mini flat available for rent in Lekki The house is located in a clean and secured environment. Its also very close to the main road. ... ...,lekki,1,1,1,1,lekki1,800000.0,1300000.0,1169999.9999999988,4,21,4,1300000
1577, lekki phase1 lekki phase 1 lekki lagos,7,4,3,4,Nice apartment for rent in a lovely environment with a BQ Rent 2.5m S/c 1m Agency and Agreement 10% each ... Serviced. Renovated. Boys Quater. Security. All Room Ensuit. Big Compound. Supermarket Nearby. Security Doors. Parking Space. 24 Hours Electricity. Pop Ceiling. 24 Hours Security. Water Treatment. ...,lekki,0,0,0,1,lekki4,2500000.0,3500000.0,3000000.0,1,39,7,2500000
1578, ikota villa estate ikota lekki lagos,7,4,3,4,The property is a block of flats located in a gated estate. The apartment available is a spacious 3 bedroom flat. Ceiling is finished with POP and floor with tiles. Rent is slightly negotiable ... ...,lekki,0,0,0,0,lekki4,2500000.0,3500000.0,3000000.0,0,39,7,2000000
1579," off babatunde anjouse street, lekki phase 1 lekki lagos",5,3,2,3,"Now Letting: Premium 2 bedroom serviced flat with fitted air conditioner and kitchen. With 24 hours guaranteed light. Ideal for newly wedded couples, working class singles and for company quest house. The property is located in a quiet ... ...",lekki,1,1,0,1,lekki3,2000000.0,2500000.0,2500000.0,3,38,7,2500000
1580, lekki phase1 lekki phase 1 lekki lagos,5,3,2,3,Nice apartment in lekki phase1 for rent Rent 3.5m Caution fee 5% S/c 750k Agreement 5% Agency 10% Call us at Vicals Property for pictures and inspection ... Serviced. New. Furnished. Boys Quater. Big Compound. Restaurants Nearby. Security Doors. 24 Hours Security. Security. All Room Ensuit. Supermarket Nearby. Gym. Parking Space. 24 Hours Electricity. Swimming Pool. Pop Ceiling. C Of O. Water Treatment. ...,lekki,1,1,1,1,lekki3,2000000.0,2500000.0,2500000.0,4,38,7,3500000
1581, oral estate lekki lagos,8,4,4,4,FULLY DETACHED CONTEMPORARY DUPLEX Pay and park in brand new 5 beds Fully Detached Duplex FEATURES: Secured and gated estate Jacuzzi Interlocked road Well channelled drainage system Large parking space Spacious living room with guest toilet Dining session Well positioned fitted kitchen with back door Pop ... Serviced. New. Security. All Room Ensuit. Cctv Cameras. Big Compound. Parking Space. 24 Hours Electricity. Pop Ceiling. 24 Hours Security. Water Treatment. ...,lekki,1,1,1,1,lekki4,2500000.0,3500000.0,3000000.0,4,39,7,4300000
1582, ikate lekki lagos,5,3,2,3,"Serviced 2 bedroom flat available for rent in a serene environment at lkate. Rooms are spacious and en-suite with wardrobe. Fitted kitchen and ample parking space. Rent is 2m Service charge 450k covers treatment of water, waste disposal, ... ...",lekki,0,0,0,1,lekki3,2000000.0,2500000.0,2500000.0,1,38,7,2000000
1583," ikate elegushi, ikate lekki lagos",7,4,3,4,Furnished 3 Bedroom Apartment with b.q Features: 24 hours security. 24 hours water and power supply. Flat screen TV . Complimentary DSTV Channels Treated water and Sewage/waste disposal services Free Cleaning services. Modern kitchen + washer dryer Ensuited Bedrooms 3 Bathrooms Toilet ... ...,lekki,0,0,0,0,lekki4,2500000.0,3500000.0,3000000.0,0,39,7,2000000
1584, lekki phase1 lekki phase 1 lekki lagos,7,4,3,4,"Lovely apartment in lekki phase1 for rent Rent 5m Security deposit 1m Disel deposit 1m S/c 500k Agency 500k Agreement 250k AC, BQ, 24/7power, CCTV camera Total package 8.250,000 ... Serviced. New. Furnished. Boys Quater. Governor's Consent. Cctv Cameras. Big Compound. Restaurants Nearby. Security Doors. 24 Hours Security. Street Lights. Church Nearby. All Room Ensuit. Supermarket Nearby. Gym. Parking Space. 24 Hours Electricity. Pop Ceiling. C Of O. Water Treatment. ...",lekki,1,1,1,1,lekki4,2500000.0,3500000.0,3000000.0,4,39,7,4300000
1585," ogunfayo mini estate awoyaya, awoyaya ibeju lekki lagos",10,5,5,5,Well spacious appartment. It has two different terraced. Biggest is 1.5m while big is 1m but all spacious... ... ...,lekki,0,0,0,1,lekki5,3500000.0,5000000.0,4000000.0,1,48,9,3500000
1586, jakande lekki lagos,8,4,4,4,"Lovely 3 bedrooms penthouse with 24hours power at Cadogan estate, Jakande, Lekki ... Serviced. New. Cheap. Dry. Jacuzzi. All Room Ensuit. Cctv Cameras. Big Compound. Gym. Parking Space. 24 Hours Electricity. Pop Ceiling. 24 Hours Security. Street Lights. Water Treatment. ...",lekki,1,1,1,1,lekki4,2500000.0,3500000.0,3000000.0,4,39,7,3800000
1587, lekki lagos,8,4,4,4,"4 Bedroom Terrace Duplex with a room bq, pool, gym, diesel, gen.etc Location: Lekki, Lagos Rent: N2.7M Service Charge: N57k Monthly ... ...",lekki,0,0,0,1,lekki4,2500000.0,3500000.0,3000000.0,1,39,7,2700000
1588, osapa london lekki lagos,9,5,4,5,Lovely 4 bedroom semi-detached duplex ... ...,lekki,1,1,1,1,lekki5,3500000.0,5000000.0,4000000.0,4,48,9,5000000
1589, osapa osapa london lekki lagos,9,5,4,5,"Lovely semi detached duplex within a residential estate that is well planned, great play area for children, supermarket, swimming pool, physical and armed security guards on standby 24/7 etc ... ...",lekki,0,0,0,1,lekki5,3500000.0,5000000.0,4000000.0,1,48,9,3600000
1590, chevron lekki lagos,8,4,4,4,"Brand new 4 bedroom detached duplex with bq, at chevron alternative route, chevron. ... ...",lekki,1,1,1,1,lekki4,2500000.0,3500000.0,3000000.0,4,39,7,3500000
1591, chevron lekki lagos,8,4,4,4,"FULLY SERVICED 4 BEDROOM SEMI-DETACHED DUPLEX FOR RENT!!! - - Chevron, Lekki, Lagos Price: 3.5M per annum Features: - New - All Rooms Ensuite - Carport - CCTV Cameras - Swimming Pool - Fully Fitted Kitchen - Stamped Concrete Floor - 2 Lounges - Sound System ... Serviced. New. Boys Quater. All Room Ensuit. Big Compound. Security Doors. 24 Hours Electricity. Swimming Pool. Pop Ceiling. 24 Hours Security. ...",lekki,1,1,1,1,lekki4,2500000.0,3500000.0,3000000.0,4,39,7,3500000
1592, osapa osapa london lekki lagos,10,5,5,5,"Executive Semi-Detached Duplex in a Serene environment, secured estate, water treatment plant, pay and park-in, excellent proximity, stable power supply, adorable kitchen etc ... ...",lekki,0,0,0,1,lekki5,3500000.0,5000000.0,4000000.0,1,48,9,3500000
1593, chevron lekki lagos,9,5,4,5,NEW LISTING... This is a newly beautiful 4 bedroom semi-detached duplex available for rent. FEATURES: Smoke Detector Security House Water Treatment Plant Power Kitchen Design Well-interlocked compound Very Spacious Compound Giant Sized sitting room & bedrooms Highly Detailed Finishing Title: Governors Consent. ... New. ...,lekki,0,0,0,1,lekki5,3500000.0,5000000.0,4000000.0,1,48,9,3500000
1594," ikota villa estate, ikota lekki lagos",11,5,6,5,Magnificently built 5 Bedroom Detached townhouse with bq and located at ikota Villa EstateLekki Price : N3.5Million ________________________________ Features 1. All rooms ensuite 2. 2 Family Lounge 3. 4. Fitted kitchen 5. Stamped Concrete Floor 7. Inbuilt Sound System 8. Closet 9. CCTV 10. POP Ceilings 11. Spacious ... ...,lekki,1,1,1,1,lekki5,3500000.0,5000000.0,4000000.0,4,48,9,5600000
1595, lekki phase 1 lekki lagos,10,5,5,5,FOR RENT!!! â€¢ â€¢ Detail: 5 Bedroom Detached Duplex for Rent! Location: Lekki Phase 1 Price: N15m Features: - All Rooms Ensuite - 24hrs Security - 2 Boyâ€™s Quarter - Big Compound - Solar Panels - CCTV Cameras - Bathtub - Smoke Detectors - Cinema - Fully Fitted ... Serviced. New. Furnished. All Room Ensuit. Big Compound. Parking Space. 24 Hours Electricity. Swimming Pool. Pop Ceiling. 24 Hours Security. ...,lekki,1,1,1,1,lekki5,3500000.0,5000000.0,4000000.0,4,48,9,5600000
1596, ikota villa gra ikota lekki lagos,5,3,2,3,"Lovely and spacious 2 bedroom apartment with luxury finishing. Sitting room is spacious, spacious dining room and kitchen and very reasonably spacious rooms with cross ventilation ... ...",lekki,0,0,0,0,lekki3,2000000.0,2500000.0,2500000.0,0,38,7,1500000
1597, majek opp fara park after crown estate in sangotedo in ajah axis lekki. crown estate ajah lagos,8,4,4,4,"Freshly Built Superb 3 Bedrooms Flat in a cool, gated and secured area with clean water, good light and easy access roads in Majek opp Fara Park after Crown Estate in Sangotedo in Ajah axis ... New. Cheap. Security. All Room Ensuit. Big Compound. Supermarket Nearby. Fast Internet. Restaurants Nearby. Security Doors. Parking Space. Pop Ceiling. Drainage System. Street Lights. Water Treatment. ...",lekki,0,0,0,0,lekki4,2500000.0,3500000.0,3000000.0,0,39,7,2000000
1598, bera chevron lekki lagos,8,4,4,4,"A lovely 3 bedroom flat at bera estate,all rooms ensuite,good road,secured clean water. ... Cheap. All Room Ensuit. Big Compound. Restaurants Nearby. Security Doors. Parking Space. Pop Ceiling. 24 Hours Security. Drainage System. Street Lights. Water Treatment. ...",lekki,0,0,0,0,lekki4,2500000.0,3500000.0,3000000.0,0,39,7,2000000
1599, dr alakija lekki phase 1 lekki lagos,8,4,4,4,"This property is suitable for both residential and commercial, in a great location just 1 mins to the lekki epe expressway. Itâ€™s a 3 bedroom apartment with 1 guest room, all rooms ensuite,environment is not ... ...",lekki,1,0,0,1,lekki4,2500000.0,3500000.0,3000000.0,2,39,7,3000000
1600, alternative route chevron lekki lagos,9,5,4,5,"Newly Finished 4 Bedroom Terrace Duplex for Rent. Property Features: - Quality upscale finishing - Quality wardrobes and tiles - Gas cooker - Extractor - Master bedroom with Jacuzzi - Ample parking space - And all necessary electrical and plumbing fittings, ready ... New. Security. Supermarket Nearby. Security Doors. Parking Space. Pop Ceiling. Street Lights. Water Treatment. ...",lekki,0,0,0,1,lekki5,3500000.0,5000000.0,4000000.0,1,48,9,3500000
1601, ologolo ologolo lekki lagos,3,2,1,2,"A very neat, nice and lovely mini flat now available for rent in a location with good proximity to the express, good interlocked roads, good constant electricity and etc. Rent: 1,000,000 Service charge: 240,000 Agency: 10% Legal: 10% Caution: 100k ... ...",lekki,0,0,0,0,lekki2,1500000.0,2000000.0,1700000.0,0,34,6,1000000
1602, ikate lekki lagos,9,5,4,5,*FOR RENT IN IKATE* Newly built & Well finished 4bedroom Semi-detached duplex with a BQ is available for RENT in Ikate. Price - N4.5M Agency - 10% Agreement - 5% Caution - 5% *Total Package N5.4M* ... New. Furnished. Dry. Boys Quater. Security. All Room Ensuit. Big Compound. Restaurants Nearby. Security Doors. Parking Space. 24 Hours Electricity. Pop Ceiling. 24 Hours Security. Water Treatment. ...,lekki,1,0,1,1,lekki5,3500000.0,5000000.0,4000000.0,3,48,9,4500000
1603, bera estate chevron lekki lagos,7,4,3,4,Available ... ...,lekki,0,0,0,0,lekki4,2500000.0,3500000.0,3000000.0,0,39,7,2000000
1604, lekki palms estate lavalon hotel estate off addo road ajah ado ajah lagos,9,5,4,5,4 bedroom stand alone detached duplex all rooms ensuite with big studio kitchen with spacious sitting room and dinning inside a mini estate facing interlocked road. ... Renovated. All Room Ensuit. Big Compound. Security Doors. Pop Ceiling. 24 Hours Security. Water Treatment. ...,lekki,0,0,0,1,lekki5,3500000.0,5000000.0,4000000.0,1,48,9,3500000
1605, lekki lagos,4,2,2,2,2 bedroom serviced apartment in a gated estate by Lekki second round about occupied by a tenant for an annual rent in the sum of N2m. Sales Price N40m ... ...,lekki,1,1,1,1,lekki2,1500000.0,2000000.0,1700000.0,4,34,6,2000000
1606, agungi road lekki lagos,2,1,1,1,A very sizable shop for business or office located at AGUNGI Road Lekki. Neat with good security Standby Generator Uniform security Good proximity to the express ... ...,lekki,0,0,0,1,lekki1,800000.0,1300000.0,1169999.9999999988,1,21,4,800000
1607, southern view estate beside lekki conservation center opp chevron lekki peninsula lekki chevron lekki lagos,2,1,1,1,Tastefully renovated Miniflat with POP ceiling small fitted kitchen with wardrobe inside a secured Estate with tight security facing interlocked road inside. ... Renovated. All Room Ensuit. Pop Ceiling. ...,lekki,0,0,0,1,lekki1,800000.0,1300000.0,1169999.9999999988,1,21,4,900000
1608, chevy view lekki lagos,11,6,5,6,"Location-chevy view. Composition- brand new twin duplex with a bq , it has solar and spacious compound. Rent-4.5m Legal- 10% Agency-10% ... ...",lekki,0,0,0,0,lekki6,5500000.0,6200000.0,6200000.0,0,54,10,4700000
1609, chevron drive chevron lekki lagos,7,4,3,4,Lovely 3 bedroom flat apartment with spacious rooms and round the clock security in a fully serviced estate with 24/7 electricity supply and clean water. Apartment is on the fourth floor (Construction of Elevator is ... ...,lekki,0,0,0,0,lekki4,2500000.0,3500000.0,3000000.0,0,39,7,2400000
1610, lekki lagos,10,5,5,5,A newly renovated 5bedroom detached duplex with a BQ Location: Lekki Rent: #8m Service charge: self service Power deposit: self service Caution:#200k Agency and legal 5% each ... ...,lekki,1,1,1,1,lekki5,3500000.0,5000000.0,4000000.0,4,48,9,5600000
1611, salem lekki phase 1 lekki lagos,7,4,3,4,Luxurious Well Built 3 Bedroom Apartment in a Gated Compound with Treated clean water. Rent: 1.5m Legal and Agency: 10% each Pay and move in.... ... ...,lekki,0,0,0,0,lekki4,2500000.0,3500000.0,3000000.0,0,39,7,2000000
1612, off castle and temple off admiralty road lekki phase 1 lekki lagos,7,4,3,4,Luxury 3 Bedroom Terrace House with Gallery over Looking the Grand Room with double height ceiling BQ Swimming pool 24 electricity 24 security ... Serviced. New. Boys Quater. Big Compound. Restaurants Nearby. Security Doors. 24 Hours Security. Drainage System. Security. All Room Ensuit. Supermarket Nearby. Parking Space. 24 Hours Electricity. Swimming Pool. Pop Ceiling. Water Treatment. ...,lekki,1,1,1,1,lekki4,2500000.0,3500000.0,3000000.0,4,39,7,4300000
1613, off road 14 lekki phase 1 lekki lagos,7,4,3,4,A very well maintained self serviced 3bedroom flat in a serene residential area of Lekki phase 1 available to let. Suitable for Office use or residential ... ...,lekki,1,0,0,1,lekki4,2500000.0,3500000.0,3000000.0,2,39,7,3000000
1614, ikate lekki lagos,10,5,5,5,"FOR RENT!!! Newly built 5 bedroom with BQ(suitable for commercial use) LOCATION: Kusenla road, Ikate-Lekki RENT: 6m per annum LEGAL: 10% AGENCY: 10% CAUTION: 100k ... ...",lekki,1,1,1,1,lekki5,3500000.0,5000000.0,4000000.0,4,48,9,5600000
1615, chevron lekki lagos,8,4,4,4,"FULLY SERVICED 4 BEDROOM SEMI-DETACHED DUPLEX FOR RENT!!! - - Chevron, Lekki, Lagos Price: 3.5M per annum Features: - New - All Rooms Ensuite - Carport - CCTV Cameras - Swimming Pool - Fully Fitted Kitchen - Stamped Concrete Floor - 2 Lounges - Sound System ... New. Furnished. All Room Ensuit. Big Compound. Parking Space. 24 Hours Electricity. Swimming Pool. Pop Ceiling. 24 Hours Security. ...",lekki,1,1,1,1,lekki4,2500000.0,3500000.0,3000000.0,4,39,7,3500000
1616, lekki lagos,4,2,2,2,Decent 2 bedroom for rent in Lekki ... ...,lekki,1,1,1,1,lekki2,1500000.0,2000000.0,1700000.0,4,34,6,2000000
1617," around crown estate, sangotedo, ajah axis, lekki. sangotedo ajah lagos",6,3,3,3,"A Newly Built Luxury 2 Bedrooms Flat in a very cool, serene, seriously guarded, well gated and highly secured Estate with clean water, good light, easy access to the road and close to the road ... New. Security. All Room Ensuit. Big Compound. Supermarket Nearby. Restaurants Nearby. Parking Space. Pop Ceiling. 24 Hours Security. Drainage System. Street Lights. Water Treatment. ...",lekki,0,0,0,0,lekki3,2000000.0,2500000.0,2500000.0,0,38,7,1000000
1618," not far from pinnock beach estate, jakande, lekki osapa london lekki lagos",6,3,3,3,"Luxury all Ensuite 3 bedroom apartment in Osapa, Jakande Location: Not far from Pinnock Beach Estate, Jakande, Lekki 24hrs power 24hrs Security 24hrs Treated water supply Fully fitted Kitchen Marble walls Well tiled apartment ACs to be installed in all the rooms *below are ... Serviced. New. Boys Quater. Security. All Room Ensuit. Cctv Cameras. Big Compound. Parking Space. 24 Hours Electricity. Swimming Pool. Pop Ceiling. 24 Hours Security. Water Treatment. ...",lekki,1,1,0,1,lekki3,2000000.0,2500000.0,2500000.0,3,38,7,2500000
1619, oral estate lekki lagos,10,5,5,5,*FULLY DETACHED CONTEMPORARY DUPLEX* Pay and park in brand new 5 bed room Fully Detached Duplex FEATURES: Secured and gated estate Jacuzzi Interlocked road Well channelled drainage system Large parking space Spacious living room with guest toilet Dining session Well positioned fitted kitchen with back ... New. Furnished. All Room Ensuit. Big Compound. Parking Space. 24 Hours Electricity. Pop Ceiling. 24 Hours Security. ...,lekki,1,0,1,1,lekki5,3500000.0,5000000.0,4000000.0,3,48,9,4500000
1620, estate osapa london lekki lagos,2,1,1,1,Nice and Standard Service Mini Flat available in a Serene and Secured Estate in Osapa Lekki Lagos. Features: Standard room with Nice Wardrobe; Serene and cozy environment; fence and gated compound; good road network; good ... Serviced. Security. Supermarket Nearby. 24 Hours Security. ...,lekki,0,0,0,1,lekki1,800000.0,1300000.0,1169999.9999999988,1,21,4,850000
1621, osapa osapa london lekki lagos,2,1,1,1,Rent 1. 2 Agency and legal 10% respectively Caution 50k refundable Sc not fixed yet Just 2 in a compound ... ...,lekki,1,0,0,1,lekki1,800000.0,1300000.0,1169999.9999999988,2,21,4,1200000
1622, ikate elegushi ikate lekki lagos,5,3,2,3,Lovely 2bedrooms flat with a guest toilet available in a serene area of Ikate with close proximity to VI and Ikoyi. House is newly built with great design and has a spacious compound for ... ...,lekki,0,0,0,1,lekki3,2000000.0,2500000.0,2500000.0,1,38,7,2000000
1623, lekki phase 2 lekki phase 2 lekki lagos,9,5,4,5,Luxury 4bed semi detached duplex with a mini flat bq(has a kitchen) Rent:2.3m Location :crown estate ... ...,lekki,0,0,0,1,lekki5,3500000.0,5000000.0,4000000.0,1,48,9,3500000
1624, chevy view estate chevron lekki lagos,11,6,5,6,"Lovely apartment in Chevy View for rent Rent 5M Caution fee not setting yet Agency 10% Legal 5% Service charge 350k which covers security, water treatment and waste disposal Self-service ... Serviced. New. Boys Quater. Big Compound. Restaurants Nearby. Security Doors. 24 Hours Security. Jacuzzi. Security. All Room Ensuit. Supermarket Nearby. Gym. Parking Space. 24 Hours Electricity. Swimming Pool. Pop Ceiling. Water Treatment. ...",lekki,0,0,0,0,lekki6,5500000.0,6200000.0,6200000.0,0,54,10,5000000
1625, lekki paradise estate chevron lekki lagos,9,5,4,5,The property is a newly built 4 bedroom detached house with boy's quarter located in a serene gated estate off Chevron Drive. The property is fenced round and finished with the best modern facilities and ... Serviced. New. Boys Quater. Security. All Room Ensuit. Big Compound. Security Doors. 24 Hours Electricity. 24 Hours Security. Water Treatment. ...,lekki,1,1,1,1,lekki5,3500000.0,5000000.0,4000000.0,4,48,9,5000000
1626, osapa london lekki lagos,12,6,6,6,"6 BEDROOM FULLY DETACHED DUPLEX FOR RENT!!! â€¢ Location: Victory Park, Osapa London Price: 7M Features: - New - All Rooms Ensuite - Carport - CCTV Cameras - Fully Fitted Kitchen - Stamped Concrete Floor - Sound System - Security House - Box Room -1 BQ ... Serviced. New. Furnished. All Room Ensuit. Big Compound. Parking Space. 24 Hours Electricity. Pop Ceiling. 24 Hours Security. ...",lekki,1,1,0,1,lekki6,5500000.0,6200000.0,6200000.0,3,54,10,6200000
1627," ikate elegushi, ikate lekki lagos",6,3,3,3,. ... ...,lekki,1,1,1,1,lekki3,2000000.0,2500000.0,2500000.0,4,38,7,3000000
1628, ikate lekki lagos ikate lekki lagos,5,3,2,3,"Clean 3 bedroom flat upstairs all rooms ensuite, spacious rooms and spacious sitting room fitted kitchen. Facing interlocked road. ... Serviced. New. Cheap. All Room Ensuit. Big Compound. Security Doors. Pop Ceiling. 24 Hours Security. Water Treatment. ...",lekki,1,1,0,1,lekki3,2000000.0,2500000.0,2500000.0,3,38,7,2500000
1629, osapa osapa london lekki lagos,2,1,1,1,Luxurious single room shared apartment at Osapa-London. Features All rooms are spacious All en-suits room Wardrobe Clean water Central generator Fitted kitchen Washing machine ... ...,lekki,0,0,0,0,lekki1,800000.0,1300000.0,1169999.9999999988,0,21,4,600000
1630, lekki phase 1 lekki lagos,10,5,5,5,FOR RENT!!! Brand New Exquisitely Built & Very Spacious 5 bedroom detached duplex with BQ FEATURES: - Excellent space arrangement - Secured & enclosed environment - Fully Fitted Kitchen - Car Port - All Rooms En-suite - Beautiful Sit Out - Top notch ... New. ...,lekki,1,1,1,1,lekki5,3500000.0,5000000.0,4000000.0,4,48,9,5600000
1631, chevron lekki lagos,9,5,4,5,NEW LISTING... This is a tastefully finished 4 bedroom detached duplex with a BQ available for rent. FEATURES: Smoke Detector Water Sprinkler Security House Water Treatment Plant Power Kitchen Design The Jumbo Size Well-interlocked compound Green Areas Very Spacious Compound Giant Sized sitting room & bedrooms Highly ... New. Jacuzzi. Security. Governor's Consent. Supermarket Nearby. Restaurants Nearby. Security Doors. Parking Space. Pop Ceiling. Street Lights. Water Treatment. ...,lekki,1,0,1,1,lekki5,3500000.0,5000000.0,4000000.0,3,48,9,4500000
1632," off freedom way, lekki phase 1 lekki phase 1 lekki lagos",3,2,1,2,"New mini flat in a Serene environment lekki 1, off freedom way Lagos. It comes with two toilet, big kitchen, store, stable light, excellent proximity, clean water etc ... ...",lekki,0,0,0,0,lekki2,1500000.0,2000000.0,1700000.0,0,34,6,1400000
1633, ikota villa estate ikota lekki lagos,7,4,3,4,Very lovely 3bedroom flat in a nice residential estate ... ...,lekki,0,0,0,0,lekki4,2500000.0,3500000.0,3000000.0,0,39,7,2000000
1634, 5 street estate osapa london lekki lagos,2,1,1,1,A Portable BQ SELFCON with Access to kitchen at OSAPA London Lekki. Features: Access to kitchen Ensuit toilet and bathroom Clean water system Regular power supply 24hrs security Good drainage system Good proximity to the express Call to book and appointment for viewing while ... ...,lekki,0,0,0,0,lekki1,800000.0,1300000.0,1169999.9999999988,0,21,4,400000
1635, osapa london osapa london lekki lagos,5,3,2,3,"The apartment is a tastefully finished 2 bedroom flat located in a good neighborhood. It is a serviced apartment. Ceiling is finished with POP and floor with ceramic tiles. Rent #2m,service charge 240,000 ... Serviced. Security. All Room Ensuit. Security Doors. ...",lekki,0,0,0,0,lekki3,2000000.0,2500000.0,2500000.0,0,38,7,1800000
1636, agungi agungi lekki lagos,7,4,3,4,"Serviced estate with great facilities, nicely ventilated houses with green areas and playzone for kids ... ...",lekki,0,0,0,1,lekki4,2500000.0,3500000.0,3000000.0,1,39,7,2500000
1637, chevy view estate chevron lekki lagos,7,4,3,4,Three Bedroom Duplex in Chevy View Estate Chevron Lekki Rent:2.2m A/A 10% each Note: inspection fee is 3k Contact: God's Empire Real Estate Consultant Mr Napoleon ... Cheap. Big Compound. Restaurants Nearby. Security Doors. 24 Hours Security. Drainage System. Street Lights. Survey. Church Nearby. Security. All Room Ensuit. Supermarket Nearby. Parking Space. Pop Ceiling. Children Play Ground. Child Care. Water Treatment. ...,lekki,0,0,0,0,lekki4,2500000.0,3500000.0,3000000.0,0,39,7,2200000
1638, igbo efon by eti osa lg igbo efon lekki lagos,5,3,2,3,2bedroom apartment @ igbo efon eti osa L.G lekki road ... New. Cheap. Renovated. Security. All Room Ensuit. Supermarket Nearby. Drainage System. Water Treatment. ...,lekki,0,0,0,0,lekki3,2000000.0,2500000.0,2500000.0,0,38,7,1000000
1639, lekki lagos,8,4,4,4,4Bed+BQ terrace apartment with fully furnished kitchen. Location:Lekki Rent- 3.5m Service charge- 400k ... ...,lekki,1,1,1,1,lekki4,2500000.0,3500000.0,3000000.0,4,39,7,3500000
1640, osapa london osapa london lekki lagos,2,1,1,1,Lovely units of mini flat newly built in an estate. Just 2 tenants in the compound ... ...,lekki,0,0,0,1,lekki1,800000.0,1300000.0,1169999.9999999988,1,21,4,1100000
1641, lekki ph1 estate lagos. lekki phase 1 lekki lagos,7,4,3,4,"3 bedroom serviced apartment with a room BQ, pool and gym in quiet and safe area of lekki phase one Rent: 5m Service charge including diesel per annum: 2.8m. (Agt Gab). ... Serviced. Boys Quater. Security. All Room Ensuit. Big Compound. Gym. Security Doors. Parking Space. 24 Hours Electricity. Swimming Pool. Pop Ceiling. 24 Hours Security. Water Treatment. ...",lekki,1,1,1,1,lekki4,2500000.0,3500000.0,3000000.0,4,39,7,4300000
1642, osapa london lekki lagos,6,3,3,3,3 bedroom flat with a Bq Osapa London Rent 2M Self service ... Boys Quater. All Room Ensuit. Big Compound. 24 Hours Electricity. Pop Ceiling. 24 Hours Security. ...,lekki,0,0,0,1,lekki3,2000000.0,2500000.0,2500000.0,1,38,7,2000000
1643, oceanestate ologolo lekki lagos,8,4,4,4,"A brand new 3 bedroom flat inside an estate at ologolo,upstairs, good road,clean water and secured. ... New. Cheap. Security. All Room Ensuit. Big Compound. Security Doors. Parking Space. Pop Ceiling. 24 Hours Security. Drainage System. Street Lights. Water Treatment. Church Nearby. ...",lekki,0,0,0,0,lekki4,2500000.0,3500000.0,3000000.0,0,39,7,2000000
1644, ocean breeze ologolo lekki lagos,10,5,5,5,"A brand new 4 bedroom semi detached/terrace duplex,inside an estate,well secured ... New. Cheap. Boys Quater. Big Compound. Security Doors. 24 Hours Security. Drainage System. Street Lights. Church Nearby. Security. All Room Ensuit. Parking Space. 24 Hours Electricity. Pop Ceiling. Water Treatment. ...",lekki,0,0,0,1,lekki5,3500000.0,5000000.0,4000000.0,1,48,9,3500000
1645, agungi agungi lekki lagos,3,1,2,1,Well finished serviced 2Bedroom Flat in a nice serene mini estate in Agungi. Facilities: Generator Gym Roof Terrace Elevator Rent: N2m p.a Service Charge: N504k Power: N89/kw ... ...,lekki,1,1,1,1,lekki1,800000.0,1300000.0,1169999.9999999988,4,21,4,2000000
1646, lekki lagos,2,1,1,1,"A newly built mini flat Location: lekki Rent: #1,600,000 Services charge:#150,000 Caution:#150k Agency and legal 5% each ... ...",lekki,1,1,1,1,lekki1,800000.0,1300000.0,1169999.9999999988,4,21,4,1600000
1647, before blenco supermarket in olokonla in ajah axis lekki. olokonla ajah lagos,10,5,5,5,"A Brand New 4 Bedrooms Duplex in a serene, well gated, seriously guarded and highly secured Environment with easy access to the road, very close to the road, good light and clean water before Blenco ... New. Cheap. Security. All Room Ensuit. Big Compound. Supermarket Nearby. Restaurants Nearby. Security Doors. Parking Space. Pop Ceiling. 24 Hours Security. Drainage System. Street Lights. Water Treatment. ...",lekki,0,0,0,1,lekki5,3500000.0,5000000.0,4000000.0,1,48,9,3500000
1648," ikate elegushi, lekki lagos",2,1,1,1,"Standard room self available for rent in ikate elegushi,upstairs Running water,parking space,self serviced , wardrobe but no kitchen . Rent :500k Total package 570k ... ...",lekki,0,0,0,0,lekki1,800000.0,1300000.0,1169999.9999999988,0,21,4,500000
1649, before sangotedo market in sangotedo in ajah axis lekki. sangotedo ajah lagos,6,3,3,3,"A Well Kept 2 Bedrooms Flat in a peaceful, gated and secure area with good roads, very close to the road, clean water, easy access to the roads and good light in Sangotedo in Ajah ... Cheap. Renovated. Big Compound. Restaurants Nearby. Security Doors. 24 Hours Security. Drainage System. Street Lights. Church Nearby. Security. All Room Ensuit. Supermarket Nearby. Fast Internet. Parking Space. Pop Ceiling. Water Treatment. ...",lekki,0,0,0,0,lekki3,2000000.0,2500000.0,2500000.0,0,38,7,1000000
1650, off kusenla ikate lekki lagos,9,5,4,5,Lovely serviced terrace duplex available for rent off Kusenla in a contemporary residential setting. Each duplex has its own private backyard and parking space allotted to each unit. Fitted kitchen and a penthouse master bedroom. ... ...,lekki,0,0,0,1,lekki5,3500000.0,5000000.0,4000000.0,1,48,9,3500000
1651, off admiralty road lekki phase 1 lekki lagos,8,4,4,4,"This beautifully built terrace offers a lovely designed 4 bedrooms finished with modern facilities, good family setting, a clean, cozy and serene environment. the property also comes serviced with services such as power, back-up generator, ... ...",lekki,1,1,1,1,lekki4,2500000.0,3500000.0,3000000.0,4,39,7,4300000
1652, by mobolaji johnson lekki phase 1 lekki lagos,7,4,3,4,A cozy and lovely 3 bed house with 2 big sitting room up and down that can accommodate 20-25 staffs in a well developed area close to the Lekki Epe express. great accessibility for clients ... ...,lekki,1,1,1,1,lekki4,2500000.0,3500000.0,3000000.0,4,39,7,3500000
1653, around the new shoprite in sangotedo in ajah axis lekki. sangotedo ajah lagos,10,5,5,5,"A Newly Built Nice 4 Bedrooms Duplex in a very cool, seriously guarded, well gated and highly secured Estate with good roads, easy access to the roads, good light, clean water, very close to the ... Serviced. New. Cheap. Boys Quater. Cctv Cameras. Big Compound. Restaurants Nearby. Security Doors. 24 Hours Security. Drainage System. Street Lights. Security. All Room Ensuit. Supermarket Nearby. Fast Internet. Parking Space. 24 Hours Electricity. Pop Ceiling. Children Play Ground. Child Care. Water Treatment. ...",lekki,0,0,0,1,lekki5,3500000.0,5000000.0,4000000.0,1,48,9,3500000
1654, . ologolo lekki lagos,7,4,3,4,"Tastefully finished 3 bedroom terraced duplex with bq in a good serene environment, 24hrs power supply and 24hrs armed security. ... ...",lekki,1,0,0,1,lekki4,2500000.0,3500000.0,3000000.0,2,39,7,3200000
1655, lekki phase 1 lekki lagos,2,1,1,1,Decent Mini flat located at lekki phase 1. Rent 1.5m per annum Service charge 300k ... Serviced. New. Security. All Room Ensuit. Big Compound. Supermarket Nearby. Restaurants Nearby. Security Doors. Pop Ceiling. 24 Hours Security. Drainage System. Street Lights. ...,lekki,1,1,1,1,lekki1,800000.0,1300000.0,1169999.9999999988,4,21,4,1500000
1656, close to the spar ikate lekki lagos,8,4,4,4,Serviced 3 bedroom with bq and swimming pool with 24/7 power in an estate in ikate. Features include All rooms ensuite Fitted kitchen Guest toilet Balcony Large living area space Large kitchen and bedrooms Swimming pool Gym Facility management office Ample parking space Water treatment plant 24/7 ... ...,lekki,1,0,0,1,lekki4,2500000.0,3500000.0,3000000.0,2,39,7,3000000
1657, lekki right lekki phase 1 lekki lagos,7,4,3,4,Serviced apartment with facility maintenance team on site. ... ...,lekki,1,1,1,1,lekki4,2500000.0,3500000.0,3000000.0,4,39,7,3800000
1658, ikota lekki lagos,8,4,4,4,"4 BEDROOM SEMI-DETACHED DUPLEX FOR RENT!!! - - Ikota, Lekki, Lagos Price: 3M per annum Features: - New - All Rooms Ensuite - Carport - CCTV Cameras - Fitted Kitchen - BQ - Stamped Concrete Floor - Family Lounge - Sound System - 1 BQ ... Serviced. New. Boys Quater. All Room Ensuit. Cctv Cameras. Big Compound. 24 Hours Electricity. Pop Ceiling. 24 Hours Security. ...",lekki,1,0,0,1,lekki4,2500000.0,3500000.0,3000000.0,2,39,7,3000000
1659, ikota ikota lekki lagos,8,4,4,4, Brand new 4 bedroom fully detached duplex with room bq Spacious All rooms en-suite Cctv camera Video door bell Fully fitted Located at ikota For rent 3.5m Caution-300k Agent 10% Legal 5% ... ...,lekki,1,1,1,1,lekki4,2500000.0,3500000.0,3000000.0,4,39,7,3500000
1660, lekki phase 1 lekki lagos,8,5,3,5,"Hi Good day Thanks for clicking on me I'm a Tastefully finished and lovely 3 bedroom terrace duplex with an en-suite bq in a Serene and secured neighbourhood with beautiful aesthetic you'd love, I'm located in a ... ...",lekki,0,0,0,1,lekki5,3500000.0,5000000.0,4000000.0,1,48,9,3500000
1661," oladimeji alo street, lekki phase 1 lekki lagos",11,6,5,6,"Tastefully built Five bedrooms terrace duplex with penthouse for rent in lekki phase one, ... ...",lekki,0,0,0,0,lekki6,5500000.0,6200000.0,6200000.0,0,54,10,5000000
1662, off kazim osapa london lekki lagos,6,3,3,3,"A lovely 2 bedroom at Osapa london,one year old,with good finishing,clean water,secured,good road. ... New. Security. All Room Ensuit. Big Compound. Security Doors. Parking Space. Pop Ceiling. 24 Hours Security. Drainage System. Street Lights. Water Treatment. ...",lekki,0,0,0,1,lekki3,2000000.0,2500000.0,2500000.0,1,38,7,2000000
1663, - osapa london lekki lagos,2,1,1,1,"A Room Self Contain, (A SHARED KITCHEN) A Clean, Nice, Standard Apartment, highly gated and secured compound, gated and secured estate, well structured and very organize, at Osapa, Beside Friends Colony, Lekki, Lagos. Fully Serviced. Hurry! 1st Pay, 1st Get... Rent:500k Agent:50k Legal:50k Caution:50k Service Charge:25k ... Serviced. Cheap. Renovated. Security. Parking Space. Pop Ceiling. Street Lights. Water Treatment. ...",lekki,0,0,0,0,lekki1,800000.0,1300000.0,1169999.9999999988,0,21,4,500000
1664, lekki lekki phase 1 lekki lagos,8,4,4,4,"Very spacious 3 bedroom flat with a room Boys quarter, all rooms ensuit, stable power supply, well finished with an adorable POP and in a Serene environment. it has water heater in all the room ... ...",lekki,0,0,0,1,lekki4,2500000.0,3500000.0,3000000.0,1,39,7,2500000
1665, lekki phase one lekki phase 1 lekki lagos,5,3,2,3,"Fully serviced 2 bedroom flat in a serene environment now available for rent at 3M naira for unfurnished and 3,5M for furnished. Service charge is 1.5M Furnished: 3.5M Unfurnished: 3M ... ...",lekki,1,1,1,1,lekki3,2000000.0,2500000.0,2500000.0,4,38,7,3000000
1666, agungi lekki lagos,6,3,3,3,A decent 3 bedroom flat available for rent in Agungi. The house is located in a clean and secured environment. Its also very close to the main road. Service charge 300k Caution-100k Agent/legal 10% each ... ...,lekki,0,0,0,0,lekki3,2000000.0,2500000.0,2500000.0,0,38,7,1800000
1667," idado, lekki idado lekki lagos",5,3,2,3,Standard 2 bedroom flat in a cerene neighbourhood with modern facilities ... Serviced. New. Cheap. Security. All Room Ensuit. Big Compound. Supermarket Nearby. Parking Space. Pop Ceiling. 24 Hours Security. Drainage System. Water Treatment. ...,lekki,0,0,0,0,lekki3,2000000.0,2500000.0,2500000.0,0,38,7,1500000
1668, fubara green igbo efon lekki lagos,4,2,2,2,"A service 2 bedroom flat at fubara green, upstairs, 24 hrs light,clean water, good riad and secured, service charge 250k, no diesel deposit. ... Serviced. Cheap. Security. Big Compound. Security Doors. Parking Space. 24 Hours Electricity. Pop Ceiling. 24 Hours Security. Drainage System. Water Treatment. ...",lekki,0,0,0,0,lekki2,1500000.0,2000000.0,1700000.0,0,34,6,1200000
1669, ikate ikate lekki lagos,11,6,5,6,I very lovely apartment for rent in ikate Elegushi Rent 6M Agency and Agreement 10% Caution 300K Self service ... New. Boys Quater. Big Compound. Restaurants Nearby. Security Doors. 24 Hours Security. Street Lights. Jacuzzi. Mosques Nearby. Security. All Room Ensuit. Supermarket Nearby. Ocean View. Office Supplies. Parking Space. 24 Hours Electricity. Pop Ceiling. C Of O. Water Treatment. ...,lekki,0,0,0,1,lekki6,5500000.0,6200000.0,6200000.0,1,54,10,6000000
1670," valley stream estate, osapa london lekki lagos",9,5,4,5,Fully serviced 4 bedroom terrace duplex with bq in a serene and secured estate at osapa London. 24 hours power supply (68naira per kilowatt) Serene and secured estate. You have to call before entering the estate Swimming pool Children ... ...,lekki,0,0,0,1,lekki5,3500000.0,5000000.0,4000000.0,1,48,9,3500000
1671, .. idado lekki lagos,2,1,1,1,"A Room Self Contain, A Newly Built, Upstairs, (A SHARED KITCHEN) The Masters Bedroom of A Duplex, with Jacuzzi/Cubicle bath, gas cooker, heat extractor, water heater, very spacious. A Clean, Nice, Standard Apartment, highly gated and secured compound, gated and secured ... Serviced. New. Cheap. Security. Big Compound. Supermarket Nearby. Parking Space. Pop Ceiling. Street Lights. Water Treatment. ...",lekki,0,0,0,1,lekki1,800000.0,1300000.0,1169999.9999999988,1,21,4,1000000
1672, lekki paradise chevron lekki lagos,8,4,4,4,Fantastic 4bedroom terrace house in a secure and cerene neighbourhood with mordern facilities ... Furnished. Cheap. Renovated. Security. All Room Ensuit. Big Compound. Supermarket Nearby. Restaurants Nearby. Security Doors. Parking Space. 24 Hours Electricity. Pop Ceiling. 24 Hours Security. Drainage System. Water Treatment. ...,lekki,1,0,0,1,lekki4,2500000.0,3500000.0,3000000.0,2,39,7,3000000
1673, agungi agungi lekki lagos,2,1,1,1,Nice and well Self con Share apartment available in a Serene and Secured Environment in Agungi Lekki Lagos. Features: Standard room; Serene and cozy environment; fence and gated compound; good road network; good accessibility and ... ...,lekki,0,0,0,0,lekki1,800000.0,1300000.0,1169999.9999999988,0,21,4,450000
1674," lekki palm city estate, off ado road, ajah, lagos. badore ajah lagos",9,5,4,5,"4bedroom detached house with a room bq at Lekki palm city estate, off ado road, Ajah, Lagos. ... Serviced. New. Boys Quater. Security. All Room Ensuit. Big Compound. Supermarket Nearby. Security Doors. Parking Space. Pop Ceiling. 24 Hours Security. Water Treatment. ...",lekki,0,0,0,1,lekki5,3500000.0,5000000.0,4000000.0,1,48,9,3500000
1675, off chevron drive chevron lekki lagos,7,4,3,4,Newly built to taste with a lot of space (both inside and outside). The compound has only 2 tenants ... ...,lekki,1,0,0,1,lekki4,2500000.0,3500000.0,3000000.0,2,39,7,3000000
1676, chevron drive chevron lekki lagos,7,4,3,4,The apartment is a tastefully finished 3 bedroom terrace with a BQ located in a gated and highly secured estate. It is painted both internally and externally. It has a place in the compound where ... Serviced. Renovated. Dry. Security. All Room Ensuit. Security Doors. 24 Hours Electricity. ...,lekki,1,1,1,1,lekki4,2500000.0,3500000.0,3000000.0,4,39,7,3500000
1677, lekki phase 1 lekki lagos,6,3,3,3,"FOR RENT!!! Self-serviced 3 bedroom apartment LOCATION: off Fola Osibo, Lekki Phase 1 RENT: 3m per annum AGENCY: 10% LEGAL: 10% CAUTION: 200k ... Serviced. ...",lekki,1,1,1,1,lekki3,2000000.0,2500000.0,2500000.0,4,38,7,3000000
1678, lekki lagos,2,1,1,1, A spacious and newly built mini flat Location: Lekki Rent: #1.7m Service charge: #400k Caution:#100k Agency and legal 10% each ... ...,lekki,1,1,1,1,lekki1,800000.0,1300000.0,1169999.9999999988,4,21,4,1700000
1679, off admiralty road lekki phase 1 lekki lagos,9,5,4,5,Available for commercial or residential use ... ...,lekki,1,1,1,1,lekki5,3500000.0,5000000.0,4000000.0,4,48,9,5600000
1680, agungi lekki lagos,6,3,3,3,"A well tiled, beautiful 3 bedroom flat is available for rent in Agungi. It has a spacious living room and is very close to the main road. The house is located in a clean and secured ... ...",lekki,0,0,0,0,lekki3,2000000.0,2500000.0,2500000.0,0,38,7,1800000
1681, osapa london lekki lagos,9,5,4,5,"Tastefully Finished 4 Bedroom Semi-Detached Duplex For Rent Location: Osapa London, Lekki Price: 3.5M/p.a Features: - New - All Rooms Ensuite - Stamp Concrete Floor - Fitted Kitchen - Pop Ceiling - Clean water - Shower - Water Heater - Self-Serviced ... New. Jacuzzi. Security. Supermarket Nearby. Restaurants Nearby. Security Doors. Parking Space. Pop Ceiling. Drainage System. Water Treatment. ...",lekki,0,0,0,1,lekki5,3500000.0,5000000.0,4000000.0,1,48,9,3500000
1682, lafiaji road ikota lekki lagos,9,5,4,5,"The house has a gated compound and all rooms en suite The house comes with: - Quality upscale finishing - 24hours light - 24hours security - Good parking space for cars - and all necessary electrical and plumbing fittings, ready for ... ...",lekki,0,0,0,1,lekki5,3500000.0,5000000.0,4000000.0,1,48,9,3500000
1683, . lekki lagos,6,3,3,3,"Luxury 3 Bedroom Flat with BQ and a gym in a secure gated estate at Alpha Beach, Lekki. For rent at 2m. Service Charge of 600k per annum. ... ...",lekki,0,0,0,1,lekki3,2000000.0,2500000.0,2500000.0,1,38,7,2000000
1684, lekki county ikota lekki lagos,8,4,4,4,"4 BEDROOM DETACHED DUPLEX FOR SALE!!! â€¢ ---------------------------------------- Location: Lekki County, Lekki, Lagos?????? ---------------------------------------- Price: 100M Features: - New - All Ensuite - Swimming pool - CCTV Cameras - Automated Gate - Solar Inverter - Stamp Concrete Floor - In-house Sound System - 1 Boyâ€™s Quarter - ... New. All Room Ensuit. Cctv Cameras. Big Compound. 24 Hours Electricity. Pop Ceiling. 24 Hours Security. ...",lekki,1,1,1,1,lekki4,2500000.0,3500000.0,3000000.0,4,39,7,4300000
1685, lekki phase 2 lekki phase 2 lekki lagos,9,5,4,5,Brand new 4 semi detached duplex for rent in lekki scheme 2 Rent 2m Agency fee 10% Agreement 10% Caution fee 200k Self service ... ...,lekki,0,0,0,1,lekki5,3500000.0,5000000.0,4000000.0,1,48,9,3500000
1686, osapa london lekki lagos,11,6,5,6,*Luxury 5 Bedroom Terrace Duplex For Rent In Osapa London* Location : Osapa London Rent : 3Million Features : Large and interlocked premises Fully fitted kitchen Secured estate Interlocked compound Swimming pool Gym Green area All rooms en ... Jacuzzi. Boys Quater. Security. All Room Ensuit. Big Compound. Gym. Parking Space. 24 Hours Electricity. Swimming Pool. Pop Ceiling. 24 Hours Security. Water Treatment. ...,lekki,0,0,0,0,lekki6,5500000.0,6200000.0,6200000.0,0,54,10,4700000
1687," ikate elegushi, ikate lekki lagos",2,1,1,1,Furnished 1 Bedroom Apartment Features: 24 hours security. 24 hours water and power supply. Flat screen TV . Complimentary DSTV Channels Treated water and Sewage/waste disposal services Free Cleaning services. Modern kitchen + washer dryer Ensuited Bedroom 1 Bathroom - Toilet - ... ...,lekki,0,0,0,0,lekki1,800000.0,1300000.0,1169999.9999999988,0,21,4,400000
1688, vgc lekki lagos,12,7,5,7,4 bedroom semi detached duplex for rent â€¢4 bedrooms â€¢ â€¢all en-suite bedrooms â€¢clean water supply. â€¢partly furnished. â€¢kitchen fully fitted. .oven. Washing machine Microwave and gas cooker Spacious parking Tastefully finished Swimming pool Children play ground CCTV Wi-Fi ... Serviced. New. Furnished. Cheap. Dry. Boys Quater. Cctv Cameras. Big Compound. Free Wifi. Security Doors. 24 Hours Security. Drainage System. Street Lights. Jacuzzi. All Room Ensuit. Supermarket Nearby. Gym. Parking Space. 24 Hours Electricity. Swimming Pool. Pop Ceiling. Children Play Ground. Child Care. Water Treatment. ...,lekki,0,0,0,0,lekki7,6000000.0,6800000.0,6529999.999999999,0,56,10,5500000
1689, fola osibo. lekki phase 1 lekki lagos,13,7,6,7,Nicely Fully detached 6 bedroom duplex all ensuite and fitted with AC's. It's very spacious enough both in and out for the kids and other activity. It has a swimming pool and a 25kva generator ... ...,lekki,1,1,0,1,lekki7,6000000.0,6800000.0,6529999.999999999,3,56,10,6800000
1690, fatai arobike lekki phase 1 lekki lagos,2,1,1,1,Semi brand new mini flat @fatai arobike lekki1 Rent: 1.5m Service: 300k Agency/legal: 10/5% ... ...,lekki,1,1,1,1,lekki1,800000.0,1300000.0,1169999.9999999988,4,21,4,1500000
1691, ikate lekki lagos,8,4,4,4,3 bedroom Flat / Apartment for rent Ikate Lekki Lagos ... New. ...,lekki,1,0,0,1,lekki4,2500000.0,3500000.0,3000000.0,2,39,7,3000000
1692, elegushi ikate lekki lagos,10,5,5,5,"3 bedrooms terrace situated within a secure neighborhood off Kunsela road,Ikate Elegushi, Lekki. Rent: #3mil SC: #500,000 ... New. All Room Ensuit. Parking Space. 24 Hours Electricity. Pop Ceiling. 24 Hours Security. ...",lekki,0,0,0,1,lekki5,3500000.0,5000000.0,4000000.0,1,48,9,3500000
1693, off admiralty road lekki phase 1 lekki lagos,9,5,4,5,Very spacious and lovely available for both residential and commercial ... ...,lekki,1,1,1,1,lekki5,3500000.0,5000000.0,4000000.0,4,48,9,5600000
1694, lekki phase 1 lekki phase 1 lekki lagos,2,1,1,1,Penthouse flat Well secured environment Tarred road Good Proximity ... ...,lekki,1,1,1,1,lekki1,800000.0,1300000.0,1169999.9999999988,4,21,4,1600000
1695, osapa osapa london lekki lagos,2,1,1,1,Clean and Standard Self Con Share Apartment available in a Serene and Secured Estate in Osapa extension/Agungi Lekki Lagos. Features: Standard room with Nice Wardrobe; Serene and cozy environment; fence and gated compound; good road ... ...,lekki,0,0,0,0,lekki1,800000.0,1300000.0,1169999.9999999988,0,21,4,600000
1696," majek after fara park, after crown estate in ajah axis lekki. crown estate ajah lagos",6,3,3,3,"A Very Cool 2 Bedrooms Flat in a secured and gated street in Majek with easy access to the roads, good light, very close to the express road and clean water after Fara Park and ... Cheap. Renovated. Big Compound. Restaurants Nearby. Security Doors. 24 Hours Security. Drainage System. Street Lights. Church Nearby. Security. All Room Ensuit. Supermarket Nearby. Fast Internet. Parking Space. Pop Ceiling. Water Treatment. ...",lekki,0,0,0,0,lekki3,2000000.0,2500000.0,2500000.0,0,38,7,1000000
1697, lbs lekki phase 2 lekki lagos,8,4,4,4,"Newly built 3bedroom flat in an estate, with good security, stable power supply, good water, fitted with kitchen cabinet, wardrobe, all rooms ensuit, with visitors toilet. good road network and secure environment gated estate with ... ...",lekki,0,0,0,0,lekki4,2500000.0,3500000.0,3000000.0,0,39,7,2000000
1698, ikate lekki lagos,7,4,3,4,3 bedroom apartment for rent Location: Ikate Rent: 2.3m My Direct Property ... All Room Ensuit. Big Compound. Parking Space. Pop Ceiling. Water Treatment. ...,lekki,0,0,0,0,lekki4,2500000.0,3500000.0,3000000.0,0,39,7,2300000
1699, lekki lagos,4,2,2,2,Decent 2 bedroom flat for rent in Lekki Well tiled Close to the main road In a clean and secured environment ... ...,lekki,1,1,1,1,lekki2,1500000.0,2000000.0,1700000.0,4,34,6,2000000
1700, ilasan lekki lagos,7,4,3,4,Self serviced apartment with 4 tenants in the compound. Spacious compound with a.Ole parking space ... ...,lekki,0,0,0,0,lekki4,2500000.0,3500000.0,3000000.0,0,39,7,2000000
1701, lekki phase 2 lekki lagos,2,1,1,1,Flat Mates Needed House Type: 3 Bedroom Flat(A ROOM IN A FLAT) FEATURES: - Gated Estate. - All En-Suite Room. - Interlocked Road. - Fitted Kitchen. - Bathtub. LOCATIONChevron Drive Lekki RENT: 650k AGENCY: 10% LEGAL: 10% CAUTION: 10% ... ...,lekki,0,0,0,0,lekki1,800000.0,1300000.0,1169999.9999999988,0,21,4,650000
1702, fola osibo lekki phase 1 lekki lagos,13,7,6,7,Nicely Fully detached 6 bedroom duplex all ensuite and fitted with AC's. It's very spacious enough both in and out for the kids and other activity. It has a swimming pool and a 25kva generator ... ...,lekki,1,1,0,1,lekki7,6000000.0,6800000.0,6529999.999999999,3,56,10,6800000
1703, close to the spar ikate lekki lagos,8,4,4,4,Serviced 3 bedroom with bq and swimming pool with 24/7 power in an estate in ikate. Features include All rooms ensuite Fitted kitchen Guest toilet Balcony Large living area space Large kitchen and bedrooms Swimming pool Gym Facility management office Ample parking space Water treatment plant 24/7 ... ...,lekki,1,0,0,1,lekki4,2500000.0,3500000.0,3000000.0,2,39,7,3000000
1704, agungi lekki lagos,2,1,1,1,"A Mini Flat, A Clean, Nice, Very Spacious standard Apartment, gated and secured compound, gated and secured estate, at Agungi, Lekki, Lagos. Hurry! 1st Pay, 1st Get... Rent:1M Agent:10% Legal:10% Caution:10% Maintenance: For Inquiries, Inspection and Payment, CALL; 08122254648 (suA) ... ...",lekki,0,0,0,1,lekki1,800000.0,1300000.0,1169999.9999999988,1,21,4,1000000
1705, megamound estate ikota lekki lagos,9,5,4,5,"FULLY FURNISHED HOUSE IN MEGAMOUND ESTATE LEKKI FOR LEASE A fully furnished and well equipped 5 bedroom fully detached house in Megamound Estate , Ikota Villa, Lekki is available for rent. Other features include: - 2 large sitting ... Furnished. Dry. Boys Quater. Security. All Room Ensuit. Security Doors. Parking Space. Swimming Pool. Pop Ceiling. Drainage System. Water Treatment. ...",lekki,1,1,1,1,lekki5,3500000.0,5000000.0,4000000.0,4,48,9,5600000
1706, orchid road ikota lekki lagos,8,4,4,4,"FOR RENT!!! â€¢ Detail: 4 Bedroom Terrace Duplex for Rent Location: Orchid, Lekki Price: 3M/p.a â€¢ â€¢ Features: - All Rooms Ensuite - New - Interlocked Floor - Gated Estate - CCTV Cameras - Fitted Kitchen - Pop Ceiling - Security - Inbuilt Speakers ... Serviced. New. Furnished. All Room Ensuit. Big Compound. Parking Space. 24 Hours Electricity. Pop Ceiling. 24 Hours Security. ...",lekki,1,0,0,1,lekki4,2500000.0,3500000.0,3000000.0,2,39,7,3000000
1707, osapa osapa london lekki lagos,7,4,3,4,The apartment is a 3 bedroom Flat located in a serene neighborhood at Osapa London. The property is painted both internally and externally. Ceiling is finished with POP and floor with ceramic tiles. Water is ... Security. All Room Ensuit. Security Doors. Pop Ceiling. Drainage System. Water Treatment. ...,lekki,0,0,0,0,lekki4,2500000.0,3500000.0,3000000.0,0,39,7,2000000
1708, osapa osapa london lekki lagos,11,6,5,6,"Brand New , Well Finished, Fully Detached bedroom 4 Duplex + BQ in a secured estate with a swimming pool. Features: - Spacious living room - CCTV - 2 Car Parking Space Per Duplex - 24/7 Security - Standard Bedroom Space - ... ...",lekki,1,1,0,1,lekki6,5500000.0,6200000.0,6200000.0,3,54,10,6200000
1709, chevron chevron lekki lagos,9,5,4,5,4 Bedrooms +1Bq Semi Detached Duplex At Chevron in a gated estate- ____ RENT: N3.5M(Pay and pack in) Self Serviced. +Self Compound +Fitted Large Kitchen +Intercom +Sound System +DSTV Connection ... ...,lekki,0,0,0,1,lekki5,3500000.0,5000000.0,4000000.0,1,48,9,3500000
1710," ikate elegushi, ikate lekki lagos",7,4,3,4,"Trust me, this is the best apartment for you. Features of the property; Brand new luxury apartment 5 flats in the compound (up and down still available) Enough parking space ( 2 cars per flat) *Person prepaid meter *Osmosis water treatment ... ...",lekki,0,0,0,1,lekki4,2500000.0,3500000.0,3000000.0,1,39,7,2500000
1711, igbo efon lekki lagos,7,4,3,4,Newly Built in a serene environment ... ...,lekki,0,0,0,0,lekki4,2500000.0,3500000.0,3000000.0,0,39,7,2000000
1712, lekki paradise 3 estate chevron lekki lagos,7,4,3,4,"The property is a Newly built built 3 units of 3 bedroom apartments located in Lekki Paradise, Chevron. It is located in a highly secured gated estate. It is painted both internally and externally. Floor ... Serviced. New. 24 Hours Electricity. ...",lekki,0,0,0,1,lekki4,2500000.0,3500000.0,3000000.0,1,39,7,2500000
1713, ikota villa estate ikota lekki ikota lekki lagos,2,1,1,1,Spacious roomself contain with toilet and bath but No kitchen inside Ikota Villa Estate ... Renovated. All Room Ensuit. Security Doors. Pop Ceiling. Water Treatment. ...,lekki,0,0,0,0,lekki1,800000.0,1300000.0,1169999.9999999988,0,21,4,500000
1714, lekki lagos lekki phase 1 lekki lagos,8,4,4,4,"Very spacious 3 bedroom flat with a room Boys quarter, all rooms ensuit, just 4 person in the compound with AC in all the rooms and palor, good power supply, well finished with an adorable ... ...",lekki,0,0,0,1,lekki4,2500000.0,3500000.0,3000000.0,1,39,7,2800000
1715," united estate, sangotedo, ajah axis, lekki. sangotedo ajah lagos",4,2,2,2,"A Very New Mini Flat in a decent, secure and gated United Estate with easy access to the express road, close to the gate, clean water, good light and very close to the road in ... New. Cheap. Big Compound. Restaurants Nearby. Security Doors. 24 Hours Security. Drainage System. Street Lights. Security. All Room Ensuit. Supermarket Nearby. Fast Internet. Parking Space. Pop Ceiling. Water Treatment. ...",lekki,0,0,0,0,lekki2,1500000.0,2000000.0,1700000.0,0,34,6,900000
1716, off osapa agungi lekki lagos,2,1,1,1,"A Room Self Contain, A Clean, Nice, Very Spacious Apartment, (The Living room of a Duplex) A well highly gated and secured compound, gated and secured estate, well structured and very organize, at Osapa, Lekki, Lagos. Fully Serviced. (With Intended ... Serviced. Cheap. Renovated. Security. Supermarket Nearby. Restaurants Nearby. Parking Space. Pop Ceiling. Water Treatment. ...",lekki,0,0,0,1,lekki1,800000.0,1300000.0,1169999.9999999988,1,21,4,850000
1717, orchid road ikota lekki lagos,8,4,4,4,"FOR RENT!!! * * Detail: 4 bedroom semi-detached duplex for rent Location: Orchid, Lekki Price: 3M/p.a â€¢ â€¢ Features: - New - All Rooms Ensuite - Carport - Fitted Kitchen - Pop Ceiling - Clean water - Walk-in Shower - Water Heater ... New. Furnished. All Room Ensuit. Big Compound. Parking Space. 24 Hours Electricity. Pop Ceiling. 24 Hours Security. ...",lekki,1,0,0,1,lekki4,2500000.0,3500000.0,3000000.0,2,39,7,3000000
1718," majek, opposite fara park, in ajah axis lekki. crown estate ajah lagos",4,2,2,2,"A New Mini Flat in a lovely and secured place in Majek with good light, clean water and easy access to the roads opposite Fara Park in Ajah axis Lekki For Rent. ... New. Cheap. Big Compound. Restaurants Nearby. Security Doors. 24 Hours Security. Drainage System. Street Lights. Church Nearby. Security. All Room Ensuit. Supermarket Nearby. Fast Internet. Parking Space. Pop Ceiling. Water Treatment. ...",lekki,0,0,0,0,lekki2,1500000.0,2000000.0,1700000.0,0,34,6,900000
1719," megamound avenue, ikota villa estate lekki lagos",11,6,5,6,"This is a very lovely and well maintained house, it is finished with quality materials and the house is built and designed to give absolute comfort and luxury. RENT PER ANNUM: 3m HOME FEATURES - All Rooms En-suit - ... ...",lekki,0,0,0,0,lekki6,5500000.0,6200000.0,6200000.0,0,54,10,4700000
1720, ibeju lekki lagos,2,1,1,1," room self contain Sharing apartment at Ibeju Lekki Rent: 160,000 Agency: 30,000 Agreement: 30,000 Total: 220,000 The apartment is three bedroom flat with all rooms ensuite So we are renting out the rooms while all the tenants co-share the ... ...",lekki,0,0,0,0,lekki1,800000.0,1300000.0,1169999.9999999988,0,21,4,400000
1721, . lekki phase 1 lekki lagos,8,4,4,4,"Very spacious 3 bedroom flat with all rooms ensuit, upstairs just 2 person in the compound, good power supply, Magnificently finished with an adorable POP and in a Serene environment. it has water heater in ... ...",lekki,0,0,0,1,lekki4,2500000.0,3500000.0,3000000.0,1,39,7,2500000
1722, osapa london lekki lagos,6,3,3,3,"features - big sitting room - Dinning area - big kitchen - fitted kitchen with 6bunner gas vooker , smoke extractor, microwave and oven - master bedroom - all rooms ensuite - top notch pop finishing - spacious master bedroom - wardrobes - showers, ... ...",lekki,0,0,0,0,lekki3,2000000.0,2500000.0,2500000.0,0,38,7,1500000
1723, ikate lekki lagos,10,5,5,5,"NEW LISTING!!! â€¢ â€¢ Detail: 5 bedroom detached duplex for rent Location: Ikate, Lekki Price: 6M/p.a â€¢ â€¢ Features: - New - All Rooms Ensuite - interlocked Floor - Fitted Kitchen - Pop Ceiling - Clean water - Walk-in Shower - Water Heater - Automated Gate - ... New. Furnished. All Room Ensuit. Big Compound. Parking Space. 24 Hours Electricity. Pop Ceiling. 24 Hours Security. ...",lekki,1,1,1,1,lekki5,3500000.0,5000000.0,4000000.0,4,48,9,5600000
1724, victory park osapa london lekki lagos,12,6,6,6,"6 BEDROOM FULLY DETACHED DUPLEX FOR RENT!!! â€¢ Location: Victory Park, Osapa London Price: 7M Features: - New - All Rooms Ensuite - Carport - CCTV Cameras - Fully Fitted Kitchen - Stamped Concrete Floor - Sound System - Security House - Box Room -1 BQ ... Boys Quater. All Room Ensuit. Cctv Cameras. Big Compound. Parking Space. 24 Hours Electricity. Pop Ceiling. 24 Hours Security. ...",lekki,1,1,0,1,lekki6,5500000.0,6200000.0,6200000.0,3,54,10,6200000
1725, lekki phase 1 lekki phase 1 lekki lagos,7,4,3,4,"Lovely built serviced 3bedroom terrace house in lekki phase 1, All rooms are ensuite with a fitted kitchenette and 24hours power supply. Price 4million ... ...",lekki,1,1,1,1,lekki4,2500000.0,3500000.0,3000000.0,4,39,7,4000000
1726, yeye olofin street lekki phase 1 lekki lagos,4,2,2,2,"A lovely spacious serviced mini flat at lekki phase 1,clean water, good road, good light and secured. ... Serviced. Security. All Room Ensuit. Big Compound. Restaurants Nearby. Security Doors. Parking Space. Pop Ceiling. 24 Hours Security. Drainage System. Street Lights. Water Treatment. ...",lekki,1,0,0,1,lekki2,1500000.0,2000000.0,1700000.0,2,34,6,1700000
1727, ikate lekki lagos,4,2,2,2,3 Bedroom Flat For Rent In Ikate ... ...,lekki,1,1,1,1,lekki2,1500000.0,2000000.0,1700000.0,4,34,6,3000000
1728, ikate lekki lagos,8,4,4,4,3 bedroom flat for sale with 1 bq Location: Ikate Lekki Lagos Price: 45m Features: - New - Pop Ceiling - Interlocking - Security - Serviced - Lounge - Fitted Kitchen - Smell Extractor - ... C Of O. ...,lekki,1,1,1,1,lekki4,2500000.0,3500000.0,3000000.0,4,39,7,4300000
1729, osapa osapa london lekki lagos,2,1,1,1,2 bedroom flat at osapa..with just one toilet.. ... ...,lekki,0,0,0,1,lekki1,800000.0,1300000.0,1169999.9999999988,1,21,4,800000
1730, spg road ologolo lekki lagos,2,1,1,1,Two bedroom flat at spg.. ... ...,lekki,1,0,0,1,lekki1,800000.0,1300000.0,1169999.9999999988,2,21,4,1200000
1731, idado estate lekki lagos idado lekki lagos,7,4,3,4,"Tastefully renovated 3 bedroom flat furnished with split A/c, Microwave oven, cooker with 2 balcony, entrance and exit, water treatment , POP ceiling with prepaid meter self serviced. Inside an estate between Idado and ... Renovated. All Room Ensuit. Big Compound. Pop Ceiling. 24 Hours Security. Water Treatment. ...",lekki,0,0,0,0,lekki4,2500000.0,3500000.0,3000000.0,0,39,7,2000000
1732, osapa osapa london lekki lagos,2,1,1,1,Luxurious Bq available at Osapa London. Features Spacious Clean water Power Central generator ... ...,lekki,0,0,0,0,lekki1,800000.0,1300000.0,1169999.9999999988,0,21,4,500000
1733," estate, agungi lekki lagos",2,1,1,1,Nice and Standard Bq Self Con Apartment available in a Serene and Secured Estate in Agungi Lekki Lagos. Features: Standard BQ Room; Serene and cozy environment; fence and gated compound; good road network; good accessibility ... ...,lekki,0,0,0,0,lekki1,800000.0,1300000.0,1169999.9999999988,0,21,4,400000
1734, idado idado lekki lagos,7,4,3,4,"Neat, serviced 3 bedroom flat to rent in Idado, Lekki. All rooms en-suite. Rent: N2,000,000.00 Service Charge: N900,000 P/A (Diesel inclusive) Generator running time - 18hrs Agency and Legal 10% each. ... ...",lekki,0,0,0,0,lekki4,2500000.0,3500000.0,3000000.0,0,39,7,2000000
1735, before blenco supermarket in olokonla in ajah axis lekki. olokonla ajah lagos,6,3,3,3,"A Very Cute 3 Bedrooms Flat in seriously guarded, well gated and quiet Estate with good light, clean water and very close to the road before Blenco Supermarket in Olokonla in Ajah axis Lekki For ... New. Cheap. Big Compound. Restaurants Nearby. Security Doors. 24 Hours Security. Drainage System. Street Lights. Church Nearby. Security. All Room Ensuit. Supermarket Nearby. Parking Space. Pop Ceiling. Water Treatment. ...",lekki,0,0,0,0,lekki3,2000000.0,2500000.0,2500000.0,0,38,7,1000000
1736, ikate lekki lagos,8,4,4,4,"FOR RENT Detail: 4 bedroom terrace duplex for rent Location: Ikate, Lekki Price: 3M/p.a â€¢ â€¢ Features: - New - All Rooms Ensuite - interlocked Floor - Fitted Kitchen - Pop Ceiling - Clean water - Walk-in Shower - Water Heater -Fully serviced ... New. Boys Quater. All Room Ensuit. Cctv Cameras. Big Compound. 24 Hours Electricity. Pop Ceiling. 24 Hours Security. ...",lekki,1,0,0,1,lekki4,2500000.0,3500000.0,3000000.0,2,39,7,3000000
1737, ologolo road ologolo lekki lagos,7,4,3,4,Very lovely units of terraces adorn with top notch finishing in a residential estate ... ...,lekki,0,0,0,1,lekki4,2500000.0,3500000.0,3000000.0,1,39,7,2500000
1738, off admiralty lekki phase 1 lekki lagos,7,4,3,4,"*Self Serviced, Spacious and Cosy 3Bedroom Apartment** *24hours Secured Security on facility. *24hours Cleaners and waste management. *Spacious Car park. *Effective and Efficient power supply. *24hours Facility personnel on standby. *Secured and clean environment. *Spacious and Ventilated rooms. *24hours Cleaners and facility personnel ... Renovated. Big Compound. Street Lights. Security. Parking Space. Pop Ceiling. 24 Hours Security. All Room Ensuit. Security Doors. Water Treatment. ...",lekki,0,0,0,0,lekki4,2500000.0,3500000.0,3000000.0,0,39,7,2200000
1739, orchid road lekki lagos,9,5,4,5,"Brand new newly built fully serviced semi detached + BQ in a serene secure estate environment off Orchid Hotel Road , Lekki 2nd Toll Gate , Lekki , Lagos State . Amenities : Children Play Ground ... Serviced. Dry. New. Big Compound. All Room Ensuit. Gym. Swimming Pool. Water Treatment. Street Lights. Boys Quater. Jacuzzi. Security. Parking Space. Security Doors. Supermarket Nearby. Pop Ceiling. ...",lekki,1,0,0,1,lekki5,3500000.0,5000000.0,4000000.0,2,48,9,4000000
1740," idado ext., agungi lekki lagos",2,1,1,1,"A Room Self Contain, A BQ of a Duplex, (SHARES KITCHEN of the Duplex) A Clean, Nice, highly gated and secured compound, gated and secured estate, well structured and very organize, at Agungi, Lekki, Lagos. Fully Serviced. Hurry! 1st Pay, 1st ... Cheap. Serviced. Supermarket Nearby. Security. Parking Space. Pop Ceiling. Water Treatment. ...",lekki,0,0,0,0,lekki1,800000.0,1300000.0,1169999.9999999988,0,21,4,400000
1741, .. idado lekki lagos,2,1,1,1,"A Room Self Contain, A Newly Built, Upstairs, (With Shared Kitchen or Intended Kitchen Optional) A Clean, Nice, Standard Apartment, highly gated and secured compound, gated and secured estate, well structured and very organize, at Idado, Lekki, Lagos. Fully Serviced. Hurry! 1st Pay, ... Serviced. New. Cheap. Security. Pop Ceiling. Water Treatment. Parking Space. ...",lekki,0,0,0,1,lekki1,800000.0,1300000.0,1169999.9999999988,1,21,4,900000
1742, .. idado lekki lagos,2,1,1,1,"A Room Self Contain, Newly Built, (A SHARED KITCHEN) Upstairs/Downstairs A Clean, Nice, Spacious, Standard Apartment, highly gated and secured compound, gated and secured estate, well structured and very organize, at Idado, after Osapa, before Chevron, Lekki, Lagos. Fully Serviced. Hurry! 1st Pay, ... New. Cheap. Serviced. Pop Ceiling. Water Treatment. Security. Parking Space. ...",lekki,0,0,0,0,lekki1,800000.0,1300000.0,1169999.9999999988,0,21,4,700000
1743," ikota gra, ikota villa ikota lekki lagos",5,3,2,3,"NEWLY AND NEATLY BUILT 2-BEDROOM DUPLEX IN A SERENE NEIGHBORHOOD IN IKOTA GRA, IKOTA VILLA. SPACIOUS SITTING ROOM WITH A VISITORS TOILET. ONLY TWO TENANTS IN THE COMPOUND. NEAT ACCESS ROADS. ... New. Furnished. Dry. Mosques Nearby. Drainage System. Security. Water Treatment. Restaurants Nearby. Security Doors. All Room Ensuit. Supermarket Nearby. Pop Ceiling. Street Lights. Parking Space. Church Nearby. ...",lekki,0,0,0,0,lekki3,2000000.0,2500000.0,2500000.0,0,38,7,1700000
1744, shoprite road osapa london lekki lagos,3,2,1,2,"A Mini Flat, Upstairs/Downstairs, A Clean, Nice, Very Spacious and Standard Apartment, A gated and secured compound, secured estate, well structured and organize, at Shoprite Road, Osapa, Lekki, Lagos. Its an Off Plan. Hurry! 1st Pay, 1st Get... Rent:1.5M Agent:10% Legal:10% Caution:10% Service Charge:360k Per Annum For ... New. Cheap. Serviced. Big Compound. Security. Water Treatment. Parking Space. Supermarket Nearby. Pop Ceiling. ...",lekki,0,0,0,1,lekki2,1500000.0,2000000.0,1700000.0,1,34,6,1500000
1745, atlantic view estate alpha beach road lekki lagos,2,1,1,1,"*For Rent* : _Self contained apartment_ (Studio Penthouse apartment) *very spacious.* It also comes with Inverter so you are guaranteed stable power supply. Location : Atlantic View Estate, Alpha Beach road, Lekki, ... Serviced. Security. 24 Hours Security. Security Doors. All Room Ensuit. ...",lekki,0,0,0,0,lekki1,800000.0,1300000.0,1169999.9999999988,0,21,4,500000
1746, lekki scheme 2 abraham adesanya ogombo road ajah ogombo ajah lagos,5,3,2,3,"Brand new 2 bedroom flat upstairs and downstairs all rooms ensuite, fitted kitchen, water heater bathroom, POP ceiling inside interlocked compound facing interlocked road. ... New. 24 Hours Security. All Room Ensuit. Pop Ceiling. ...",lekki,0,0,0,0,lekki3,2000000.0,2500000.0,2500000.0,0,38,7,1000000
1747, agungi lekki lagos,2,1,1,1,"A Mini Flat, Newly Built, Upstairs/Downstairs available. A Clean, Nice, Standard Apartment, gated and secured compound, gated and secured estate, at Agungi, Lekki, Lagos. Hurry! 1st Pay, 1st Get... Rent:850k Agent:10% Legal:10% Caution:10% Maintenance:150k For Inquiries, Inspection and Payment, CALL; ... New. Cheap. Security. Parking Space. ...",lekki,0,0,0,1,lekki1,800000.0,1300000.0,1169999.9999999988,1,21,4,850000
1748, southern view estate ikota lekki lagos,3,2,1,2,The property is a block of one bedroom and room self-contained apartments. It is located in southern view estate which is very close to the toll gate at Chevron. The ceiling of the rooms are ... New. ...,lekki,0,0,0,0,lekki2,1500000.0,2000000.0,1700000.0,0,34,6,900000
1749, lekki scheme 2 abraham adesanya ogombo road ajah ilaje ajah lagos,7,4,3,4,"Clean 3 bedroom flat upstairs all rooms ensuite, spacious kitchen, spacious sitting room and big rooms, POP ceiling with just 2 people in the compound facing interlocked road. ... Renovated. Cheap. Big Compound. Pop Ceiling. 24 Hours Security. Security Doors. All Room Ensuit. ...",lekki,0,0,0,0,lekki4,2500000.0,3500000.0,3000000.0,0,39,7,2000000
1750, off ayo babatunde street oniru lekki phase 1 lekki lagos,7,4,3,4,"*Fully Serviced, Spacious and Cosy 3Bedroom Apartment Upstairs** *24hours Secured Security on facility. *24hours Cleaners and waste management. *Spacious Car park. *24hours Effective and Efficient Power Supply. *24hours Facility personnel on standby. *Secured and clean environment. *Spacious and Ventilated rooms. *24hours Cleaners and ... Serviced. Renovated. Big Compound. Security. 24 Hours Security. Boys Quater. 24 Hours Electricity. Ocean View. Security Doors. Cctv Cameras. Free Wifi. Water Treatment. Street Lights. Parking Space. Pop Ceiling. Swimming Pool. All Room Ensuit. ...",lekki,1,0,0,1,lekki4,2500000.0,3500000.0,3000000.0,2,39,7,3000000
1751, osapa london lekki lagos,7,4,3,4,3 bedroom Blocks of Flats House for rent Osapa london Lekki Lagos ... ...,lekki,0,0,0,0,lekki4,2500000.0,3500000.0,3000000.0,0,39,7,2000000
1752," oceanbay estate, lafiaji chevron lekki lagos",7,4,3,4,"This is a well fully furnished 3 Bedroom Terrace Duplex with BQ located within oceanbay estate lafiaji, chevron. The estate is secure and family friendly with all basic amenities within the area. Features includes 24hours ... Renovated. All Room Ensuit. Big Compound. 24 Hours Security. Parking Space. Water Treatment. ...",lekki,1,1,1,1,lekki4,2500000.0,3500000.0,3000000.0,4,39,7,4000000
1753, eleganza gardens vgc lekki lagos,7,4,3,4,This is a Serviced 3 Bedroom Apartment in a secured and well planned estate. The apartment comes with a spacious living room with all rooms ensuite. Features include 24 hours power 24 hours security Play ... Serviced. Dry. New. Security Doors. All Room Ensuit. Big Compound. 24 Hours Security. Parking Space. Water Treatment. Security. Pop Ceiling. Street Lights. Supermarket Nearby. 24 Hours Electricity. ...,lekki,0,0,0,0,lekki4,2500000.0,3500000.0,3000000.0,0,39,7,2000000
1754, 12e admiralty way opposite skybox lekki phase 1 lekki lagos,2,1,1,1,"Room come furnished with: Kitchenette (With Microwave & Electric Stove) Queen Bed and Mattress 32"" TV DSTV Small Fridge 2HP Air Conditioner Standing Rechargeable Fan Wall Closet Associated Costs Rent: N1m/Annum Agency: 10% Legal: 10% Service Charge: N200,000 (Inclusive of Water treatment/pumping, security, environmental cleaning, sewage disposal & ... Serviced. Furnished. Cheap. Security. Front Desk Service. Restaurants Nearby. 24 Hours Security. 24 Hours Electricity. Cctv Cameras. All Room Ensuit. Ocean View. Parking Space. Supermarket Nearby. Water Treatment. Free Wifi. Fast Internet. ...",lekki,1,1,1,1,lekki1,800000.0,1300000.0,1169999.9999999988,4,21,4,1300000
1755, 12e admiralty way opposite skybox lekki phase 1 lekki lagos,2,1,1,1,"Room come furnished with: Queen Bed and Mattress 32"" TV DSTV Small Fridge 2HP Air Conditioner Standing Rechargeable Fan Wall Closet Associated Costs Rent: N1m/Annum Agency: 10% Legal: 10% Service Charge: N200,000 (Inclusive of Water treatment/pumping, security, environmental cleaning, sewage disposal & refuse disposal . PHCN: N7,000 Monthly ... Serviced. Furnished. Cheap. Security. Front Desk Service. Restaurants Nearby. 24 Hours Security. 24 Hours Electricity. Cctv Cameras. All Room Ensuit. Ocean View. Parking Space. Supermarket Nearby. Water Treatment. Free Wifi. Fast Internet. ...",lekki,0,0,0,1,lekki1,800000.0,1300000.0,1169999.9999999988,1,21,4,1000000
1756, chevron lekki lagos,10,5,5,5,"4 BEDROOM SEMI-DETACHED DUPLEX FOR RENT! - Chevron, Lekki, Lagos Price: 4M per annum Features: - New - All Rooms Ensuite - Carport - CCTV Cameras - Fully Fitted Kitchen - Stamped Concrete Floor - Sound System - Security House -â€¢â€¢â€¢â€¢â€¢â€¢â€¢â€¢â€¢â€¢â€¢â€¢â€¢â€¢â€¢â€¢â€¢â€¢â€¢â€¢â€¢â€¢â€¢â€¢â€¢â€¢â€¢â€¢â€¢â€¢â€¢â€¢â€¢â€¢â€¢â€¢â€¢â€¢â€¢â€¢â€¢â€¢ For enquiries: ?? 08166553629 ... Furnished. Cheap. Dry. New. Street Lights. Boys Quater. Big Compound. Security Doors. Water Treatment. Restaurants Nearby. Supermarket Nearby. Children Play Ground. 24 Hours Security. Parking Space. Jacuzzi. 24 Hours Electricity. Drainage System. All Room Ensuit. Governor's Consent. Pop Ceiling. Survey. Cctv Cameras. Security. Church Nearby. ...",lekki,1,0,0,1,lekki5,3500000.0,5000000.0,4000000.0,2,48,9,4000000
1757, chevron lekki lagos,10,5,5,5,"4 BEDROOM SEMI-DETACHED DUPLEX FOR RENT! - Chevron, Lekki, Lagos Price: 4M per annum Features: - New - All Rooms Ensuite - Carport - CCTV Cameras - Fully Fitted Kitchen - Stamped Concrete Floor - Sound System - Security House -â€¢â€¢â€¢â€¢â€¢â€¢â€¢â€¢â€¢â€¢â€¢â€¢â€¢â€¢â€¢â€¢â€¢â€¢â€¢â€¢â€¢â€¢â€¢â€¢â€¢â€¢â€¢â€¢â€¢â€¢â€¢â€¢â€¢â€¢â€¢â€¢â€¢â€¢â€¢â€¢â€¢â€¢ For enquiries: ?? 08166553629 ... Furnished. Cheap. Dry. New. Street Lights. Boys Quater. Big Compound. Security Doors. Water Treatment. Restaurants Nearby. Supermarket Nearby. Children Play Ground. 24 Hours Security. Parking Space. 24 Hours Electricity. Drainage System. All Room Ensuit. Governor's Consent. Cctv Cameras. Security. Church Nearby. ...",lekki,1,0,0,1,lekki5,3500000.0,5000000.0,4000000.0,2,48,9,4000000
1758, hi lekki phase 1 lekki lagos,2,1,1,1,Spacious mini flat at lekki 1 rent 1.5m service charge 300k ... Cheap. Serviced. Furnished. Renovated. Fast Internet. Security. 24 Hours Security. Big Compound. All Room Ensuit. Street Lights. Security Doors. Parking Space. Pop Ceiling. ...,lekki,1,1,1,1,lekki1,800000.0,1300000.0,1169999.9999999988,4,21,4,1500000
1759, h lekki phase 1 lekki lagos,2,1,1,1,Lovely spacious mini flat at lekki 1 rent 1.4m served 300k including Napa for a year ... Cheap. Serviced. Furnished. Renovated. Fast Internet. Security. 24 Hours Security. Big Compound. All Room Ensuit. Security Doors. Parking Space. Pop Ceiling. ...,lekki,1,1,1,1,lekki1,800000.0,1300000.0,1169999.9999999988,4,21,4,1400000
1760, lekki phase 1 lekki lagos,11,6,5,6,5 bedroom Terraced Duplex House for rent Lekki Phase 1 Lekki Lagos ... Cheap. Serviced. Dry. Renovated. 24 Hours Security. Supermarket Nearby. 24 Hours Electricity. Street Lights. Cctv Cameras. Water Treatment. Boys Quater. Parking Space. ...,lekki,0,0,0,1,lekki6,5500000.0,6200000.0,6200000.0,1,54,10,6000000
1761, lekki phase 1 lekki lagos,9,5,4,5,4 bedroom Terraced Duplex House for rent Lekki Phase 1 Lekki Lagos ... Serviced. Dry. Renovated. 24 Hours Security. Supermarket Nearby. Big Compound. 24 Hours Electricity. All Room Ensuit. Street Lights. Water Treatment. Boys Quater. ...,lekki,1,1,1,1,lekki5,3500000.0,5000000.0,4000000.0,4,48,9,5600000
1762, lekki phase 1 lekki phase 1 lekki lagos,15,8,7,8,A Lovely Brand New 7 Bedroom Fully Detached Duplex is now available for Rent in Lekki phase 1 with Features; -Well paved and secured compound -Located in a serene neighborhood -Good and accessible road network -All rooms ensuite -1 Room staff ... Security. Swimming Pool. 24 Hours Electricity. Street Lights. Security Doors. Parking Space. 24 Hours Security. Big Compound. All Room Ensuit. Cctv Cameras. Water Treatment. Boys Quater. Gym. ...,lekki,1,1,0,1,lekki8,7000000.0,7000000.0,7000000.0,3,59,10,7000000
1763, off platinum way lekki phase 2 lekki phase 2 lekki lagos,9,5,4,5,"A Brand New 4 Bedroom Terraced Duplex for rent in Lekki . Annual rent #3.5m, Agency 10% of annual rent, Legal 10% of annual rent, Service Charge 400k Total package = # 4,600,000 ... New. ...",lekki,0,0,0,1,lekki5,3500000.0,5000000.0,4000000.0,1,48,9,3500000
1764, chervon alternative road lekki lagos. chevron lekki lagos,12,6,6,6,*Luxury finished 4 Bedroom Fully Detached Duplex with BQ in Eli Court Lekki. Pay and Pack In.* Are you looking for Brand new duplex with bigger sitting room and bigger rooms in a serene location where ... ...,lekki,1,1,0,1,lekki6,5500000.0,6200000.0,6200000.0,3,54,10,6200000
1765," safe court estate ikate,elegushi lekki. ikate lekki lagos",7,4,3,4,"Newly renovated 3bedroom duplex with a room bq, all room ensuit water heater ,bath hub at safe court estate ikate lagos FEATURES INCLUDE ALL ROOMS ENSUITE FITTED KITCHEN GUEST TOILET BALCONY LARGE LIVING AREA SPACE Large Kitchen and Bedrooms SWIMMING POOL GYM FACILITY MANAGEMENT OFFICE AMPLE ... Renovated. ...",lekki,1,0,0,1,lekki4,2500000.0,3500000.0,3000000.0,2,39,7,3000000
1766," safe court estate ikate, elegushi lekki, ikate lekki lagos",7,4,3,4,"Newly renovated 3bedroom duplex with a room bq, all room ensuit water heater ,bath hub at safe court estate ikate lagos FEATURES INCLUDE ALL ROOMS ENSUITE FITTED KITCHEN GUEST TOILET BALCONY LARGE LIVING AREA SPACE Large Kitchen and Bedrooms SWIMMING POOL GYM FACILITY MANAGEMENT OFFICE AMPLE ... ...",lekki,1,0,0,1,lekki4,2500000.0,3500000.0,3000000.0,2,39,7,3000000
1767, horizon 11 estate via meadow hall way. ikate lekki lagos,7,4,3,4,This is a nice and well maintained 3bedroom Flat in a well secured estate. The environment is serene with 24hourd power supply. Power is on pay as you use @ #65/kilowatt. The apartment is on ... Serviced. 24 Hours Security. Swimming Pool. 24 Hours Electricity. Church Nearby. Security Doors. All Room Ensuit. Supermarket Nearby. ...,lekki,0,0,0,1,lekki4,2500000.0,3500000.0,3000000.0,1,39,7,2750000
1768," lekki palm city estate, opposite ecobank ado road ajah lagos ado ajah lagos",5,3,2,3,Two bedrooms penthouse apartment available for rent with parking space and state of the art kitchens cupboard & restrooms at lekki palm city estate lavalon hotel road ajah lagos ... Dry. Security Doors. Restaurants Nearby. Pop Ceiling. Parking Space. Security. Big Compound. Street Lights. ...,lekki,0,0,0,0,lekki3,2000000.0,2500000.0,2500000.0,0,38,7,1400000
1769, off orchid hotel road chevron lekki lagos,9,5,4,5,"4 bedroom semi detached duplex with a BQ in a serene estate off Orchid Hotel Road, Lekki . . Features include: All rooms en-suite and fitted with wardrobes, fitted kitchen with microwave, oven, heat extractor, gas cooker and ... Cheap. New. Boys Quater. Water Treatment. All Room Ensuit. 24 Hours Security. Street Lights. Restaurants Nearby. Pop Ceiling. Church Nearby. Supermarket Nearby. Big Compound. Security. Jacuzzi. Parking Space. Security Doors. Cctv Cameras. Drainage System. ...",lekki,0,0,0,1,lekki5,3500000.0,5000000.0,4000000.0,1,48,9,3500000
1770, 34 agungi road agungi lekki lagos,5,2,3,2,3 bedroom Penthouse Flat / Apartment for rent 34 Agungi Road Agungi Lekki Lagos ... Old. New. 24 Hours Electricity. Parking Space. Excision. C Of O. All Room Ensuit. ...,lekki,1,1,1,1,lekki2,1500000.0,2000000.0,1700000.0,4,34,6,3000000
1771, chief collins lekki phase 1 lekki lagos,3,1,2,1,"Nice Mini Flat To Let @ Chief Collins, off Fola Oshibo, Lekki Phase 1. All round tilled, fitted kitchen, upstairs, constant power supply, clean compound, fenced, gate and water. Located in a serene environment. ... ...",lekki,1,0,0,1,lekki1,800000.0,1300000.0,1169999.9999999988,2,21,4,1200000
1772, oba amusa adebambo avenue agungi lekki lagos,2,1,1,1,"A room in a three bedroom shared apartment is up for a sublet for 5 months. Annual rent is 550,000. Payment of 230,000 would be made from May to September, then a full amount of ... New. All Room Ensuit. ...",lekki,0,0,0,0,lekki1,800000.0,1300000.0,1169999.9999999988,0,21,4,400000
1773," 25, ganiu eletu, street awoyaya eputu ibeju lekki lagos",4,2,2,2,"Attention... The house is just ten pole from the express, brand-new House, two (2) Toilets, Pop finishing, interlocked compound and Kitchen Cabinets. Location: opposite Meridian Gardens Awoyaya by chresol College ... Dry. New. Church Nearby. All Room Ensuit. Parking Space. Survey. Mosques Nearby. Pop Ceiling. Supermarket Nearby. Restaurants Nearby. Big Compound. Water Treatment. Drainage System. Security Doors. ...",lekki,0,0,0,0,lekki2,1500000.0,2000000.0,1700000.0,0,34,6,900000
1774, idado estate idado lekki lagos,5,3,2,3,"This brand new and luxuriosly finished apartment is now renting. For N2.5m annually, the apartment building comes with only 2 apartments in a compound, modern fittings, massive rooms, and safely located in a gated community. Call now. ... New. Pop Ceiling. 24 Hours Security. Security. 24 Hours Electricity. Big Compound. Supermarket Nearby. Parking Space. Drainage System. Water Treatment. All Room Ensuit. Street Lights. Security Doors. Restaurants Nearby. ...",lekki,1,1,0,1,lekki3,2000000.0,2500000.0,2500000.0,3,38,7,2500000
1775, ikate ikate lekki lagos,5,3,2,3,2Bedroom Flat at ikate Lekki Lagos ... All Room Ensuit. Big Compound. Parking Space. Pop Ceiling. Water Treatment. ...,lekki,0,0,0,1,lekki3,2000000.0,2500000.0,2500000.0,1,38,7,2000000
1776," shoprite road, osapa london lekki lagos",2,1,1,1,"A Room Self Contained, (A SHARED KITCHEN) Upstairs, Newly Built, A Clean, Nice, Spacious Apartment, highly gated and secured compound, gated and secured estate, well structured and very organize, at Shoprite Road, Osapa, Lekki, Lagos. Fully Serviced. Hurry! 1st Pay, 1st Get... Rent:750k Agent:10% Legal:10% Caution:10% Service ... Cheap. New. Serviced. Restaurants Nearby. Security Doors. Parking Space. Pop Ceiling. Big Compound. Security. Water Treatment. Supermarket Nearby. ...",lekki,0,0,0,0,lekki1,800000.0,1300000.0,1169999.9999999988,0,21,4,750000
1777, lekki phase 1 lekki phase 1 lekki lagos,2,1,1,1,Standard Mini flat at Lekki Phase 1 ... Parking Space. Pop Ceiling. Water Treatment. ...,lekki,0,0,0,1,lekki1,800000.0,1300000.0,1169999.9999999988,1,21,4,1000000
1778," idado ext., idado lekki lagos",2,1,1,1,"A Room Self Contained, (A SHARED KITCHEN) Upstairs, Newly Built, A Clean, Nice, highly gated and secured compound, gated and secured estate, well structured and very organize, at Agungi, After Osapa, Lekki, Lagos. Fully Serviced. Hurry! 1st Pay, 1st Get... Rent:700k Agent:10% Legal:10% Caution:10% Service Charge:25k Per ... Cheap. New. Serviced. Security. Security Doors. Water Treatment. Pop Ceiling. Parking Space. ...",lekki,0,0,0,0,lekki1,800000.0,1300000.0,1169999.9999999988,0,21,4,700000
1779, .. igbo efon lekki lagos,2,1,1,1,"A Room Self Contain, (A SHARED Kitchen + Living room) Of a 2 Bedroom Flat, Standard, Clean, Nice apartment, gated and secured compound, gate and secured community, well structured and well organize, at Igboefon, Lekki, Lagos. Hurry! Its Pay, ... ...",lekki,0,0,0,0,lekki1,800000.0,1300000.0,1169999.9999999988,0,21,4,400000
1780, shoprite road osapa london lekki lagos,5,3,2,3,Do you love gardens? Then you will love this place. Beautifully Finished and spacious interiors. Kids play area and a serene garden sitout. Well fitted bathrooms with modern facilities. Cabinet fitted kitchen e.t.c Renting for N2m annually and self ... Renovated. Pop Ceiling. 24 Hours Security. Security. Big Compound. Supermarket Nearby. Parking Space. Drainage System. Water Treatment. Children Play Ground. All Room Ensuit. Street Lights. Security Doors. Restaurants Nearby. ...,lekki,0,0,0,1,lekki3,2000000.0,2500000.0,2500000.0,1,38,7,2000000
1781, - igbo efon lekki lagos,3,2,1,2,"A 2 Bedroom Flat, Upstairs, A Clean, Nice, gated and secured compound, gated and secured community, at Igboefon, Before Chevron, Lekki, Lagos. Hurry! 1st Pay, 1st Get... Rent:750k Agent:75k Legal:75k Caution:50k Maintenance: For Inquiries, Inspection and Payment, CALL; [redacted] (suA) ... Cheap. Renovated. Parking Space. Security. ...",lekki,0,0,0,0,lekki2,1500000.0,2000000.0,1700000.0,0,34,6,900000
1782, megamound estate lekki country homes ikota ikota lekki lagos,11,6,5,6,4bedroom Duplex with BQ in Megamond lekki Country Homes ikota. ... Renovated. Furnished. Dry. Security. Boys Quater. Street Lights. Drainage System. Big Compound. All Room Ensuit. Water Treatment. Security Doors. Parking Space. Pop Ceiling. ...,lekki,0,0,0,0,lekki6,5500000.0,6200000.0,6200000.0,0,54,10,4700000
1783, 2nd avenue lekki phase 1 lekki lagos,6,3,3,3,Newly built 3 bedroom flat apartment for rent ... New. All Room Ensuit. Restaurants Nearby. 24 Hours Electricity. Supermarket Nearby. Cctv Cameras. 24 Hours Security. Security. Big Compound. Survey. Church Nearby. Street Lights. Printing Service. Parking Space. Children Play Ground. Security Doors. Water Treatment. ...,lekki,0,0,0,0,lekki3,2000000.0,2500000.0,2500000.0,0,38,7,1800000
1784, 2 avenue lekki phase 1 lekki lagos,8,4,4,4,Newly built 4 bedroom apartment for rent ... New. All Room Ensuit. 24 Hours Electricity. Supermarket Nearby. Mosques Nearby. Cctv Cameras. 24 Hours Security. Security. Big Compound. Survey. Church Nearby. Street Lights. Parking Space. Child Care. Children Play Ground. Security Doors. Water Treatment. ...,lekki,0,0,0,0,lekki4,2500000.0,3500000.0,3000000.0,0,39,7,2000000
1785, .. ologolo lekki lagos,6,3,3,3,Well built and tastefully finished 2bedroom penthouse with nice fittings at ologolo lekki Rent N1.5m pa Sc N200k pa Agency N150k Legal N150k Caution N100k ... Renovated. Children Play Ground. Drainage System. Street Lights. All Room Ensuit. Big Compound. Security. Security Doors. 24 Hours Security. Pop Ceiling. Parking Space. Water Treatment. ...,lekki,0,0,0,0,lekki3,2000000.0,2500000.0,2500000.0,0,38,7,1500000
1786, horizon 11 estate via meadow hall way ikate elegushi. ikate lekki lagos,7,4,3,4,This is an apartment with good proximity to the expressway and in a very secured estate. It is fully serviced with 24/7 power @ pay as you use. The apartment is on the 3rd floor with ... Serviced. Security Doors. Supermarket Nearby. All Room Ensuit. Pop Ceiling. Swimming Pool. 24 Hours Electricity. Children Play Ground. Church Nearby. Parking Space. 24 Hours Security. ...,lekki,0,0,0,1,lekki4,2500000.0,3500000.0,3000000.0,1,39,7,2750000
1787, lekki phase 1 lekki lagos,5,3,2,3,"Nicely built 2 Bedroom flat with a Bq Location: Lekki phase 1, Lekki Price: 2.8million Features: Ample parking space, All room en-suite, Serene environment, easily accessible Kindly contact Michael on +234 810 020 3228 more enquiries MORTGAGE PLANS OF UP ... ...",lekki,1,1,1,1,lekki3,2000000.0,2500000.0,2500000.0,4,38,7,2800000
1788, lekki phase 1 lekki lagos,11,6,5,6,"Nicely built 5 Bedroom semi Detached duplex with a Bq Location: Lekki phase 1, Lekki Price: 6million Features: Ample parking space, All room en-suite, Serene environment, easily accessible Kindly contact Michael on +234 810 020 3228 more enquiries MORTGAGE PLANS ... ...",lekki,0,0,0,1,lekki6,5500000.0,6200000.0,6200000.0,1,54,10,6000000
1789, prince olanrewaju elegushi street ikate lekki lagos,5,3,2,3,"A shared 2 bed, stylish design house at Prince Olanrewaju Elegushi street Quiet, secure area, tarred road Good water, with bathroom heater. Guaranteed 12hr power - 7pm to 7am. Prepaid meter 800k rent 250k service charge ( noted it's a 2bed and ... ...",lekki,0,0,0,0,lekki3,2000000.0,2500000.0,2500000.0,0,38,7,1000000
1790, chevron lekki phase 1 lekki lagos,2,1,1,1,Hello there. Click on me to see more Pictures of this 100% real studio apartment. This Superb single room studio apartment is available for rent at Chevron. Move-in-Ready No works or renovations needed. Air conditioners ...among others ... ...,lekki,0,0,0,1,lekki1,800000.0,1300000.0,1169999.9999999988,1,21,4,800000
1791," ikate elegushi, lekki lagos",2,1,1,1,TO LET: 2 bedroom shared apartment available for rent at Ikate for 800k rent. Service charge of 250k includes generator hours of 7am to 7pm. ... ...,lekki,0,0,0,1,lekki1,800000.0,1300000.0,1169999.9999999988,1,21,4,800000
1792, no 7 bello close chevy view estate chevron lekki lagos,12,6,6,6,"A 5 bedroom detached duplex with swimming pool, gate house & boy's quarters in a serene, cozy & beautiful environment. ... New. Swimming Pool. Parking Space. Drainage System. Security. All Room Ensuit. Security Doors. Boys Quater. Water Treatment. ...",lekki,0,0,0,0,lekki6,5500000.0,6200000.0,6200000.0,0,54,10,5000000
1793, chevron lekki lagos,2,1,1,1,agent and agreement;10% each caution; 5% ... ...,lekki,1,1,1,1,lekki1,800000.0,1300000.0,1169999.9999999988,4,21,4,1500000
1794, chevron lekki lagos,5,3,2,3,agent and agreement; 10% each caution; 5% ... ...,lekki,0,0,0,1,lekki3,2000000.0,2500000.0,2500000.0,1,38,7,2000000
1795," after forte oil before abraham adesanya roundabout, lekki expressway lekki lagos",2,1,1,1,"Now open for lease ; Selfcontained studio flat in a gated and well fensed compound . Features , Spacious kitchen . Fensed compound . Borehole water . Good security . Good electricity . Good proximity . Rent 250k Agent 50k Legal 50k Total 300k ... ...",lekki,0,0,0,0,lekki1,800000.0,1300000.0,1169999.9999999988,0,21,4,400000
1796, lekki phase 1 lekki lagos,4,2,2,2,2 bedroom Flat / Apartment for rent Lekki Phase 1 Lekki Lagos ... ...,lekki,0,0,0,0,lekki2,1500000.0,2000000.0,1700000.0,0,34,6,1200000
1797," main elesekan town road, bogije ibeju lekki lagos",7,4,3,4,This is a large family Home if needed ... ...,lekki,0,0,0,0,lekki4,2500000.0,3500000.0,3000000.0,0,39,7,2000000
1798," victoria bay estate, lafiaji lekki lagos",5,3,2,3,Modern 2 Bedroom terrace duplex in a fully serviced estate with 24hrs power Features include: A fitted kitchen Ample space with top notch lighting 24hrs power A 6 aside football pitch Swimming pool Uniformed security Dstv installed Video doorbell Well interlocked roads Good location Clean central treated ... ...,lekki,1,1,0,1,lekki3,2000000.0,2500000.0,2500000.0,3,38,7,2500000
1799," victoria bay estate, lafiaji lekki lagos",7,4,3,4,Modern 3 Bedroom terrace duplex in a fully serviced estate with 24hrs power Features include: A fitted kitchen Ample space with top notch lighting 24hrs power A 6 aside football pitch Swimming pool Uniformed security Dstv installed Video doorbell Well interlocked roads Good location Clean central treated ... ...,lekki,0,0,0,1,lekki4,2500000.0,3500000.0,3000000.0,1,39,7,2900000
1800," ibrahim odo close, by friend colony gate, off agungi road agungi lekki lagos",9,5,4,5,A brand new wing of 4Bedroom duplex tastefully finished Ground Floor - Living Area - Guest Bedroom - Kitchen - Visitor's toilet Upper Floor - Family Sitting - Master bedroom Ensuite 2Nos. Bedroom Ensuite Ample parking space ... ...,lekki,0,0,0,1,lekki5,3500000.0,5000000.0,4000000.0,1,48,9,3500000
1801, lekki phase 1 lekki lagos,2,1,1,1,"EXCELLENT MINI FLAT FOR RENT LEKKI PHASE 1 OFF ADEBAYO DORHERTY LEKKI PHASE 1 Apartment for rent (Individual & Corporate) Superbly finished , nicely tiled floor with an accessible road network, adequate spacious bedroom and sitting room sizes. located in ... ...",lekki,1,1,1,1,lekki1,800000.0,1300000.0,1169999.9999999988,4,21,4,1900000
1802, lekki phase 1 lekki phase 1 lekki lagos,4,2,2,2,2 bedroom Flat / Apartment for rent Lekki Phase 1 Lekki Phase 1 Lekki Lagos ... ...,lekki,0,0,0,0,lekki2,1500000.0,2000000.0,1700000.0,0,34,6,1200000
1803, agungi agungi lekki lagos,5,3,2,3,Brand new 2bedrm flat in lovely and gated neighbourhood of Agungi. Rent. N1.8m Legal. N180k Agency. N180k ... New. Security Doors. Pop Ceiling. Street Lights. Parking Space. All Room Ensuit. Security. ...,lekki,0,0,0,0,lekki3,2000000.0,2500000.0,2500000.0,0,38,7,1800000
1804, meadow hall way ikate lekki lagos,2,1,1,1,1 Bedroom en-suite apartment for rent ... Serviced. 24 Hours Electricity. 24 Hours Security. Swimming Pool. Parking Space. Fast Internet. Pop Ceiling. ...,lekki,0,0,0,1,lekki1,800000.0,1300000.0,1169999.9999999988,1,21,4,1000000
1805," rdp apartments, beechwood park estate, lekki express way ibeju- lekki eleko ibeju lekki lagos",6,3,3,3,"Fully furnished 3 bedroom apartments at RDP building beechwood park estate, Lakowe Ibeju lekki. + Apartments are fully furnished with * Electric water heater in bathrooms * Tiles in all living spaces * Kitchen cabinets with good countertops * Electric ... New. Furnished. Serviced. 24 Hours Security. C Of O. Parking Space. Water Treatment. All Room Ensuit. Big Compound. Drainage System. ...",lekki,0,0,0,0,lekki3,2000000.0,2500000.0,2500000.0,0,38,7,1000000
1806, palm spring road ikate lekki lagos,6,3,3,3,"Morning Everyone, I am leasing Ericâ€™s place for yearly renting is a 3bedroom at Ikate behind spar on Palm Springs Road Rent & Service Charge :- 5,000,000 Legal 5% :- 250,000 Agency 10% :- 500,000 Note:- ... Furnished. Serviced. Security. ...",lekki,1,1,1,1,lekki3,2000000.0,2500000.0,2500000.0,4,38,7,3500000
1807, by pinnacle filling station lekki phase 1 lekki lagos,11,6,5,6,"5 bedroom detached duplex plus rooms bq, lekki right hand side by pinnacle filling station. Rent 7m ... ...",lekki,1,1,0,1,lekki6,5500000.0,6200000.0,6200000.0,3,54,10,6200000
1808, lake view estate orchid road estate lekki phase 1 lekki lagos,7,4,3,4,This Newly Built 3Bedroom Apartment is located at Lake View 1 Estate it was built in order to make its resident comfortable. Here are some of its unique features: -Glowing Tiles -Special Lightings -Interlocking Pavement -Dazzling Kitchen -Dazzling Bathroom -Dazzling Toilet -Superb ... ...,lekki,0,0,0,1,lekki4,2500000.0,3500000.0,3000000.0,1,39,7,2500000
1809, bakare estate agungi lekki lagos,2,1,1,1,"Mini flat with 1 bedroom, dining room, and a sitting room @ Bakare Estate Agungi. N650K per year excluding agent and agreement. Call or WhatsApp me on 0-7-0-3-0-9-5-4-3-7-6 for inspection ... ...",lekki,0,0,0,0,lekki1,800000.0,1300000.0,1169999.9999999988,0,21,4,650000
1810, ologolo lekki lagos,9,5,4,5,Rent 2.8m Agency 10% Legal 5% Caution....100 ... Cheap. Old. New. Security. Big Compound. Water Treatment. Boys Quater. All Room Ensuit. Security Doors. Street Lights. 24 Hours Security. ...,lekki,0,0,0,1,lekki5,3500000.0,5000000.0,4000000.0,1,48,9,3500000
1811, ikota ikota lekki lagos,9,5,4,5,Rent 2.7m Agency 10% Legal 5% Caution ...... ... New. Security. Big Compound. Water Treatment. Parking Space. Boys Quater. All Room Ensuit. C Of O. Security Doors. Street Lights. Cctv Cameras. 24 Hours Security. Pop Ceiling. ...,lekki,0,0,0,1,lekki5,3500000.0,5000000.0,4000000.0,1,48,9,3500000
1812, off fola osibo lekki phase 1 lekki lagos,7,4,3,4,"Lovely 3 Bedroom apartments, located in a serene neighborhood, off Fola Osibo, Lekki phase 1 Features: Spacious rooms and Living room All rooms en suite, well furnished toilets and bath Located within serene environment Fitted kitchen Spacious Compound and more..! ... ...",lekki,0,0,0,1,lekki4,2500000.0,3500000.0,3000000.0,1,39,7,2700000
1813," earls court, ikate elegushi ikate lekki lagos",10,5,5,5,"*To let* 4 bedroom duplex at Earls Court All rooms en-suite, with Ac, water heater, guest toilet, Maid Room. 24/7 hours light Swimming pool Estate mall Security. Gated estate. Soccer astro turf & children play ground Two Squash courts, Panasonic A/c in all rooms, Gym Well laid ... ...",lekki,1,1,1,1,lekki5,3500000.0,5000000.0,4000000.0,4,48,9,5600000
1814, hakeem dickson lekki phase 1 lekki lagos,2,1,1,1,Renovated miniflat bq with tiles carpark fitted kitchen cabinet wardrobe etc Hakeem dickson Lekki phase 1 going for 1million naira.service charge 200k ... Renovated. Security. Street Lights. Security Doors. ...,lekki,0,0,0,1,lekki1,800000.0,1300000.0,1169999.9999999988,1,21,4,1000000
1815," chevron drive, chevron lekki lagos",2,1,1,1,"TO LET: Shared selfcon available at Bera estate, chevron for 600k. Total 770k. ... ...",lekki,0,0,0,0,lekki1,800000.0,1300000.0,1169999.9999999988,0,21,4,600000
1816, lekki phase 1 lekki phase 1 lekki lagos,5,3,2,3,"Apartment for rent ( Individual & Corporate) Superbly finished , nicely tiled floor Quality Interior with an accessible road network, DRAINAGE NETWORK adequate bedroom and sitting room sizes. located in a very serene environment Adorned with top-notch finishing Nice Cozy Room ... ...",lekki,1,1,0,1,lekki3,2000000.0,2500000.0,2500000.0,3,38,7,2500000
1817," ikate elegushi, ikate lekki lagos",2,1,1,1,"I bedroom Miniflat flat at ikate elegushi lekki lagos for rent. Well fitted kitchen, security, and treated water. Price; 32000000 ... ...",lekki,1,1,1,1,lekki1,800000.0,1300000.0,1169999.9999999988,4,21,4,2000000
1818, adiva estate ibeju lekki lagos,6,3,3,3,"Brand New 2befrom Bungalow with 2hrs light, all rooms En suit, nice Kitchen Cabinet, Wardrobes in all rooms, good road network and P. O. P Finishing is available for rent in Adiva Estate well secured ... ...",lekki,0,0,0,0,lekki3,2000000.0,2500000.0,2500000.0,0,38,7,1000000
1819, adiva estate ibeju lekki lagos,6,3,3,3,"Brand New 2befrom Bungalow with 2hrs light, all rooms En suit, nice Kitchen Cabinet, Wardrobes in all rooms, good road network and P. O. P Finishing is available for rent in Adiva Estate well secured ... ...",lekki,0,0,0,0,lekki3,2000000.0,2500000.0,2500000.0,0,38,7,1000000
1820, olanrewaju elegushi street ilasan lekki lagos,5,3,2,3,A shared space in a semi furnished and stylish apartment. Just behind The Elevation Church. ... New. Drainage System. Security. Water Treatment. Parking Space. All Room Ensuit. Street Lights. 24 Hours Security. ...,lekki,0,0,0,0,lekki3,2000000.0,2500000.0,2500000.0,0,38,7,1000000
1821, ologolo lekki lagos,9,5,4,5,6 units of 4 bedroom semi-detached duplex with BQ available for quick rent in Ologolo by domino's pizza Lekki Rent 2.7M Service Charge 150k/yearly ... Cheap. New. All Room Ensuit. 24 Hours Security. Boys Quater. Water Treatment. ...,lekki,0,0,0,1,lekki5,3500000.0,5000000.0,4000000.0,1,48,9,3500000
1822, ologolo lekki lagos,9,5,4,5,6 units of 4 bedroom semi-detached duplex with BQ available for quick rent in Ologolo by domino's pizza Lekki Rent 2.7M Service Charge 150k/yearly ... Cheap. New. Big Compound. All Room Ensuit. 24 Hours Security. Water Treatment. Street Lights. ...,lekki,0,0,0,1,lekki5,3500000.0,5000000.0,4000000.0,1,48,9,3500000
1823, located at ikota villa estate behind mega chicken ikota lekki lagos,9,5,4,5,"A Luxury and massive 4bedroom Terrace Duplex + BQ with an Executive Rooms with wardrobes,,water heater,,full p.o.p,,cross ventilated,,Massive master bedroom + Jacuzzi,, Massive and fully fitted kitchen with all kitchen equipment,, security house,,BQ,,Large living room ... New. Furnished. Water Treatment. Supermarket Nearby. Pop Ceiling. Boys Quater. 24 Hours Security. Street Lights. Security. Restaurants Nearby. Security Doors. All Room Ensuit. Big Compound. Jacuzzi. Parking Space. ...",lekki,0,0,0,1,lekki5,3500000.0,5000000.0,4000000.0,1,48,9,3500000
1824," eric's place, behind spar on palm springs road ikate lekki lagos",7,4,3,4,"Morning Everyone, I am leasing Eric's place for yearly renting is a 3bedroom at Ikate behind spar on Palm Springs Road Rent & Service Charge :- 5,000,000 Legal 5% :- 250,000 Agency 5% :- 250,000 Total Package = 5,500,000 Note:- ... ...",lekki,1,1,1,1,lekki4,2500000.0,3500000.0,3000000.0,4,39,7,4300000
1825, agungi agungi lekki lagos,4,2,2,2,2 bedroom Flat / Apartment for rent Agungi Agungi Lekki Lagos ... ...,lekki,0,0,0,0,lekki2,1500000.0,2000000.0,1700000.0,0,34,6,1200000
1826," ikate elegushi, ikate lekki lagos",7,4,3,4,"Service charge N500,000 & Monthly diesel deposit 50,000 generator time 7pm to 7am daily Apartment for rent ( Individual & Corporate) Superbly finished , nicely tiled floor with an accessible road network, adequate bedroom and sitting room sizes. located in ... ...",lekki,0,0,0,0,lekki4,2500000.0,3500000.0,3000000.0,0,39,7,2300000
1827," lakowe lakes and country homes (golf resort), lakowe ibeju lekki lagos",9,5,4,5,"Well built and spacious 4 Bedroom Terrace house with a Study in the very peaceful, serene Lakowe Lakes Golf & Country Estate. Features: Ground Floor: Laundry room, foyer, Guest convenience, patio, courtyard, living room , dining , ... ...",lekki,0,0,0,1,lekki5,3500000.0,5000000.0,4000000.0,1,48,9,3500000
1828," off george enenmoh street, lekki phase 1 lekki lagos",2,1,1,1,Spacious miniflat upstairs with balcony to let off George enenmoh street lekki phase one. Rent 1m Service charge 250k including phcn Agent and legal fees 10%/5% respectively. ... ...,lekki,0,0,0,1,lekki1,800000.0,1300000.0,1169999.9999999988,1,21,4,1000000
1829," ikate elegushi, ikate lekki lagos",8,4,4,4,. ... ...,lekki,0,0,0,0,lekki4,2500000.0,3500000.0,3000000.0,0,39,7,2000000
1830, lekki phase 1 lekki phase 1 lekki lagos,9,5,4,5,Are you on business trip or on holiday/honeymoon in Lagos? Are you thinking of a comfortable lifestyle and flawless environment? Then experience haven in our short let apartment in Lekki Phase 1. Each room is ... ...,lekki,0,0,0,1,lekki5,3500000.0,5000000.0,4000000.0,1,48,9,3500000
1831, ikota ikota lekki lagos,9,5,4,5,"Uniquely finished duplex with good access road and excellent drainage network in ikota villa estate We can also be contacted if u have a property to sell, rent or lease. ... ...",lekki,0,0,0,1,lekki5,3500000.0,5000000.0,4000000.0,1,48,9,3500000
1832, off adekunle kuye adelabu lekki lagos,2,1,1,1,"A clean and decent 2bedroom apartment upstairs with constant water, parking space, tiles, prepaid, etc. ... Renovated. Big Compound. 24 Hours Security. ...",lekki,0,0,0,1,lekki1,800000.0,1300000.0,1169999.9999999988,1,21,4,1000000
1833," muri sodiq drive, off spg road, lekki lekki phase 1 lekki lagos",7,4,3,4,"This is meant for only those who love SPACE and classy finish!!! Now Renting... 3 Bedroom flat on Muri Sodiq Drive, off SPG road. The pictures says it all. Living room is massive, the master Bedroom is ... Serviced. New. Water Treatment. Drainage System. All Room Ensuit. Supermarket Nearby. Security. Cctv Cameras. 24 Hours Security. ...",lekki,0,0,0,1,lekki4,2500000.0,3500000.0,3000000.0,1,39,7,2800000
1834, prince kazeem eletu street osapa london osapa london lekki lagos,2,1,1,1,"very nice and clean environment and we have other options at chevron area, shevy view, idado estate, agungi, lekkipenninsula phase 1 ... ...",lekki,0,0,0,0,lekki1,800000.0,1300000.0,1169999.9999999988,0,21,4,500000
1835, road 6 blook 56 chevron lekki lagos,2,1,1,1,very nice within a serene environment free from noise and pollution ... Dry. New. ...,lekki,0,0,0,0,lekki1,800000.0,1300000.0,1169999.9999999988,0,21,4,650000
1836, okera-nla lekki ajah lagos ado ajah lagos,2,1,1,1,Newly Renovated Mini Flat ... Dry. Renovated. 24 Hours Electricity. Church Nearby. Fast Internet. 24 Hours Security. Street Lights. Water Treatment. ...,lekki,0,0,0,0,lekki1,800000.0,1300000.0,1169999.9999999988,0,21,4,400000
1837," ocean bay estate, lekki peninsula 2 lekki phase 2 lekki lagos",8,5,3,5,"The property is located at ocean bay estate, Lekki Penninsula 2, and is made up of three floors. The penthouse consists of a 3 bedroom luxury penthouse apartment with an outdoor balcony jacuzzi, patio lounge, ... New. Serviced. Restaurants Nearby. Parking Space. Water Treatment. Street Lights. 24 Hours Electricity. Drainage System. Boys Quater. Supermarket Nearby. C Of O. Fast Internet. All Room Ensuit. Jacuzzi. Ocean View. 24 Hours Security. Security. Church Nearby. ...",lekki,0,0,0,1,lekki5,3500000.0,5000000.0,4000000.0,1,48,9,3500000
1838, agungi agungi lekki lagos,2,1,1,1,Well furnished 4 units of 3bedroom apartment available for rent. Location: Agungi Rent 1.2m For Rent: Selfcon 3bedapartment 4bed apartment ... Renovated. Dry. Cheap. Furnished. Fast Internet. Drainage System. Church Nearby. Supermarket Nearby. 24 Hours Security. Big Compound. Security. Restaurants Nearby. Water Treatment. ...,lekki,1,0,0,1,lekki1,800000.0,1300000.0,1169999.9999999988,2,21,4,1200000
1839," off oladimeji alo street, lekki phase 1 lekki lagos",2,1,1,1,"A compact 1 Bedroom Self Contain in a serene and easily accessible area at Lekki Phase 1, Lekki. The apartment has a room, Toilet/Bathroom and Kitchen. The premises is well paved with ample parking space. There is clean ... ...",lekki,0,0,0,0,lekki1,800000.0,1300000.0,1169999.9999999988,0,21,4,600000
1840," off oladimeji alo street, lekki phase 1 lekki lagos",2,1,1,1,"A compact 1 Bedroom Self Contain in a serene and easily accessible area at Lekki Phase 1, Lekki. The apartment has a room, Toilet/Bathroom and Kitchen. The premises is well paved with ample parking space. There is clean ... ...",lekki,0,0,0,0,lekki1,800000.0,1300000.0,1169999.9999999988,0,21,4,600000
1841, orchid estate ologolo lekki lagos,2,1,1,1,Looking for a lovely 1 bedroom self contained Apartment for short stay. This cozy self con is just perfect with 24 hours power and top notch services. Apartment is located in ologolo lekki lagos. Coming in at a ... ...,lekki,0,0,0,0,lekki1,800000.0,1300000.0,1169999.9999999988,0,21,4,400000
1842, lekki lekki phase 1 lekki lagos,2,1,1,1,"This s a brand new serviced one roomself contain well furnished with ur private generator, gas cooker, DStv, refrigerator, and lot more this house s fully equipped with features 2, make a great stay ... ...",lekki,0,0,0,0,lekki1,800000.0,1300000.0,1169999.9999999988,0,21,4,400000
1843," ikota, lekki lekki lagos",5,3,2,3,"This s a brand new serviced 2bedroom flat with A/C ND gas cooker, inverter 24 hours uninterrupted power supply and lots more. this house s fully equipped with features 2 make a great stay. ... ...",lekki,0,0,0,0,lekki3,2000000.0,2500000.0,2500000.0,0,38,7,1600000
1844, osapa osapa london lekki lagos,9,5,4,5,"Beautiful home located in one of the most serene neighborhoods in Osapa London, stone throwaway from The Circle mall . This beautiful Duplex boast spacious rooms and living room, well finished to taste with modern ... ...",lekki,1,1,1,1,lekki5,3500000.0,5000000.0,4000000.0,4,48,9,5000000
1845, gra ikota lekki lagos,9,5,4,5,"Tastefully finished 4 Bedroom Terraced duplex with all room ensuite at Ikota GRA, Lekki ... ...",lekki,1,1,1,1,lekki5,3500000.0,5000000.0,4000000.0,4,48,9,5600000
1846, lagasa rd oribanwa ibeju lekki lagos,2,1,1,1,Well maintained one bedroom flat in a good neighborhood ... ...,lekki,0,0,0,0,lekki1,800000.0,1300000.0,1169999.9999999988,0,21,4,400000
1847," shapati, bogije ibeju lekki lagos",5,3,2,3,Well built to taste 2bedroom flat in serene location. All room ensuit with wardrobes and kitchen cabinet Rent 400k Agency 40k Legal 40k ... ...,lekki,0,0,0,0,lekki3,2000000.0,2500000.0,2500000.0,0,38,7,1000000
1848, lekky county estate ikota lekki lagos,10,5,5,5,"4Bedroom semi detached duplex for sale with BQ @ Ikota Estate , Lekki Rent:3m Features: - - All Rooms Ensuite - New - Interlocking floor - Security - Pop Ceiling -Fitted Kitchen - sitting room - packing lot etc ----------------------------- ... ...",lekki,0,0,0,1,lekki5,3500000.0,5000000.0,4000000.0,1,48,9,3500000
1849, new road/alfa beach road lekki lagos,2,1,1,1,"A cute mini flat, in a fenced compound ... ...",lekki,0,0,0,0,lekki1,800000.0,1300000.0,1169999.9999999988,0,21,4,400000
1850, agungi lekki lagos,7,4,3,4,"A 3 bedroom apartment in secure estate in Agungi, Lekki. On the market for rent at 1.8m. For Enquiries Call 09061557176 08165920863 Email info@crescohomes.com Website www.crescohomes.com ... ...",lekki,0,0,0,0,lekki4,2500000.0,3500000.0,3000000.0,0,39,7,2000000
1851, .. ikate lekki lagos,7,4,3,4,"This is a well maintained and spacious 3bedroom available in Ikate presently being renovated. It is very accessible. with good power supply. Rent plus service charge is 2m, agency and legal is 300k. You are ... Renovated. Cheap. Dry. Drainage System. C Of O. Supermarket Nearby. Street Lights. Restaurants Nearby. Swimming Pool. All Room Ensuit. 24 Hours Security. Church Nearby. Parking Space. Water Treatment. Big Compound. ...",lekki,0,0,0,0,lekki4,2500000.0,3500000.0,3000000.0,0,39,7,2000000
1852, - lekki phase 1 lekki lagos,5,3,2,3,"2 Bedroom Flat in a Clean House at Lekki Phase 1, for 1.7 million ... ...",lekki,0,0,0,0,lekki3,2000000.0,2500000.0,2500000.0,0,38,7,1700000
1853, jakande jakande lekki lagos,2,1,1,1,. ... ...,lekki,1,1,1,1,lekki1,800000.0,1300000.0,1169999.9999999988,4,21,4,1300000
1854, agungi lekki lagos,2,1,1,1,Luxury mini flat for rent at Agungi Rent 1.1m Agency 10% Legal 10% Caution 120k SC: 250k ... New. ...,lekki,0,0,0,1,lekki1,800000.0,1300000.0,1169999.9999999988,1,21,4,1100000
1855, .. ikate lekki lagos,6,3,3,3,Self service 3 bedroom en-suite flat for rent at Ikate Rent 1.7m Agency 10% Legal 10% Caution 100k Every necessary renovation/repairs will be done by the landlord before a new occupant take possession upon payment of rent. ... New. ...,lekki,0,0,0,0,lekki3,2000000.0,2500000.0,2500000.0,0,38,7,1700000
1856, idado idado lekki lagos,8,4,4,4,Luxury 3bedroom flat with BQ Located in a secured serene environment . . Features : All room ensuite BQ Very spacious living room . Spacious room space Treated water Water heater . ........................................................ Price - #2.5M per annum ... ...,lekki,0,0,0,1,lekki4,2500000.0,3500000.0,3000000.0,1,39,7,2500000
1857, agungi agungi lekki lagos,5,3,2,3,"Brand new two bedroom serviced apartment with Fully fitted kitchen, air condition, and dstv..in a a well serene environment.. ... New. Serviced. ...",lekki,0,0,0,1,lekki3,2000000.0,2500000.0,2500000.0,1,38,7,2000000
1858, directly off fola osibo lekki phase 1 lekki lagos,12,6,6,6,Finely finished wing of duplex for commercial use located in a nice location suitable for any firm or organization ... Dry. Renovated. Big Compound. Boys Quater. ...,lekki,1,1,0,1,lekki6,5500000.0,6200000.0,6200000.0,3,54,10,6200000
1859, gbo efon igbo efon lekki lagos,7,4,3,4,. ... ...,lekki,0,0,0,0,lekki4,2500000.0,3500000.0,3000000.0,0,39,7,2000000
1860, chevron drive lekki phase 2 lekki lagos,12,6,6,6,"very neat 5bedroom terrace duplex on 3floors with spacious rooms in a well secured Estate,Chevron drive Price:5million Agency: 10% ... ...",lekki,0,0,0,0,lekki6,5500000.0,6200000.0,6200000.0,0,54,10,5000000
1861, idado estates idado lekki lagos,7,4,3,4,Sercice charge of 800k with 12 hours power supply ... ...,lekki,0,0,0,0,lekki4,2500000.0,3500000.0,3000000.0,0,39,7,2000000
1862, osapa osapa london lekki lagos,9,5,4,5,FOR RENT: Luxury 4bedroom detached duplex with a room BQ at Osapa london lekki. FEATURES: - All rooms en-suite - Fitted kitchen - Air condition - Prepaid meter - Ensuit BQ - Generator - Solar pannel ... ...,lekki,1,0,1,1,lekki5,3500000.0,5000000.0,4000000.0,3,48,9,4500000
1863, osapa osapa london lekki lagos,11,6,5,6,FOR RENT: Brand new spacious and luxury fitted 5bedroom detached duplex with a room BQ at Osapa. ... ...,lekki,0,0,0,0,lekki6,5500000.0,6200000.0,6200000.0,0,54,10,4700000
1864, - lekki lagos,10,5,5,5,To let a fully serviced 5 Bedroom Penthouse @ Oniru Estate. Price - 6m ... New. Parking Space. Big Compound. Restaurants Nearby. All Room Ensuit. Supermarket Nearby. ...,lekki,1,1,1,1,lekki5,3500000.0,5000000.0,4000000.0,4,48,9,5600000
1865, lekki county estate ikota lekki lagos,6,3,3,3,"It a tastefully built apartment to your delight, located in a decent estate of Lekki county. this apartment enjoys the following: Good access road, 24hrs power supply, spacious compound, Provision of water, maximum security, surveillance camera, ... Serviced. New. Dry. All Room Ensuit. Parking Space. Security. Security Doors. Drainage System. Supermarket Nearby. Big Compound. Pop Ceiling. Cctv Cameras. 24 Hours Electricity. Water Treatment. 24 Hours Security. ...",lekki,1,1,0,1,lekki3,2000000.0,2500000.0,2500000.0,3,38,7,2730000
1866, orchid road victoria crest estate lekki lagos,10,5,5,5,Lovely Estate Interlock road Workable to d express road Big compound and interlock Environment Pop finishing Big palour and dining space Big kitchen with store & lovely cabinet Big rooms with jacuzzi bathtub All rooms ensuit Big wardrobes Water heater Study rooms Nice compound Personal prepaid meter ... ...,lekki,0,0,0,1,lekki5,3500000.0,5000000.0,4000000.0,1,48,9,3500000
1867," bakare estate, in a gated secured estate agungi lekki lagos",5,3,2,3,. ... ...,lekki,0,0,0,0,lekki3,2000000.0,2500000.0,2500000.0,0,38,7,1600000
1868, osapa osapa london lekki lagos,7,4,3,4,"TO LET: Luxury 3Bedroom terrace by osapa London, Lekki, Lagos. DESCRIPTION: This is a tastefully finished super luxury brand new 3bedroom terrance built with lovely and superb finishing that speaks of luxury. The property was deliberately built ... ...",lekki,1,0,0,1,lekki4,2500000.0,3500000.0,3000000.0,2,39,7,3000000
1869," orchid, lafiaji lekki lagos",9,5,4,5,A 4 bedrooms Semi Detached Duplex with BQ in a 24hours power Estate for Rent: *Location: Orchid Road *Rent:.3m and 2.8m *Caution: 100k *Service charge: 30k monthly * Legal: 10% *Agency: 10% * Electricity: 24 hours * Close to Lekki expressway ... ...,lekki,0,0,0,1,lekki5,3500000.0,5000000.0,4000000.0,1,48,9,3500000
1870, osapa osapa london lekki lagos,6,3,3,3,Serviced 3 bedroom terrace duplex with a room bq ... ...,lekki,1,1,0,1,lekki3,2000000.0,2500000.0,2500000.0,3,38,7,2500000
1871, agungi lekki lagos,7,4,3,4,"A serviced 3 bedroom apartment in a gated estate in Agungi, Lekki. On the market for rent at 2m. For Enquiries Call [redacted] Email [redacted] Website www.crescohomes.com ... Serviced. 24 Hours Security. Parking Space. Big Compound. ...",lekki,0,0,0,0,lekki4,2500000.0,3500000.0,3000000.0,0,39,7,2000000
1872, lafiaji lekki lagos,9,5,4,5,Uniquely finished services duplex with swimming pool located on a well tarred road with excellent drainage network system. Other Features include -24Hour security -Water treatment facility -Proper internal space arrangement -Spacious and en suite rooms -Quality movable wardrobes -Spacious living rooms up ... ...,lekki,0,0,0,1,lekki5,3500000.0,5000000.0,4000000.0,1,48,9,3500000
1873, chevron chevron lekki lagos,5,3,2,3,"Serviced 2 bedroom flat at chevron Rooms are spacious and ensuite. Fitted kitchen and ample parking space. Rent is 1.8m Service charge 550k covers diesel deposit, security, waste and treatment of water. Agency 10% Legal 5% Caution 100k ... ...",lekki,0,0,0,0,lekki3,2000000.0,2500000.0,2500000.0,0,38,7,1800000
1874, ologolo ologolo lekki lagos,6,3,3,3,Very clean 3 bedroom flat at ologolo. 2 in a compound. Rooms are spacious with wardrobe. Fitted kitchen. Rent is 1m Agency 10% Legal 10% Caution 100 Total package is 1.3m ... ...,lekki,0,0,0,0,lekki3,2000000.0,2500000.0,2500000.0,0,38,7,1000000
1875, off castle and temp drive lekki lekki phase 1 lekki lagos,7,4,3,4,"Fortified with top notch Fittings and spacious rooms, this beautiful 3 Bedrooms maisonette is up for lease nested in a posh and serene environment in lekki phase 1. Home is located in a mini estate, well ... ...",lekki,1,1,1,1,lekki4,2500000.0,3500000.0,3000000.0,4,39,7,4300000
1876, off omorire johnson lekki phase 1 lekki lagos,9,5,4,5,This specious 4 bedroom duplex has 2 rooms detached bq All the rooms are en-suite with extra visitor's toilet The kitchen is fitted with modern kitchen wares All the rooms has wardrobes already fitted It has a large compound ... ...,lekki,1,1,1,1,lekki5,3500000.0,5000000.0,4000000.0,4,48,9,5600000
1877, ikate lekki lagos,8,4,4,4,4 bedroom Detached Duplex House for rent Ikate Lekki Lagos ... Cheap. Renovated. Security Doors. Security. Jacuzzi. Street Lights. Parking Space. Cctv Cameras. Boys Quater. Big Compound. Drainage System. 24 Hours Security. Pop Ceiling. All Room Ensuit. ...,lekki,1,1,1,1,lekki4,2500000.0,3500000.0,3000000.0,4,39,7,4000000
1878, off admirality way lekki phase1 lekki phase 1 lekki lagos,7,4,3,4,IDEAL FOR CORPORATE OFFICE Brand new 3bedroom semi detached to let Directly off Admirality way lekki phase1. Rent. N4.5m Agency. N450k Legal. N450k Caution. N200k ... New. Cheap. Security Doors. Pop Ceiling. Supermarket Nearby. Restaurants Nearby. Big Compound. Street Lights. Parking Space. Security. ...,lekki,1,1,1,1,lekki4,2500000.0,3500000.0,3000000.0,4,39,7,4300000
1879, in a well secured estate ikota lekki lagos,5,3,2,3,"Newly built 2bedroom flats with spacious rooms and compound, fitted kitchen, partly furnished with Ac, all rooms Ensuite plus guest toilet, interlocking floor etc Note : is a service apartments Rent:1.6m Agency:10% Legal: 10% Call: [redacted] ... New. Pop Ceiling. Security Doors. Restaurants Nearby. All Room Ensuit. Big Compound. Parking Space. Children Play Ground. ...",lekki,0,0,0,0,lekki3,2000000.0,2500000.0,2500000.0,0,38,7,1600000
1880, 117 opebi road ikeja agungi lekki lagos,3,2,1,2,1 bedroom mini flat Self Contain Flat / Apartment for rent 117 Opebi road ikeja Agungi Lekki Lagos ... Furnished. Renovated. Serviced. Cheap. New. Jacuzzi. Water Treatment. Parking Space. Children Play Ground. Security. Mosques Nearby. Restaurants Nearby. Street Lights. Elevator. 24 Hours Electricity. Supermarket Nearby. Gym. Cctv Cameras. Pop Ceiling. Boys Quater. Swimming Pool. Security Doors. Big Compound. All Room Ensuit. 24 Hours Security. ...,lekki,0,0,0,0,lekki2,1500000.0,2000000.0,1700000.0,0,34,6,1200000
1881, elegushi lekki phase 1 lekki lagos,8,4,4,4,Exquisitely Furnished with Modern Material in an Ecological Environment with 24 hours Security ... New. Security. Jacuzzi. 24 Hours Electricity. All Room Ensuit. Parking Space. Big Compound. 24 Hours Security. ...,lekki,0,0,0,1,lekki4,2500000.0,3500000.0,3000000.0,1,39,7,2500000
1882, lekki phase 1 lekki lagos,10,5,5,5,"Exquisitely Furnished with foreign material, Located at a good Environment with 24 hours Security ... New. Boys Quater. Drainage System. 24 Hours Electricity. All Room Ensuit. Children Play Ground. ...",lekki,0,0,0,1,lekki5,3500000.0,5000000.0,4000000.0,1,48,9,3500000
1883, lekki phase 1 lekki phase 1 lekki lagos,12,6,6,6,FOR RENT!!! - Detail: 5 Bedroom Detached Duplex for Rent! Location: Lekki Phase 1 Price: N15m Features: - All Rooms Ensuite - Swimming Pool - 1 Boy's Quarter - Big Compound - Water treatment - CCTV Cameras - Bathtub - Interlocked floor - Refrigerator - Fitted Kitchen - Air Conditioners - Security ... ...,lekki,1,1,0,1,lekki6,5500000.0,6200000.0,6200000.0,3,54,10,6200000
1884, jakande jakande lekki lagos,9,5,4,5,"TO LET Note : Only corporate tenant pls, married person preferably) Fully serviced with 24hours power 4bedroom terrace with bq available at Valley stream Estate, Jakande/Shopright road. Facilities; gym, pool, club house, event space, top notch security, cctv, ... ...",lekki,0,0,0,1,lekki5,3500000.0,5000000.0,4000000.0,1,48,9,3500000
1885, lekki lekki phase 1 lekki lagos,11,6,5,6, 1) Brand new luxury 5bedroom detached house with 2 rooms boys quarter. 2) 2 living rooms. 3)Sufficient parking space. 4)Spacious rooms and master bedroom. 5) All rooms ensuite. 6) Prime location. 7) Access to good road network. 8) Gate house. 9) Bullet proof ... ...,lekki,1,1,0,1,lekki6,5500000.0,6200000.0,6200000.0,3,54,10,6200000
1886, ... chevron lekki lagos,8,4,4,4,"Lekki - 4bedroom attached @ ChevyView estate, Chevron Lekki. Fully Furnished - N4.5m Basic: N3.5m ... New. ...",lekki,1,1,1,1,lekki4,2500000.0,3500000.0,3000000.0,4,39,7,4300000
1887, 6th avenue eletu osapa london osapa london lekki lagos,12,6,6,6,It's a spacious and secured duplex in a lovely estate in osapa London ... New. Furnished. Drainage System. Jacuzzi. All Room Ensuit. Cctv Cameras. Water Treatment. Parking Space. Big Compound. Pop Ceiling. ...,lekki,0,0,0,0,lekki6,5500000.0,6200000.0,6200000.0,0,54,10,5000000
1888, gabriel okoi street ikate lekki lagos,7,4,3,4,3 Bedroom Flat in a nice and serene environment of spring Bay Estate off Freedom Way behind Prime Water view Estate ... Renovated. Serviced. Parking Space. Pop Ceiling. Street Lights. Water Treatment. All Room Ensuit. Big Compound. Security. ...,lekki,0,0,0,0,lekki4,2500000.0,3500000.0,3000000.0,0,39,7,2300000
1889," off admiralty way, lekki phase 1,1 lekki phase 1 lekki lagos",2,1,1,1,Newly renovated Simple and stylish In a serene premises Open kitchen design Clean water 90% PHCN power supply ... ...,lekki,1,1,1,1,lekki1,800000.0,1300000.0,1169999.9999999988,4,21,4,1500000
1890, maruwa lekki phase 1 lekki lagos,9,5,4,5,"Well finished 3 bedroom Terrace Duplex with Boysquater at Marwa Well finished , Al rooms ensuite, Generator, cleaning, security ... ...",lekki,1,0,0,1,lekki5,3500000.0,5000000.0,4000000.0,2,48,9,4000000
1891, behind elevation church ilasan lekki lagos,9,5,4,5,"*TO LET: 4 BEDROOM SEMI DETACHED DUPLEX* DUPLEX FEATURES Brand new, beautiful & exquisitely built 4 nos of 4 bedroom semi detached duplex with ensuite maid's room, Garden lounge/Gym/Play area Installed kitchen appliances Fitted wardrobes Custom kitchen cabinetry 3 car slots per ... ...",lekki,0,0,0,1,lekki5,3500000.0,5000000.0,4000000.0,1,48,9,3500000
1892, chevyview estate chevron lekki lagos,6,3,3,3,"*Luxury 12 units of 3 bedroom Terrace House + bq on 3 floors* facilities includes *Air-conditioning, washing machine, swimming pool, Generator, security, ample parking space* at Chevyview Estate,Â  Rent- #3m pa each call SDIL [redacted], [redacted] ... ...",lekki,1,1,1,1,lekki3,2000000.0,2500000.0,2500000.0,4,38,7,3000000
1893, .. osapa london lekki lagos,7,4,3,4,Admirable 3bedroom flat @ osapa london Rent. 2m Caution fee. 100k Legal 10% Agency. 10% ... Old. Parking Space. Big Compound. All Room Ensuit. ...,lekki,0,0,0,0,lekki4,2500000.0,3500000.0,3000000.0,0,39,7,2000000
1894, .. osapa london lekki lagos,9,5,4,5,Appealing 4bedroom duplex with a BQ @ osapa london Rent. 3m Cation fee. 250k Agency. 10% Legal. 10% Payment are negotiable ... Serviced. Parking Space. Big Compound. Boys Quater. All Room Ensuit. ...,lekki,0,0,0,1,lekki5,3500000.0,5000000.0,4000000.0,1,48,9,3500000
1895, osapa osapa london lekki lagos,4,2,2,2,"A brand new 2 bedroom apartment for rent. Spacious living room with a guest toilet. Large rooms ensuute with wardrobes Ample parking space Serene and nice neighbourhood. Rent: 2.5m per annum Service charge ; 300,000 for general serviced excluding power ( ... ...",lekki,1,1,1,1,lekki2,1500000.0,2000000.0,1700000.0,4,34,6,2500000
1896, horizon 2 lekki gardens ikate lagos ikate lekki lagos,10,5,5,5,Brand New Luxury 5 Bedroom Semi Detached Duplex ... Furnished. New. Security. Parking Space. Church Nearby. Pop Ceiling. Street Lights. Big Compound. ...,lekki,1,1,1,1,lekki5,3500000.0,5000000.0,4000000.0,4,48,9,5000000
1897, lafiaji lekki phase 1 lekki lagos,9,5,4,5,This property is surely one of the best located in a serene environment at the best market rate. It is built with top notch finishing. Features are: *Ample parking space *Fitted kitchen *glass showers *security *closet *car port ... ...,lekki,0,0,0,1,lekki5,3500000.0,5000000.0,4000000.0,1,48,9,3500000
1898, divine estate lekki phase 1 lekki lagos,4,2,2,2,"Well furnished 2bedroom apartment for yearly rent... it's equipped with 24hrs Unlimited internet, Room have their individual Tv, Ac, DStv, Bed, Wardrobes, bathroom and toilet ... and electricity is very good in this area... all ... ...",lekki,1,1,1,1,lekki2,1500000.0,2000000.0,1700000.0,4,34,6,2500000
1899, chevy view alternative route vgc lekki lagos,10,5,5,5,. ... ...,lekki,1,0,0,1,lekki5,3500000.0,5000000.0,4000000.0,2,48,9,4000000
1900, jakande lekki lagos,2,1,1,1,"Readily available for salon,restuarants,fashion house,kiddies store Nd mny more Call 07059908894 ... Furnished. Cheap. New. Serviced. Water Treatment. 24 Hours Electricity. Security Doors. Church Nearby. Pop Ceiling. Fast Internet. 24 Hours Security. Security. Supermarket Nearby. Governor's Consent. Office Supplies. Parking Space. Children Play Ground. Big Compound. Front Desk Service. Drainage System. ...",lekki,1,0,0,1,lekki1,800000.0,1300000.0,1169999.9999999988,2,21,4,1200000
1901," lafiaji, lekki lagos",9,5,4,5,This property is surely one of the best located in a serene environment at the best market rate. It is built with top notch finishing. Features are: *Ample parking space *Fitted kitchen *glass showers *security *closet *car port ... ...,lekki,0,0,0,1,lekki5,3500000.0,5000000.0,4000000.0,1,48,9,3500000
1902," kazeem eletu way osapa london, osapa london lekki lagos",11,6,5,6,Newly renovated 5 bedroom detached duplex with a room bq on Kazeem Eletu Way @ Osapa London ... ...,lekki,0,0,0,0,lekki6,5500000.0,6200000.0,6200000.0,0,54,10,4700000
1903," second lekki toll gate, orchid lekki phase 2 lekki lagos",8,4,4,4,"TO LET @ SECOND LEKKI TOLL GATE , ORCHID lovely 4 bedroom semi detached duplex with a bq fully serviced with 24hrs power supply, Gym, swiming pool and kids play ground Rent 4.2m legal 5% caution 250k service ... Serviced. New. Boys Quater. Swimming Pool. 24 Hours Electricity. Children Play Ground. Gym. ...",lekki,1,1,1,1,lekki4,2500000.0,3500000.0,3000000.0,4,39,7,4200000
1904, lekki phase 1 lekki phase 1 lekki lagos,11,6,5,6,Nicely built 5 bedroom luxury detached duplex with 2 rooms bqand a fitted kitchen with all rooms ensuite with a big compound located in a serene environment around lekki phase 1 is up for rent ... ...,lekki,1,1,0,1,lekki6,5500000.0,6200000.0,6200000.0,3,54,10,6200000
1905," lafiaji, lekki lagos",10,6,4,6,"5 bedroom Flat / Apartment for rent Lafiaji, Lekki Lagos ... ...",lekki,0,0,0,0,lekki6,5500000.0,6200000.0,6200000.0,0,54,10,4700000
1906, horison court ikate lekki lagos,3,2,1,2,"Fully furnished 1bedroom terrace for rent at Horison Court (lekki garden) ikate elegushi for N1.8m... just 1year rent Service charge:N350,000 Power N200,000 including diesel Features.... Washing machine Fridge Dstv Dinning table..etc ... ...",lekki,1,0,0,1,lekki2,1500000.0,2000000.0,1700000.0,2,34,6,1800000
1907, - ikota lekki lagos,9,5,4,5,"4Bedroom Semi detached Duplex with a built in Boy's Quarter at West End Estate beside Lekky County Homes, Ikota, Lekki. ... Boys Quater. All Room Ensuit. ...",lekki,0,0,0,1,lekki5,3500000.0,5000000.0,4000000.0,1,48,9,3500000
1908, spring bey estate off freedom way lekki phase 1 lekki lagos,11,6,5,6,"Trust me, this is the best apartment for you. Features of the property; Brand new luxury apartment Fully detached Duplex Fully furnished Enough parking space *Person prepaid meter *Osmosis water treatment plant *Water heaters *Spacious bedrooms with standard wardrobe *all interior fittings is American standard. *Spacious ... ...",lekki,0,0,0,0,lekki6,5500000.0,6200000.0,6200000.0,0,54,10,4700000
1909," adegbenle street, chevy view estate, chevron drive, lekki osapa london lekki lagos",9,5,4,5,To Let: This is a Mini Estate in Chevy View Estate. There are well crafted 12 x Units of warm & airy 4 bedroom terrace houses on 3 floors. The ground floor is beautiful laid ... ...,lekki,0,0,0,1,lekki5,3500000.0,5000000.0,4000000.0,1,48,9,3500000
1910, osapa osapa london lekki lagos,9,5,4,5,Lovely 4 bedroom Terrace Duplex with Massive Sized subletable BQ of half a million naira valued. BREAKDOWN: Annual Rent - N 2.7m (net). Caution - 10% of Annual Rent. Professional Fee (Agency) - 10%. Legal Fee (Agreement) - 5%. Service Charge ... ...,lekki,0,0,0,1,lekki5,3500000.0,5000000.0,4000000.0,1,48,9,3500000
1911, lekki county estate lekki lekki phase 1 lekki lagos,9,5,4,5,"Luxury 4 Bedroom Detached Duplex with room bq for rent Location: Lekki County Homes, Lagos Price: 4.5 m per annum For two years 4m per annum Features: All Ensuite Fully Fitted Kitchen CCTV Cameras 24 hrs Security Jacuzzi 1 Boyâ€™s Quarter Stamp Concrete Floor In-house sound systems Pop ... ...",lekki,1,0,1,1,lekki5,3500000.0,5000000.0,4000000.0,3,48,9,4500000
1912," friends colony estate, agungi agungi lekki lagos",9,5,4,5,"TO LET 4Bedroom SEMI-DETACHED with BQ all rooms ensuite at Friends Colony, Estate Lekki Lagos ... Renovated. Serviced. Supermarket Nearby. 24 Hours Electricity. Boys Quater. 24 Hours Security. Street Lights. Water Treatment. Security Doors. ...",lekki,0,0,0,1,lekki5,3500000.0,5000000.0,4000000.0,1,48,9,3500000
1913," friends colony, agungi axis agungi lekki lagos",9,5,4,5,"4 Bedrooms Semi-Detach, Good Lightening system and security ... Renovated. Serviced. Supermarket Nearby. 24 Hours Electricity. Boys Quater. 24 Hours Security. Cctv Cameras. Street Lights. Parking Space. Water Treatment. ...",lekki,0,0,0,1,lekki5,3500000.0,5000000.0,4000000.0,1,48,9,3500000
1914, ikate elegushi ikate lekki lagos,7,4,3,4,"Trust me, this is the best apartment for you. Features of the property; Brand new luxury apartment 5 flats in the compound (up and down still available) Enough parking space ( 2 cars per flat) *Person prepaid meter *Osmosis water treatment ... ...",lekki,0,0,0,1,lekki4,2500000.0,3500000.0,3000000.0,1,39,7,2500000
1915, . lekki phase 1 lekki lagos,9,5,4,5,"A Luxury self serviced 4bedroom terrace Duplex with a room BQ, good finishing, big rooms, big compound for car pack and proper drainage systems in lekki phase1 and all tenant come with their generator. ... ...",lekki,1,0,0,1,lekki5,3500000.0,5000000.0,4000000.0,2,48,9,4000000
1916, lekki chevron lagos chevron lekki lagos,10,5,5,5, Brand new 5 bedroom fully detached duplex Well finished with quality interior. Ample parking space. Treated water. Fully fitted kitchen. High profile neighborhood. Tight security. Good road and drainage network. Good title document. ... Cheap. New. Serviced. Furnished. Security Doors. 24 Hours Security. 24 Hours Electricity. All Room Ensuit. Security. Big Compound. Water Treatment. ...,lekki,0,0,0,1,lekki5,3500000.0,5000000.0,4000000.0,1,48,9,3500000
1917," beside earl court, ikate elegushi, lagos state ikate lekki lagos",9,5,4,5, ????Super environment ????Giant Sized sitting room & bedrooms ????Highly Detailed Finishing ????No BQ ????Highly Secured Call-to-enter Estate ????Installed CCTV on the house in and out ????play area of kids ????car port ????fully serviced service charge is 380 ... New. Serviced. Dry. Security. Water Treatment. Parking Space. Supermarket Nearby. Restaurants Nearby. Drainage System. Mosques Nearby. Pop Ceiling. Church Nearby. Fast Internet. Survey. 24 Hours Security. Cctv Cameras. Street Lights. All Room Ensuit. Children Play Ground. Security Doors. 24 Hours Electricity. ...,lekki,1,0,0,1,lekki5,3500000.0,5000000.0,4000000.0,2,48,9,4000000
1918, orchid road lekki phase 1 lekki lagos,11,6,5,6,"Newly built spacious 5 Bedroom apartment located in a secure and serene environment for rent,Southern view estate, Eleganza B/stop , lekki Lagos. TEL; 09059926686 EMAIL; Ibitolulope@gmail.com ... New. Furnished. 24 Hours Electricity. ...",lekki,0,0,0,0,lekki6,5500000.0,6200000.0,6200000.0,0,54,10,4700000
1919, maruwa lekki lagos,9,5,4,5,"Nice 4 bedroom maisonette in a Serene Neighbour all ensuit, with two living rooms ... Restaurants Nearby. Security. Big Compound. All Room Ensuit. ...",lekki,0,0,0,1,lekki5,3500000.0,5000000.0,4000000.0,1,48,9,3500000
1920, orchid road chevron lekki lagos,9,5,4,5,4 Bedroom Duplex for Rent ... New. ...,lekki,0,0,0,1,lekki5,3500000.0,5000000.0,4000000.0,1,48,9,3500000
1921, chevron lekki lagos,8,5,3,5,4bedroom duplex in chevron 3.8m is d yearly due around chevron drive lekki ... Furnished. Dry. Parking Space. Big Compound. Pop Ceiling. Water Treatment. Drainage System. Security. Security Doors. Supermarket Nearby. Street Lights. All Room Ensuit. ...,lekki,0,0,0,1,lekki5,3500000.0,5000000.0,4000000.0,1,48,9,3800000
1922, the grantham estate lekki phase 2 lekki lagos,9,5,4,5,4 bedroom Mini flat Flat / Apartment for rent The Grantham estate Lekki Phase 2 Lekki Lagos ... Serviced. 24 Hours Security. ...,lekki,0,0,0,1,lekki5,3500000.0,5000000.0,4000000.0,1,48,9,3500000
1923, ilasan lekki lagos,6,3,3,3,3 bedroom Penthouse Flat / Apartment for rent Ilasan Lekki Lagos ... New. Furnished. Pop Ceiling. ...,lekki,0,0,0,1,lekki3,2000000.0,2500000.0,2500000.0,1,38,7,2200000
1924, emcel court ikota gra lekki ikota lekki lagos,11,5,6,5,Newly built 4bedroom semi detached duplex for rent in a fully Serviced estate and in a serene neighborhood. Water Treatment facility 24hrs light 24hrs security CCTV cameras Video door bell Ample parking space Fully kitted kitchen ... New. Security. Children Play Ground. Gym. 24 Hours Electricity. Water Treatment. Street Lights. Parking Space. Supermarket Nearby. Drainage System. Church Nearby. Boys Quater. Big Compound. Restaurants Nearby. All Room Ensuit. 24 Hours Security. Security Doors. Cctv Cameras. Child Care. ...,lekki,0,0,0,1,lekki5,3500000.0,5000000.0,4000000.0,1,48,9,3500000
1925, ikate lekki lagos,6,3,3,3,"2 bedroom massionette for rent in Richmond gate estate ikate, with 24 hours light. Rent is 2.5m per annum Features 24 hours light Swimming pool 24 hours security Fitted kitchen Spacious room Gym house Estate supermarket A room ... ...",lekki,1,1,0,1,lekki3,2000000.0,2500000.0,2500000.0,3,38,7,2500000
1926, osapa london lekki lagos,11,6,5,6," Brand new and well finished 5 bedroom fully detached duplex with bq. All rooms ensuite and kitchen well fitted Location: Osapa London, Lekki Rent: 4m Agency: 10% Legal fee: 5% Caution fee: 150k Total: 4,750,000 ... New. Parking Space. Pop Ceiling. Boys Quater. ...",lekki,0,0,0,0,lekki6,5500000.0,6200000.0,6200000.0,0,54,10,4700000
1927, bera estate chevron lekki lagos,11,6,5,6," Spacious 5 bedroom detached duplex with bq Car park: 7 cars Rent: 3.5m Agency: 10% Legal fee: 10% Location: Bera estate, off Chevron Drive ... Parking Space. Water Treatment. Pop Ceiling. Boys Quater. Jacuzzi. ...",lekki,0,0,0,0,lekki6,5500000.0,6200000.0,6200000.0,0,54,10,4700000
1928, admiralty road lekki phase 1 lekki phase 1 lekki lagos,11,6,5,6,"Property Description 5bedroom duplex, with 2 room bq along admiralty way lekki phase1 is available for lease... Owner is open to demolishing and reconstruction if need be. 15m/annum minimum 5 years. 08032443481 WhatsApp 08125935182 ... Renovated. Parking Space. Supermarket Nearby. Security Doors. Water Treatment. Office Supplies. All Room Ensuit. Boys Quater. Drainage System. Big Compound. C Of O. Street Lights. Security. Pop Ceiling. Jacuzzi. Restaurants Nearby. ...",lekki,1,1,0,1,lekki6,5500000.0,6200000.0,6200000.0,3,54,10,6200000
1929, chief augustine anozie lekki phase 1 lekki lagos,3,1,2,1,A 4-room ground-floor flat/office space situated in Lekki Phase 1 is up for lease. Tenant is free to make alterations to the flat as long as they have been pre-approved by the owner. Situated in ... Renovated. Old. Pop Ceiling. Supermarket Nearby. Parking Space. All Room Ensuit. Security Doors. Mosques Nearby. Church Nearby. 24 Hours Security. 24 Hours Electricity. Big Compound. Restaurants Nearby. C Of O. ...,lekki,1,1,1,1,lekki1,800000.0,1300000.0,1169999.9999999988,4,21,4,2000000
1930, chief augustine anozie lekki phase 1 lekki lagos,7,2,5,2,A fully detached 7-bedroom house situated in Lekki Phase 1 is up for long lease. Situated in prime location with very close proximity to Admiralty Way; secure area. Entire compound is 864 sq meters in ... Old. Renovated. 24 Hours Security. Drainage System. Security Doors. Pop Ceiling. C Of O. Parking Space. Big Compound. Church Nearby. Supermarket Nearby. 24 Hours Electricity. Security. Restaurants Nearby. All Room Ensuit. Mosques Nearby. ...,lekki,1,1,1,1,lekki2,1500000.0,2000000.0,1700000.0,4,34,6,3000000
1931, chesachi hani-okoroafor close lekki phase 1 lekki lagos,13,7,6,7,"4 bedroom duplex with 2 self contained BQs located on Chesachi Hani-okoroafor close , lekki phase 1, Lagos. (Available for Commercial long lease) Features: * All Rooms En-suite. * A waiting room with visitor's toilet. * Massive Master's bedroom * ... ...",lekki,0,0,0,0,lekki7,6000000.0,6800000.0,6529999.999999999,0,56,10,5500000
1932," bogije along lekki/epe express way ,lagos lacampaigne tropicana ibeju lekki lagos",6,3,3,3,"VANTAGE COURT, BOGIJE Why continue to pay rent to Lagos Landlords when you can pay for your own house? YES! With Vantage Court, you can RENT TO OWN with mortgage facility that allows you spread payment ... New. Furnished. Cheap. Street Lights. C Of O. Water Treatment. All Room Ensuit. Excision. Supermarket Nearby. Drainage System. Cctv Cameras. Child Care. Parking Space. 24 Hours Security. Big Compound. Governor's Consent. Boys Quater. 24 Hours Electricity. Children Play Ground. Survey. Security. ...",lekki,1,1,1,1,lekki3,2000000.0,2500000.0,2500000.0,4,38,7,3500000
1933, ajah lekki gardens estate ajah lagos,10,5,5,5,"Very clean, conducive ... New. Cheap. Dry. Supermarket Nearby. Drainage System. Pop Ceiling. Water Treatment. Street Lights. Restaurants Nearby. 24 Hours Electricity. Child Care. Security Doors. Big Compound. Cctv Cameras. Security. Free Wifi. All Room Ensuit. Front Desk Service. 24 Hours Security. Free Coffee. Fast Internet. Church Nearby. Jacuzzi. Parking Space. ...",lekki,1,1,1,1,lekki5,3500000.0,5000000.0,4000000.0,4,48,9,5600000
1934," chevron, lekki, lagos chevron lekki lagos",9,5,4,5,"4 bedroom Terraced Duplex House for rent Chevron, Lekki, Lagos chevron Lekki Lagos ... New. Security. All Room Ensuit. 24 Hours Electricity. Cctv Cameras. ...",lekki,0,0,0,1,lekki5,3500000.0,5000000.0,4000000.0,1,48,9,3500000
1935," ologolo street, off lekki epe express, by dominos agungi. lekki lagos agungi lekki lagos",11,6,5,6,"Newly Built fully serviced 4 bedroom Semi Detached + 1 bedroom BQ at Atlantis 2 Estate on Ologolo Road by Agungi off Dominos, Lekki Epe Express. Lagos ... New. Cheap. Serviced. All Room Ensuit. Security. Child Care. Printing Service. Governor's Consent. Mosques Nearby. Pop Ceiling. Drainage System. Boys Quater. Cctv Cameras. Office Supplies. Swimming Pool. Big Compound. Water Treatment. Restaurants Nearby. Church Nearby. Jacuzzi. Survey. Supermarket Nearby. Gym. Fast Internet. 24 Hours Electricity. Children Play Ground. Security Doors. 24 Hours Security. Parking Space. Front Desk Service. Street Lights. ...",lekki,0,0,0,0,lekki6,5500000.0,6200000.0,6200000.0,0,54,10,4700000
1936, ologolo road agungi lekki lagos,9,5,4,5,Newly Built fully serviced 4 bedroom Terrace and BQ at Atlantis 2 Estate on Ologolo Road by Agungi off Dominos ... New. Cheap. Serviced. All Room Ensuit. Security. Child Care. Printing Service. Governor's Consent. Mosques Nearby. Pop Ceiling. Drainage System. Boys Quater. Cctv Cameras. Swimming Pool. Big Compound. Water Treatment. Restaurants Nearby. Church Nearby. Jacuzzi. Survey. Supermarket Nearby. Gym. Fast Internet. 24 Hours Electricity. Children Play Ground. Security Doors. 24 Hours Security. Parking Space. Front Desk Service. Street Lights. ...,lekki,0,0,0,1,lekki5,3500000.0,5000000.0,4000000.0,1,48,9,3500000
1937," mayfair garden estate, awoyaya eputu ibeju lekki lagos",7,4,3,4,Lovely built three bedrooms flat in an estate ... Furnished. New. Children Play Ground. Supermarket Nearby. 24 Hours Electricity. Drainage System. Security. Parking Space. Church Nearby. Pop Ceiling. All Room Ensuit. Restaurants Nearby. Street Lights. Big Compound. 24 Hours Security. Water Treatment. ...,lekki,0,0,0,0,lekki4,2500000.0,3500000.0,3000000.0,0,39,7,2000000
1938, marwa lekki phase 1 lekki lagos,9,5,4,5,"It's located in a beautiful mini estate in Lekki Phase 1 by Pinnacle filling station. Fully serviced with a pool, gym and a lounge. The Service Charge goes for 2m, it covers everything including 24hours ... Serviced. New. Pop Ceiling. 24 Hours Security. Gym. Street Lights. Swimming Pool. All Room Ensuit. Boys Quater. Water Treatment. 24 Hours Electricity. Security Doors. ...",lekki,1,0,0,1,lekki5,3500000.0,5000000.0,4000000.0,2,48,9,4000000
1939, university view estate opposite lagos business school off lekki epe expressway ajah lagos,2,1,1,1,"Tastefully furnished 1 Bedroom Mini Flat for Rent at University View Estate Opp Lagos Business School, AJAH. Rent : 500k Agency: 50k Legal: 50k Caution deposit: 50k Service charge: 50k Total: 700k ... ...",lekki,0,0,0,0,lekki1,800000.0,1300000.0,1169999.9999999988,0,21,4,500000
1940,  obawole area ifako ogba ogba lagos,6,3,3,3,"Brand new executive 2bedroom flat with luxury fittings and lovely interior plus prepaid meter and adequate car park. 3 toilets, modern tiles with wardrobe and kitchen cabinet. Fenced with gate and water. no landlord in ... Cheap. Dry. New. Drainage System. Water Treatment. Security Doors. Big Compound. All Room Ensuit. Parking Space. 24 Hours Security. ...",ogba,0,0,0,0,ogba3,650000.0,780000.0000000001,750000.0,0,15,3,500000
1941, obawole area ifako ogba ogba lagos,2,1,1,1,Decent room with modern facilities suitable for a working class tenant or young couple. Fenced with gate and water. no landlord in ccompound. Come and inspect today. Send someone if you don't have time. Form ... Cheap. Renovated. Drainage System. Water Treatment. Street Lights. Supermarket Nearby. Parking Space. Restaurants Nearby. ...,ogba,0,0,0,0,ogba1,250000.0,380000.0,300000.0,0,3,1,120000
1942,  obawole area ifako ogba ogba lagos,5,3,2,3,Brand new executive and tastefully furnished flat with luxury fittings in a secured location at obawole. Fenced with gate and water with car park and resident gateman Come and inspect today. Send someone if you ... Furnished. New. Drainage System. Water Treatment. Security Doors. Security. Pop Ceiling. Street Lights. Big Compound. All Room Ensuit. Supermarket Nearby. Parking Space. 24 Hours Security. ...,ogba,0,0,0,1,ogba3,650000.0,780000.0000000001,750000.0,1,15,3,650000
1943,  off college road ifako ogba ogba lagos,4,2,2,2,decent mini flat at an affordable rate in a secured location at ogba. Fenced with gate and water with car park. Come and inspect today. Send someone if you don't have time. Form fee is ... Cheap. Dry. Renovated. Water Treatment. Big Compound. Parking Space. Restaurants Nearby. ...,ogba,0,0,0,0,ogba2,550000.0,650000.0,625000.0,0,13,3,400000
1944,  at obawole area ifako ogba ogba lagos,2,1,1,1,Decent flat with modern facilities suitable for a working class tenant or young couple. Fenced with gate and water. Come and inspect today. Send someone if you don't have time. Form fee is compulsory for ... Cheap. Renovated. Drainage System. Water Treatment. Big Compound. Supermarket Nearby. Parking Space. 24 Hours Security. ...,ogba,0,0,0,0,ogba1,250000.0,380000.0,300000.0,0,3,1,200000
1945,  college road ifako ogba ogba lagos,2,1,1,1,decent selfcontained room at at an affordable rate in a good location at ogba. Fenced with gate and water with car park. Come and inspect today. Send someone if you don't have time. Form fee ... Cheap. Renovated. Drainage System. Water Treatment. Security. Supermarket Nearby. Parking Space. Restaurants Nearby. ...,ogba,0,0,0,0,ogba1,250000.0,380000.0,300000.0,0,3,1,170000
1946,  off college road ifako ogba ogba lagos,4,2,2,2,"decent two bedroom flat with wardrobe, kitchen cabinet and big balcony. adequate car park with gate man. all this at an affordable rate of just 600k. Fenced with gate and water with prepaid meter. no ... Cheap. Renovated. Drainage System. Water Treatment. Security Doors. Security. Street Lights. Big Compound. Parking Space. 24 Hours Security. Restaurants Nearby. ...",ogba,0,0,0,1,ogba2,550000.0,650000.0,625000.0,1,13,3,600000
1947,  obawole area ifako ogba ogba lagos,2,1,1,1,Decent flat with modern facilities suitable for a working class tenant or young couple. Fenced with gate and water. Has adequate car park and no landlord in ccompound. Come and inspect today. Send someone if ... Cheap. Renovated. Drainage System. Water Treatment. Supermarket Nearby. Parking Space. 24 Hours Security. ...,ogba,0,0,0,0,ogba1,250000.0,380000.0,300000.0,0,3,1,180000
1948,  obawole area ifako ogba ogba lagos,2,1,1,1,Decent and spacious mini-flat at an affordable rate in a secured location at obawole. Fenced with gate and water with car park. Come and inspect today. Send someone if you don't have time. Form fee ... Cheap. Dry. Renovated. Drainage System. Water Treatment. Security. Big Compound. Supermarket Nearby. Parking Space. 24 Hours Security. Restaurants Nearby. ...,ogba,0,0,0,1,ogba1,250000.0,380000.0,300000.0,1,3,1,250000
1949,  obawole area ifako ogba ogba lagos,4,2,2,2,decent two bedroom flat with prepaid meter and adequate car park. Fenced with gate and water. no landlord in ccompound. Come and inspect today. Send someone if you don't have time. Form fee is compulsory ... Cheap. Renovated. Drainage System. Water Treatment. Security Doors. Security. Big Compound. Parking Space. 24 Hours Security. Restaurants Nearby. ...,ogba,0,0,0,0,ogba2,550000.0,650000.0,625000.0,0,13,3,400000
1950,  obawole area ifako ogba ogba lagos,7,4,3,4,decent and very spacious 3bedroom flat with prepaid meter and adequate car park. Fenced with gate and water. no landlord in ccompound. Come and inspect today. Send someone if you don't have time. Form fee ... Cheap. Renovated. Water Treatment. Security Doors. Big Compound. Parking Space. 24 Hours Security. ...,ogba,0,0,0,0,ogba4,775000.0,1080000.0,1000000.0,0,19,4,700000
1951,  near airtel office aguda(ogba) ogba lagos,4,2,2,2,"decent miniflat with luxury fittings and lovely interior plus prepaid meter and adequate car park. Two toilets, spanish tiles with water heater, massive wardrobe and kitchen cabinet. Fenced with gate and water. no landlord in ... Serviced. Furnished. New. Drainage System. Water Treatment. Security Doors. Security. Pop Ceiling. Big Compound. Parking Space. 24 Hours Security. ...",ogba,1,1,0,1,ogba2,550000.0,650000.0,625000.0,3,13,3,650000
1952,  obawole area ifako ogba ogba lagos,7,4,3,4,Very lovely duplex with modern facilities suitable for a working class tenant or young couple. Fenced with gate and water. Private compound with adequate car park. Come and inspect today. Send someone if you don't ... Cheap. Renovated. Furnished. Drainage System. Water Treatment. Security Doors. Pop Ceiling. Street Lights. Big Compound. All Room Ensuit. Supermarket Nearby. Parking Space. 24 Hours Security. Restaurants Nearby. ...,ogba,0,0,0,0,ogba4,775000.0,1080000.0,1000000.0,0,19,4,750000
1953,  off college road ifako ogba ogba lagos,6,3,3,3,"brand new. pop ceiling. spanish tiles, luxury fittings, wired fencing, security camera, interlocked compound, double gate, modern doors, painted in and out.generator house. located in a secured and serene estate. form fee applies for new ... New. Drainage System. Water Treatment. Big Compound. All Room Ensuit. Supermarket Nearby. 24 Hours Electricity. ...",ogba,1,1,1,1,ogba3,650000.0,780000.0000000001,750000.0,4,15,3,1000000
1954,  obawole area ifako ogba ogba lagos,6,3,3,3,Decent flat with modern facilities suitable for a working class tenant or young couple. Fenced with gate and water. no landlord in ccompound. Come and inspect today. Send someone if you don't have time. Form ... Renovated. 24 Hours Security. Supermarket Nearby. Big Compound. Parking Space. Street Lights. Security Doors. Restaurants Nearby. Drainage System. ...,ogba,0,0,0,0,ogba3,650000.0,780000.0000000001,750000.0,0,15,3,600000
1955,  obawole area ifako ogba ogba lagos,5,3,2,3,Decent flat with modern facilities suitable for a working class tenant or young couple. Fenced with gate and water. no landlord in ccompound. Come and inspect today. Send someone if you don't have time. Form ... Renovated. Cheap. Street Lights. Parking Space. 24 Hours Security. Drainage System. Big Compound. Security Doors. Water Treatment. Supermarket Nearby. ...,ogba,0,0,0,0,ogba3,650000.0,780000.0000000001,750000.0,0,15,3,500000
1956,  obawole area ifako ogba ogba lagos,6,3,3,3,Very lovely two bedroom flat with luxury fitting and decent interior at the prestigious kfarm estate. Fenced with gate and water. no landlord in ccompound. Come and inspect today. Send someone if you don't have ... Renovated. Dry. Furnished. Big Compound. Water Treatment. Parking Space. Drainage System. Restaurants Nearby. Supermarket Nearby. 24 Hours Security. ...,ogba,0,0,0,1,ogba3,650000.0,780000.0000000001,750000.0,1,15,3,650000
1957,  obawole area ifako ogba ogba lagos,2,1,1,1,decent room of portable size that is suitable for a single person. Fenced with gate and water. no landlord in ccompound. Come and inspect today. Send someone if you don't have time. Form fee is ... Cheap. Renovated. Dry. Big Compound. Supermarket Nearby. Restaurants Nearby. Parking Space. 24 Hours Security. Drainage System. Water Treatment. ...,ogba,0,0,0,0,ogba1,250000.0,380000.0,300000.0,0,3,1,120000
1958,"  kay farm estate, obawale, ogba ikeja lagos",5,3,2,3,"Just Out...... Newly built lovely 2bedroom LOCATION:kfarm estate obawole ogba. With Pop, wardrobes, 3toilet and bath. Water heater. Price: Up 700k down 650k.... ... ...",ogba,0,0,0,1,ogba3,650000.0,780000.0000000001,750000.0,1,15,3,650000
1959,  kay farm estate obawole ogba lagos ogba lagos,5,3,2,3,"Just Out...... Newly built lovely 2bedroom LOCATION:kfarm estate obawole ogba. With Pop, wardrobes, 3toilet and bath. Water heater. Price: Up 700k down 650k.... ... New. Security. All Room Ensuit. Big Compound. Parking Space. Pop Ceiling. ...",ogba,0,0,0,1,ogba3,650000.0,780000.0000000001,750000.0,1,15,3,650000
1960, behind nationwide filling station.... aguda(ogba) ogba lagos,2,1,1,1,"Tastefully finished executive mini flat Upstairs BEHIND NATIONWIDE FILLING STATION,AGUDA OGBA,Available for Rent urgently..... ... Cheap. Renovated. Security Doors. Security. Street Lights. Parking Space. 24 Hours Electricity. 24 Hours Security. ...",ogba,1,0,0,1,ogba1,250000.0,380000.0,300000.0,2,3,1,300000
1961, kay farm estate off college road ogba aguda(ogba) ogba lagos,4,2,2,2,sharp neat all room ensuite all round tiles wardrobe ... Old. Big Compound. All Room Ensuit. Parking Space. 24 Hours Electricity. 24 Hours Security. ...,ogba,0,0,0,0,ogba2,550000.0,650000.0,625000.0,0,13,3,500000
1962, kadiri street...... ajayi road ogba lagos,2,1,1,1,"A well finished executive mini flat upstairs at AJAYI ROAD,OGBA,Available for Rent urgently.... ... Cheap. Renovated. Security Doors. Security. Street Lights. Parking Space. 24 Hours Electricity. 24 Hours Security. ...",ogba,1,0,1,1,ogba1,250000.0,380000.0,300000.0,3,3,1,350000
1963, karaole estate..off college road..... ifako ogba ogba lagos,2,1,1,1,"Tastefully finished executive spacious one roomself contain studio apartment upstairs at KARAOLE ESTATE,OFF COLLEGE ROAD,OGBA,Available for Rent urgently....... ... Cheap. Renovated. Security Doors. Security. Street Lights. Parking Space. 24 Hours Electricity. 24 Hours Security. ...",ogba,0,0,0,0,ogba1,250000.0,380000.0,300000.0,0,3,1,220000
1964, off power line obawole ifako ogba ogba lagos,2,1,1,1,Very clean and nice portable mini flat at obawole ogba ifako ijaye Lagos State nice environment 300k a year rent Contact me for inspection Charlow properties 08114761230 08138248835 ... New. Security Doors. Security. Street Lights. ...,ogba,1,0,0,1,ogba1,250000.0,380000.0,300000.0,2,3,1,300000
1965, aguda(ogba) ogba lagos,2,1,1,1,"Tastefully finished executive mini flat with water heater and wardrobe at AGUDA OGBA,Available for Rent urgently.... ... Cheap. Renovated. Security Doors. Security. Street Lights. Parking Space. 24 Hours Electricity. 24 Hours Security. ...",ogba,1,1,1,1,ogba1,250000.0,380000.0,300000.0,4,3,1,380000
1966, aguda area..... ajayi road ogba lagos,8,4,4,4,"Tastefully finished executive 3bdrm flat upstairs with all room en-suite On AJAYI ROAD AGUDA OGBA,Available for Rent urgently..... ... Cheap. Renovated. Security Doors. Security. Street Lights. Big Compound. All Room Ensuit. Parking Space. 24 Hours Electricity. 24 Hours Security. ...",ogba,0,0,0,1,ogba4,775000.0,1080000.0,1000000.0,1,19,4,800000
1967, olanipekun estate...... ajayi road ogba lagos,2,1,1,1,"Tastefully finished executive mini flat at OLANIPEKUN ESTATE,AJAYI ROAD OKE-IRA OGBA,Available for Rent urgently...... ... Cheap. Renovated. Security Doors. Security. Pop Ceiling. Street Lights. All Room Ensuit. Parking Space. 24 Hours Electricity. 24 Hours Security. ...",ogba,1,1,1,1,ogba1,250000.0,380000.0,300000.0,4,3,1,380000
1968, mobil.....ola street...... ajayi road ogba lagos,6,3,3,3,"Brand new tastefully finished executive 2bdrm flat upstairs with all room en-suite,pop ceiling and pop wall finishing,all round tiles,kitchen cabinet and wardrobes etc at AJAYI ROAD OKE-IRA OGBA,Available for Rent urgently...... ... Cheap. New. Security Doors. Security. Pop Ceiling. Street Lights. Big Compound. All Room Ensuit. Parking Space. 24 Hours Electricity. 24 Hours Security. ...",ogba,1,0,0,1,ogba3,650000.0,780000.0000000001,750000.0,2,15,3,750000
1969, mobil area..... ajayi road ogba lagos,6,3,3,3,"Brand new tastefully finished executive 2bdrm flat with all room en-suite,pop ceiling and pop wall finishing,all round tiles,ample parking space,kitchen cabinet and wardrobes,water heater,pre-paid meter etc at AJAYI ROAD OGBA,Available for Rent urgently....... ... Cheap. New. Security Doors. Security. Pop Ceiling. Street Lights. Big Compound. All Room Ensuit. Supermarket Nearby. Parking Space. 24 Hours Electricity. 24 Hours Security. ...",ogba,0,0,0,1,ogba3,650000.0,780000.0000000001,750000.0,1,15,3,650000
1970," haruna area,off college road.... ogba lagos",4,2,2,2,"Brand new tastefully finished executive mini flat upstairs with 2toilet and 2bathroom at HARUNA AREA,OFF COLLEGE ROAD OGBA,Available for Rent urgently..... ... Cheap. New. Security Doors. Security. Pop Ceiling. Street Lights. Big Compound. All Room Ensuit. Parking Space. 24 Hours Electricity. 24 Hours Security. ...",ogba,0,0,0,0,ogba2,550000.0,650000.0,625000.0,0,13,3,500000
1971, ogba aguda(ogba) ogba lagos,3,2,1,2,"Brand new Mini flats, POP finished close to Aguda Ogba,Upstairs 700k,Down 650k. ... Furnished. New. Drainage System. Security Doors. Security. Pop Ceiling. Street Lights. Big Compound. All Room Ensuit. Parking Space. 24 Hours Electricity. 24 Hours Security. ...",ogba,1,1,1,1,ogba2,550000.0,650000.0,625000.0,4,13,3,700000
1972, jacob shonola street...... ajayi road ogba lagos,6,3,3,3,"Brand new tastefully finished executive 2bdrm flat with all room en-suite,upstairs,pop ceiling and pop wall finishing etc at AJAYI ROAD OKE-IRA OGBA,Available for Rent urgently..... ... Cheap. New. Security Doors. Security. Pop Ceiling. Street Lights. Big Compound. All Room Ensuit. Parking Space. 24 Hours Electricity. 24 Hours Security. ...",ogba,0,0,0,1,ogba3,650000.0,780000.0000000001,750000.0,1,15,3,700000
1973, yusufu street...... ajayi road ogba lagos,6,3,3,3,"Brand new executive 2bdrm flat with all room en-suite,pre-paid meters,water heater etc, up and down available at AJAYI ROAD OKE-IRA OGBA,Available for Rent urgently...... ... Cheap. New. Security Doors. Free Wifi. Security. Pop Ceiling. Street Lights. Cctv Cameras. All Room Ensuit. Supermarket Nearby. Parking Space. 24 Hours Electricity. 24 Hours Security. ...",ogba,1,1,0,1,ogba3,650000.0,780000.0000000001,750000.0,3,15,3,800000
1974, oke-ira...... ajayi road ogba lagos,6,3,3,3,"Brand new executive 2bdrm flat with all room en-suite, upstairs and downstairs available at AJAYI ROAD OKE-IRA OGBA,Available for Rent urgently...... ... Cheap. New. Security Doors. Security. Pop Ceiling. Street Lights. Big Compound. Cctv Cameras. All Room Ensuit. Parking Space. 24 Hours Electricity. 24 Hours Security. ...",ogba,0,0,0,1,ogba3,650000.0,780000.0000000001,750000.0,1,15,3,650000
1975, oladoyinbo street...... aguda(ogba) ogba lagos,4,2,2,2,"Brand new executive mini flat with 2toilet and 2bathroom,pop ceiling and pop wall finishing,water heater,pre-paid meter,all round marble tiles,imported kitchen cabinet and wardrobe,double balconies etc at AGUDA OGBA,Available for Rent urgently..... ... Cheap. New. Security Doors. Security. Pop Ceiling. Street Lights. Big Compound. All Room Ensuit. Parking Space. 24 Hours Electricity. 24 Hours Security. ...",ogba,1,1,0,1,ogba2,550000.0,650000.0,625000.0,3,13,3,650000
1976, off ajayi road ajayi road ogba lagos,2,1,1,1,Decent miniflat. at an affordable rate in a secured location at ogba. With private gate man and no landlord in compound. Fenced with gate and water with car park. Come and inspect today. Send someone ... Cheap. Dry. Renovated. Drainage System. Security. Supermarket Nearby. Parking Space. Restaurants Nearby. ...,ogba,1,0,0,1,ogba1,250000.0,380000.0,300000.0,2,3,1,300000
1977, ayo alabi area....... ajayi road ogba lagos,4,2,2,2,"Tastefully finished executive mini flat with 2toilet and 2bathroom at AJAYI ROAD OKE-IRA OGBA,Available for Rent urgently....... ... Cheap. Renovated. Security Doors. Security. Pop Ceiling. Street Lights. All Room Ensuit. Parking Space. 24 Hours Electricity. 24 Hours Security. ...",ogba,0,0,0,0,ogba2,550000.0,650000.0,625000.0,0,13,3,400000
1978, oyatogun street ajayi road ogba lagos,2,1,1,1,decent mini flat at an affordable rate in a secured estate at ogba. Fenced with gate and water with car park. Come and inspect today. Send someone if you don't have time. Form fee is ... Renovated. Drainage System. Boys Quater. Water Treatment. Security Doors. Street Lights. Big Compound. Supermarket Nearby. Parking Space. ...,ogba,1,0,0,1,ogba1,250000.0,380000.0,300000.0,2,3,1,300000
1979, off college road ifako ogba ogba lagos,4,2,2,2,Clean 2bedrm flat at Ogba off college road In a mini estate with 2toilet and bath Contact me for inspection Charlow properties 08138248835 WhatsApp 08114761230 ... New. Security Doors. Street Lights. Big Compound. 24 Hours Security. ...,ogba,0,0,0,0,ogba2,550000.0,650000.0,625000.0,0,13,3,500000
1980, shonola street....... aguda(ogba) ogba lagos,2,1,1,1,"Tastefully finished executive mini flat at AGUDA OGBA,Opposite excellence hotel,Available for Rent urgently...... ... Cheap. Renovated. Security Doors. Security. Street Lights. Parking Space. 24 Hours Electricity. 24 Hours Security. ...",ogba,1,1,1,1,ogba1,250000.0,380000.0,300000.0,4,3,1,380000
1981, iju obawole ifako ogba ogba lagos,2,1,1,1," Onee room self contain for rent contact Favour properties group [redacted],[redacted] ... All Room Ensuit. 24 Hours Electricity. 24 Hours Security. ...",ogba,0,0,0,0,ogba1,250000.0,380000.0,300000.0,0,3,1,200000
1982, oke-ira..... ajayi road ogba lagos,8,4,4,4,"Executive 3bdrm flat with all room en-suite at AJAYI ROAD,OKE-IRA OGBA,Available for Rent urgently..... ... Cheap. Renovated. Security Doors. Security. Pop Ceiling. Street Lights. All Room Ensuit. Parking Space. 24 Hours Electricity. 24 Hours Security. ...",ogba,0,0,0,0,ogba4,775000.0,1080000.0,1000000.0,0,19,4,700000
1983, obawole iju ogba iju lagos,6,3,3,3,"Tastefully built 3 bedroom New apartment for rent at Obawole ogba in a very secured estate in obawole all rooms ensuit,tiles enough parking space 750 k per year contact Favour Properties Group [redacted],[redacted] for inspection ... New. Security Doors. Security. Pop Ceiling. Big Compound. All Room Ensuit. Parking Space. 24 Hours Electricity. 24 Hours Security. ...",ogba,1,0,0,1,ogba3,650000.0,780000.0000000001,750000.0,2,15,3,750000
1984, off lucas street ifako ogba ogba lagos,5,3,2,3,Correct 2bedrm flat at obawole ogba ifako ijaye Lagos with pop tiles and ensuit big compound Contact me for inspection Charlow properties 08114761230 08138248835 WhatsApp ... Cheap. New. Security Doors. Street Lights. Big Compound. All Room Ensuit. 24 Hours Electricity. 24 Hours Security. ...,ogba,0,0,0,1,ogba3,650000.0,780000.0000000001,750000.0,1,15,3,650000
1985, oke ira ogba lagos,2,1,1,1,"Brand new executive mini flat at OKE-IRA OGBA,Available for Rent urgently..... ... Cheap. New. Security Doors. Security. Pop Ceiling. Street Lights. Parking Space. 24 Hours Electricity. 24 Hours Security. ...",ogba,1,1,1,1,ogba1,250000.0,380000.0,300000.0,4,3,1,500000
1986, modupe area..... ajayi road ogba lagos,4,2,2,2,"Tastefully finished executive 2bdrm flat upstairs with spacious master bedroom at AJAYI ROAD OGBA,Available for Rent urgently...... ... Cheap. Renovated. Security Doors. Security. Pop Ceiling. Street Lights. Big Compound. All Room Ensuit. Parking Space. 24 Hours Electricity. 24 Hours Security. ...",ogba,0,0,0,1,ogba2,550000.0,650000.0,625000.0,1,13,3,550000
1987, ajayi road ogba lagos,4,2,2,2,"A well finished executive 2bdrm flat at AJAYI ROAD,OKE-IRA OGBA,Available for Rent urgently..... ... Cheap. Renovated. Security Doors. Security. Street Lights. Parking Space. 24 Hours Electricity. 24 Hours Security. ...",ogba,0,0,0,0,ogba2,550000.0,650000.0,625000.0,0,13,3,500000
1988, ogunshola street..... aguda(ogba) ogba lagos,6,3,3,3,"Tastefully finished executive 2bdrm flat upstairs with all room en-suite at AGUDA AREA OGBA,Opposite excellence hotel, Available for Rent urgently...... ... Cheap. Renovated. Security Doors. Security. Street Lights. Big Compound. All Room Ensuit. Parking Space. 24 Hours Electricity. 24 Hours Security. ...",ogba,0,0,0,0,ogba3,650000.0,780000.0000000001,750000.0,0,15,3,500000
1989, otuba street.oke-ira..... ajayi road ogba lagos,2,1,1,1,"A well finished executive and spacious mini flat at AJAYI ROAD OKE-IRA OGBA,Available for Rent urgently..... ... Cheap. Renovated. Security Doors. Security. Street Lights. Big Compound. Parking Space. 24 Hours Electricity. 24 Hours Security. ...",ogba,1,0,0,1,ogba1,250000.0,380000.0,300000.0,2,3,1,300000
1990, fadeyi street..... aguda(ogba) ogba lagos,6,3,3,3,"Tastefully finished executive 2bdrm flat upstairs with all room en-suite at AGUDA OGBA,Available for Rent urgently..... ... Cheap. Renovated. Security Doors. Security. Street Lights. All Room Ensuit. Parking Space. 24 Hours Electricity. 24 Hours Security. ...",ogba,0,0,0,0,ogba3,650000.0,780000.0000000001,750000.0,0,15,3,500000
1991, ajayi road..... oke ira ogba lagos,4,2,2,2,"Tastefully finished executive 2bdrm flat with master bedroom,upstairs at OKE-IRA OGBA,Available for Rent urgently.... ... Cheap. Renovated. Security Doors. Security. Street Lights. Big Compound. Parking Space. 24 Hours Electricity. 24 Hours Security. ...",ogba,0,0,0,1,ogba2,550000.0,650000.0,625000.0,1,13,3,600000
1992, behind county hospital....... aguda(ogba) ogba lagos,4,2,2,2,"Brand new tastefully finished executive mini flat with 2toilet and 2bathroom,water heater,pop ceiling,marble tiles,imported kitchen cabinet,2bacony,etc BEHIND COUNTY HOSPITAL,AGUDA OGBA,Available for Rent urgently... ... Cheap. New. Security Doors. Security. Pop Ceiling. Street Lights. Big Compound. All Room Ensuit. Parking Space. 24 Hours Electricity. 24 Hours Security. ...",ogba,1,1,0,1,ogba2,550000.0,650000.0,625000.0,3,13,3,650000
1993, alafia estate...... ogba lagos,4,2,2,2,"Tastefully finished executive 2bdrm flat at ALAFIA ESTATE,OGBA,Available for Rent urgently..... ... Cheap. Renovated. Security Doors. Security. Street Lights. Parking Space. 24 Hours Electricity. 24 Hours Security. ...",ogba,0,0,0,1,ogba2,550000.0,650000.0,625000.0,1,13,3,550000
1994, olanipekun estate....... oke ira ogba lagos,6,3,3,3,"A well finished executive 2bdrm flat with all room en-suite at OLANIPEKUN ESTATE,AJAYI ROAD,OKE-IRA,OGBA,Available for Rent urgently...... ... Cheap. Renovated. Security Doors. Security. Pop Ceiling. Street Lights. Parking Space. 24 Hours Electricity. 24 Hours Security. ...",ogba,0,0,0,0,ogba3,650000.0,780000.0000000001,750000.0,0,15,3,500000
1995, oke ira ogba lagos,6,3,3,3,"Tastefully finished executive 2bdrm flat with all room en-suite at AJAYI ROAD,OKE-IRA,OGBA,Available for Rent urgently..... ... Cheap. Renovated. Security Doors. Security. Pop Ceiling. Street Lights. All Room Ensuit. Parking Space. 24 Hours Electricity. 24 Hours Security. ...",ogba,0,0,0,0,ogba3,650000.0,780000.0000000001,750000.0,0,15,3,550000
1996, behind county hospital..... aguda(ogba) ogba lagos,4,2,2,2,"Brand new tastefully finished Executive Mini flat with POP,WARDROBE,PRE-PAID METER AND WATER HEATER BEHIND COUNTY HOSPITAL,AGUDA, OGBA,Available for Rent urgently.... ... Cheap. New. Security Doors. Security. Pop Ceiling. Street Lights. All Room Ensuit. Parking Space. 24 Hours Electricity. 24 Hours Security. ...",ogba,1,1,0,1,ogba2,550000.0,650000.0,625000.0,3,13,3,650000
1997, sumonu street..... oke ira ogba lagos,2,1,1,1,"A well finished executive one roomself contain studio apartment at,OKE-IRA,OFF AJAYI ROAD, Ogba,Available for Rent urgently... ... Cheap. Renovated. Security Doors. Security. Street Lights. Big Compound. Parking Space. 24 Hours Electricity. 24 Hours Security. ...",ogba,0,0,0,1,ogba1,250000.0,380000.0,300000.0,1,3,1,250000
1998, aguda ogba area..... ogba lagos,6,3,3,3,"A well renovated tastefully finished executive 2bdrm flat upstairs with all room en-suite at AGUDA OGBA,Available for Rent urgently..... ... Cheap. Renovated. Security Doors. Security. Street Lights. Big Compound. All Room Ensuit. Parking Space. 24 Hours Electricity. 24 Hours Security. ...",ogba,0,0,0,0,ogba3,650000.0,780000.0000000001,750000.0,0,15,3,550000
1999, aguda(ogba) ogba lagos,6,3,3,3,"Tastefully finished executive 3bdrm flat with master bedroom at AGUDA OGBA,Opposite excellence hotel,Available for Rent urgently..... ... Cheap. Renovated. Security Doors. Security. Street Lights. Big Compound. Parking Space. 24 Hours Electricity. 24 Hours Security. ...",ogba,0,0,0,1,ogba3,650000.0,780000.0000000001,750000.0,1,15,3,650000
2000, ajayi road oke-ira.... ogba lagos,6,3,3,3,"Tastefully finished executive 3bdrm flat with master bedroom at AJAYI ROAD OKE-IRA OGBA,Available for Rent Urgently..... ... Cheap. Renovated. Security Doors. Security. Street Lights. Big Compound. Parking Space. 24 Hours Electricity. 24 Hours Security. ...",ogba,0,0,0,0,ogba3,650000.0,780000.0000000001,750000.0,0,15,3,600000
2001, aguda.... ajayi road ogba lagos,6,3,3,3,"Tastefully finished executive 2bdrm flat with all room en-suite at AGUDA OGBA,Available for Rent Urgently..... ... Cheap. Renovated. Security Doors. Security. Street Lights. Big Compound. All Room Ensuit. Parking Space. 24 Hours Electricity. 24 Hours Security. ...",ogba,0,0,0,0,ogba3,650000.0,780000.0000000001,750000.0,0,15,3,600000
2002, aguda...... ifako ogba ogba lagos,4,2,2,2,"Tastefully finished executive mini flat upstairs with 2toilet and 2bathroom at AGUDA,AJAYI ROAD, OGBA,Available for Rent urgently...... ... Cheap. Renovated. Security Doors. Security. Street Lights. All Room Ensuit. Parking Space. 24 Hours Electricity. 24 Hours Security. ...",ogba,0,0,0,0,ogba2,550000.0,650000.0,625000.0,0,13,3,400000
2003, k farm estate ifako ogba ogba lagos,5,3,2,3,Newly built 3bedroom flat at k farm estate obawole ogba all rooms ensuit tiles Contact me for inspection Charlow properties 08114761230 08138248835 ... New. Water Treatment. Pop Ceiling. Big Compound. All Room Ensuit. Parking Space. 24 Hours Electricity. 24 Hours Security. ...,ogba,0,0,0,1,ogba3,650000.0,780000.0000000001,750000.0,1,15,3,650000
2004, obawole ifako ogba ogba lagos,5,3,2,3,Newly built 2bedroom flat at obawole ogba inside k farm estate Contact me for inspection Charlow properties 08138248835 ... Furnished. New. Security. Pop Ceiling. Big Compound. All Room Ensuit. 24 Hours Electricity. 24 Hours Security. ...,ogba,0,0,0,0,ogba3,650000.0,780000.0000000001,750000.0,0,15,3,500000
2005, ogundele avenue...... ajayi road ogba lagos,2,1,1,1,"Tastefully finished executive 2bdrm flat at AJAYI ROAD OKE-IRA OGBA,Available for Rent urgently...... ... Cheap. Renovated. Security Doors. Security. Street Lights. Parking Space. 24 Hours Electricity. 24 Hours Security. ...",ogba,1,1,1,1,ogba1,250000.0,380000.0,300000.0,4,3,1,450000
2006, ola street...... ajayi road ogba lagos,6,3,3,3,"Brand new Spacious executive 2bdrm flat with all room en-suite,pop ceiling and pop wall finishing,all round tiles etc at AJAYI ROAD OKE-IRA OGBA,Available for Rent urgently..... ... Cheap. New. Security Doors. Security. Pop Ceiling. Street Lights. All Room Ensuit. Parking Space. 24 Hours Electricity. 24 Hours Security. ...",ogba,0,0,0,1,ogba3,650000.0,780000.0000000001,750000.0,1,15,3,650000
2007, aguda(ogba) ogba lagos,6,3,3,3,"Executive 2bdrm flat en-suite at AGUDA OGBA,Opposite excellence hotel,Available for Rent urgently..... ... Cheap. Renovated. Security Doors. Security. Street Lights. All Room Ensuit. Parking Space. 24 Hours Electricity. 24 Hours Security. ...",ogba,0,0,0,0,ogba3,650000.0,780000.0000000001,750000.0,0,15,3,550000
2008, alafia estate....... aguda(ogba) ogba lagos,4,2,2,2,"Tastefully finished executive SPACIOUS mini flat with 2toilet and 2bathroom at ALAFIA ESTATE,Aguda ogba,Available for Rent... ... Cheap. Renovated. Security Doors. Security. Street Lights. All Room Ensuit. Parking Space. 24 Hours Electricity. 24 Hours Security. ...",ogba,0,0,0,0,ogba2,550000.0,650000.0,625000.0,0,13,3,400000
2009, aguda(ogba) ogba lagos,6,3,3,3,"Brand new tastefully finished executive 2bdrm flat with all room en-suite,pre-paid meter,pop all round,all round marble tiles,water heater,kitchen cabinet and wardrobes etc at AGUDA OGBA,Available for Rent urgently..... ... Cheap. New. Security Doors. Security. Pop Ceiling. Street Lights. Big Compound. All Room Ensuit. Parking Space. 24 Hours Electricity. 24 Hours Security. ...",ogba,1,1,0,1,ogba3,650000.0,780000.0000000001,750000.0,3,15,3,800000
2010, mobil....... ajayi road ogba lagos,6,3,3,3,"Brand new tastefully finished executive 2bdrm flat with all room en-suite,pop,upstairs,all round tiles,etc at AJAYI ROAD OKE-IRA OGBA,Available for Rent urgently...... ... Cheap. New. Security Doors. Security. Pop Ceiling. Street Lights. Big Compound. All Room Ensuit. Parking Space. 24 Hours Electricity. 24 Hours Security. ...",ogba,1,0,0,1,ogba3,650000.0,780000.0000000001,750000.0,2,15,3,750000
2011, fako estate...... oke ira ogba lagos,4,2,2,2,"Lovely and spacious 2bdrm flat with master bedroom,2 occupants only in the compound at FAKO ESTATE,OKE-IRA OGBA,Available for Rent urgently...... ... Cheap. Renovated. Security Doors. Security. Street Lights. Parking Space. 24 Hours Electricity. 24 Hours Security. ...",ogba,0,0,0,1,ogba2,550000.0,650000.0,625000.0,1,13,3,550000
2012, williams estate....... oke ira ogba lagos,6,3,3,3,"Brand new executive 2bdrm flat with all room en-suite,pop,water heater,etc at WILLIAMS ESTATE,OKE-IRA,OGBA,Available for Rent Urgently...... ... Cheap. New. Security Doors. Security. Pop Ceiling. Street Lights. Big Compound. All Room Ensuit. Parking Space. 24 Hours Electricity. 24 Hours Security. ...",ogba,1,1,1,1,ogba3,650000.0,780000.0000000001,750000.0,4,15,3,850000
2013, muibi street...... aguda(ogba) ogba lagos,6,3,3,3,"Tastefully finished executive 2bdrm flat with all room en-suite upstairs at AGUDA OGBA,Available for Rent Urgently..... ... Cheap. Renovated. Security Doors. Security. Street Lights. Big Compound. All Room Ensuit. Parking Space. 24 Hours Electricity. 24 Hours Security. ...",ogba,0,0,0,0,ogba3,650000.0,780000.0000000001,750000.0,0,15,3,550000
2014, oke-ira.... ajayi road ogba lagos,2,1,1,1,"Executive one roomself contain studio apartment upstairs at OKE-IRA,OGBA,Available for Rent urgently...... ... Cheap. Renovated. Security Doors. Security. Street Lights. Parking Space. 24 Hours Electricity. 24 Hours Security. ...",ogba,0,0,0,0,ogba1,250000.0,380000.0,300000.0,0,3,1,200000
2015, aguda........ ajayi road ogba lagos,2,1,1,1,"Lovely executive one roomself contain studio apartment at AGUDA OGBA,Available for Rent urgently..... ... Cheap. Renovated. Security Doors. Security. Street Lights. Parking Space. 24 Hours Electricity. 24 Hours Security. ...",ogba,0,0,0,0,ogba1,250000.0,380000.0,300000.0,0,3,1,200000
2016," akilo road,very close to the stadium..... ogba lagos",6,3,3,3,"Brand new executive 2bdrm flat upstairs With all room en-suite at AKILO ROAD, OGBA,Available for Rent urgently..... ... Cheap. New. Security Doors. Security. Pop Ceiling. Street Lights. Big Compound. All Room Ensuit. Parking Space. 24 Hours Electricity. 24 Hours Security. ...",ogba,1,1,0,1,ogba3,650000.0,780000.0000000001,750000.0,3,15,3,800000
2017, alafia estate..... ogba lagos,4,2,2,2,"Tastefully finished executive 2bdrm flat with master bedroom at ALAFIA ESTATE OGBA,Available for Rent Urgently... ... Cheap. Renovated. Security Doors. Security. Street Lights. Parking Space. 24 Hours Electricity. 24 Hours Security. ...",ogba,1,1,1,1,ogba2,550000.0,650000.0,625000.0,4,13,3,700000
2018, aguda area.... ogba lagos,6,3,3,3,"Tastefully finished executive 2bdrm flat with all room en-suite at AGUDA OGBA,Available for Rent Urgently.... ... Cheap. Renovated. Security Doors. Security. Street Lights. All Room Ensuit. Parking Space. 24 Hours Electricity. 24 Hours Security. ...",ogba,0,0,0,0,ogba3,650000.0,780000.0000000001,750000.0,0,15,3,600000
2019, 34 oyatogun street.... aguda(ogba) ogba lagos,6,3,3,3,"Tastefully finished executive 2bdrm flat upstairs with all room en-suite at AGUDA OGBA,Available for Rent urgently....... ... Cheap. Renovated. Security Doors. Security. Street Lights. All Room Ensuit. Parking Space. 24 Hours Electricity. 24 Hours Security. ...",ogba,0,0,0,0,ogba3,650000.0,780000.0000000001,750000.0,0,15,3,550000
2020, ogba obawole ifako ogba ogba lagos,4,2,2,2,"Newly built two bedroom flat for rent at obawole Ogba in a good location 700000 fenced gate with water pay and park in contact Favour properties Group ?? ?? 08035750544,08133419582,08053019208 ... New. Big Compound. All Room Ensuit. 24 Hours Electricity. 24 Hours Security. ...",ogba,1,1,1,1,ogba2,550000.0,650000.0,625000.0,4,13,3,700000
2021, obawole ifako ogba ogba lagos,7,4,3,4,"Clean 3bedroom duplex at obawole ogba ifako ijaye Lagos State for rent 750,000 Contact me for inspection 08138248835 08114761230 ... Furnished. New. Water Treatment. Security Doors. Security. Street Lights. ...",ogba,0,0,0,0,ogba4,775000.0,1080000.0,1000000.0,0,19,4,750000
2022, oke-ira........ ajayi road ogba lagos,4,2,2,2,"Newly built executive mini flat with 2toilet and 2bathroom,pop,wardrobe etc at AJAYI ROAD,OKE-IRA OGBA,Available for Rent urgently..... ... Cheap. New. Security Doors. Security. Pop Ceiling. Street Lights. All Room Ensuit. Parking Space. 24 Hours Electricity. 24 Hours Security. ...",ogba,0,0,0,0,ogba2,550000.0,650000.0,625000.0,0,13,3,450000
2023, fadunsi street...... oke ira ogba lagos,6,3,3,3,"Tastefully finished executive 2bdrm flat with all room en-suite,2 occupants only in the compound at OKE-IRA OGBA, Available for Rent urgently...... ... Cheap. Renovated. Security Doors. Security. Pop Ceiling. Street Lights. All Room Ensuit. Parking Space. 24 Hours Electricity. 24 Hours Security. ...",ogba,0,0,0,0,ogba3,650000.0,780000.0000000001,750000.0,0,15,3,550000
2024, behind county hospital.... aguda(ogba) ogba lagos,4,2,2,2,"Tastefully finished executive mini flat upstairs with 2toilet and 2bathroom BEHIND COUNTY HOSPITAL,AGUDA OGBA,Available for Rent urgently.... ... Cheap. Renovated. Security Doors. Security. Street Lights. All Room Ensuit. Parking Space. 24 Hours Electricity. 24 Hours Security. ...",ogba,1,1,0,1,ogba2,550000.0,650000.0,625000.0,3,13,3,650000
2025, behind nationwide filling station..... aguda(ogba) ogba lagos,2,1,1,1,"Tastefully finished executive mini flat BEHIND NATIONWIDE FILLING STATION AGUDA OGBA,Available for Rent urgently...... ... Cheap. Renovated. Security Doors. Security. Street Lights. Parking Space. 24 Hours Electricity. 24 Hours Security. ...",ogba,1,0,0,1,ogba1,250000.0,380000.0,300000.0,2,3,1,300000
2026, ola street..... ajayi road ogba lagos,6,3,3,3,"Tastefully finished executive 2bdrm flat with all room en-suite at AJAYI ROAD OKE-IRA OGBA,,Available for Rent urgently..... ... Cheap. Renovated. Security Doors. Security. Pop Ceiling. Street Lights. Big Compound. All Room Ensuit. Parking Space. 24 Hours Electricity. 24 Hours Security. ...",ogba,0,0,0,0,ogba3,650000.0,780000.0000000001,750000.0,0,15,3,550000
2027, modupe oke-ira.... ajayi road ogba lagos,2,1,1,1,"Brand new spacious executive one roomself contain studio apartment at AJAYI ROAD OKE-IRA OGBA,Available for Rent urgently...... ... Cheap. New. Security Doors. Security. Street Lights. Parking Space. 24 Hours Electricity. 24 Hours Security. ...",ogba,0,0,0,0,ogba1,250000.0,380000.0,300000.0,0,3,1,180000
2028, k farm estate ifako ogba ogba lagos,7,4,3,4,Newly built 3bedrm flat at obawole ogba ifako ijaye Lagos State inside k farm estate Contact me for inspection Charlow properties 08138248835. WhatsApp 08114761230 ... Furnished. New. Water Treatment. Pop Ceiling. Big Compound. All Room Ensuit. Parking Space. 24 Hours Electricity. 24 Hours Security. ...,ogba,0,0,0,0,ogba4,775000.0,1080000.0,1000000.0,0,19,4,700000
2029, okeira ifako ogba ogba lagos,5,3,2,3,"Newly built 2bedrm flat at Ogba okeira 2 people in the compound 800,000 Contact me for inspection Charlow properties 08138248835 08114761230 ... Furnished. New. Security Doors. Security. Street Lights. Big Compound. All Room Ensuit. Parking Space. 24 Hours Electricity. 24 Hours Security. ...",ogba,1,1,0,1,ogba3,650000.0,780000.0000000001,750000.0,3,15,3,800000
2030, okeira ogba ifako ogba ogba lagos,5,3,2,3,Very nice and clean 2bedrm flat at Ogba and ensuit tiles everywhere pop Contact me for inspection Charlow properties 08138248835 08114761230 ... Cheap. New. Security Doors. Pop Ceiling. Big Compound. All Room Ensuit. Supermarket Nearby. Parking Space. 24 Hours Electricity. 24 Hours Security. Restaurants Nearby. ...,ogba,0,0,0,1,ogba3,650000.0,780000.0000000001,750000.0,1,15,3,700000
2031, ogundele avenue..... oke ira ogba lagos,6,3,3,3,"Newly renovated executive 2bdrm flat with all room en-suite 3,occupants only in the compound at AJAYI ROAD OKE-IRA OGBA,Available for Rent urgently....... ... Cheap. Renovated. Security Doors. Security. Pop Ceiling. Street Lights. All Room Ensuit. Parking Space. 24 Hours Electricity. 24 Hours Security. ...",ogba,0,0,0,0,ogba3,650000.0,780000.0000000001,750000.0,0,15,3,600000
2032, muibi street....... aguda(ogba) ogba lagos,6,3,3,3,"A well finished executive 2bdrm flat upstairs with all room en-suite,and wardrobe at AGUDA OGBA,Available for Rent urgently...... ... Cheap. Renovated. Security Doors. Security. Street Lights. All Room Ensuit. Parking Space. 24 Hours Electricity. 24 Hours Security. ...",ogba,0,0,0,0,ogba3,650000.0,780000.0000000001,750000.0,0,15,3,500000
2033, ondo street...... oke ira ogba lagos,4,2,2,2,"Tastefully finished executive 2bdrm flat upstairs with all room en-suite at OKE-IRA OFF AJAYI ROAD OGBA,Available for Rent urgently... ... Cheap. Renovated. Security Doors. Security. Street Lights. Parking Space. 24 Hours Electricity. 24 Hours Security. ...",ogba,0,0,0,0,ogba2,550000.0,650000.0,625000.0,0,13,3,500000
2034, off ajayi road...... oke ira ogba lagos,4,2,2,2,"Tastefully finished executive 2bdrm flat with spacious master bedroom,upstairs,pre-paid meter at AJAYI ROAD OKE-IRA OGBA,Available for Rent urgently...... ... Cheap. Renovated. Security Doors. Security. Street Lights. Parking Space. 24 Hours Electricity. 24 Hours Security. ...",ogba,0,0,0,0,ogba2,550000.0,650000.0,625000.0,0,13,3,500000
2035, oladoyinbo street..... aguda(ogba) ogba lagos,4,2,2,2,"Brand new tastefully finished executive mini flat upstairs with 2toilet and 2bathroom,water heater,pop and pre-paid meter at OLADOYINBO STREET,AGUDA, OGBA,Available for Rent urgently...... ... Cheap. New. Security Doors. Security. Pop Ceiling. Street Lights. All Room Ensuit. Parking Space. 24 Hours Electricity. 24 Hours Security. ...",ogba,1,1,1,1,ogba2,550000.0,650000.0,625000.0,4,13,3,700000
2036, aguda area...... ogba lagos,6,3,3,3,"Tastefully finished executive 2bdrm flat upstairs with all room en-suite at AGUDA OGBA,Available for Rent Urgently... ... Cheap. Renovated. Security Doors. Security. Street Lights. Big Compound. All Room Ensuit. Parking Space. 24 Hours Electricity. 24 Hours Security. ...",ogba,0,0,0,0,ogba3,650000.0,780000.0000000001,750000.0,0,15,3,500000
2037, adeshina street..... ajayi road ogba lagos,6,3,3,3,"Tastefully finished executive 2bdrm flat with all room en-suite at AJAYI ROAD,AGUDA OGBA,,Available for Rent urgently..... ... Cheap. Renovated. Security Doors. Security. Street Lights. All Room Ensuit. Parking Space. 24 Hours Electricity. 24 Hours Security. ...",ogba,0,0,0,0,ogba3,650000.0,780000.0000000001,750000.0,0,15,3,500000
2038, shonola street....... aguda(ogba) ogba lagos,2,1,1,1,"Tastefully finished executive mini flat at AGUDA OGBA,Available for Rent urgently....... ... Cheap. Renovated. Security Doors. Security. Street Lights. Parking Space. 24 Hours Electricity. 24 Hours Security. ...",ogba,1,1,1,1,ogba1,250000.0,380000.0,300000.0,4,3,1,500000
2039, opposite williams estate.... oke ira ogba lagos,2,1,1,1,"Tastefully finished executive one roomself contain studio apartment at OKE-IRA OGBA,Available for Rent urgently.... ... Cheap. Renovated. Security Doors. Security. Street Lights. Big Compound. Parking Space. 24 Hours Electricity. 24 Hours Security. ...",ogba,0,0,0,0,ogba1,250000.0,380000.0,300000.0,0,3,1,200000
2040, off college road ifako ogba ogba lagos,2,1,1,1,Sweet a room self contain at ogba with tiles Contact me for inspection Charlow properties 08138248835 08114761230 ... Security Doors. Security. Street Lights. 24 Hours Electricity. 24 Hours Security. ...,ogba,0,0,0,1,ogba1,250000.0,380000.0,300000.0,1,3,1,250000
2041, bintu street.... ajayi road ogba lagos,6,3,3,3,"Brand new spacious executive 2bdrm flat with all room en-suite,pop ceiling and pop wall finishing,all round tiles,imported kitchen cabinet and wardrobes,water heater,etc at AJAYI ROAD OKE-IRA OGBA,Available for Rent urgently...... ... Cheap. New. Security Doors. Free Wifi. Security. Pop Ceiling. Street Lights. All Room Ensuit. Supermarket Nearby. Parking Space. 24 Hours Electricity. 24 Hours Security. ...",ogba,1,1,1,1,ogba3,650000.0,780000.0000000001,750000.0,4,15,3,1000000
2042, oke ira ogba lagos,2,1,1,1,"A well finished executive one roomself contain studio apartment Upstairs at OKE-IRA OGBA,,Available for Rent urgently..... ... Cheap. Renovated. Security Doors. Security. Street Lights. Parking Space. 24 Hours Electricity. 24 Hours Security. ...",ogba,0,0,0,0,ogba1,250000.0,380000.0,300000.0,0,3,1,200000
2043, .. oke ira ogba lagos,6,3,3,3,newly and tastefully built all round tiles all room ensuite visitors toilet wardrobe well fitted kitchen cabinet pop fenced and gated compound etc ... Serviced. New. Children Play Ground. All Room Ensuit. Drainage System. 24 Hours Security. 24 Hours Electricity. Pop Ceiling. Street Lights. Big Compound. Restaurants Nearby. Parking Space. Fast Internet. Supermarket Nearby. ...,ogba,1,1,1,1,ogba3,650000.0,780000.0000000001,750000.0,4,15,3,1000000
2044, oke ira ogba lagos,6,3,3,3,"brand new 2bed room flat in a secured street at okeira, with pop finishing, all room ensuite, kitchen fitted cabinet. fenced and gated compound 700k downstairs and 800k upstairs ... Dry. New. All Room Ensuit. 24 Hours Security. 24 Hours Electricity. Pop Ceiling. Street Lights. Big Compound. Parking Space. Fast Internet. Supermarket Nearby. ...",ogba,0,0,0,1,ogba3,650000.0,780000.0000000001,750000.0,1,15,3,700000
2045, obawole area ifako ogba ogba lagos,4,2,2,2,Decent flat with modern facilities suitable for a working class tenant or young couple. Fenced with gate and water. no landlord in ccompound. Come and inspect today. Send someone if you don't have time. Form ... New. Serviced. 24 Hours Security. Restaurants Nearby. Security Doors. Water Treatment. Drainage System. Big Compound. Printing Service. ...,ogba,0,0,0,0,ogba2,550000.0,650000.0,625000.0,0,13,3,400000
2046, at obawole area ifako ogba ogba lagos,7,4,3,4,Decent flat with modern facilities suitable for a working class tenant or young couple. Fenced with gate and water. no landlord in ccompound. Come and inspect today. Send someone if you don't have time. Form ... Cheap. Renovated. Drainage System. 24 Hours Security. Water Treatment. Supermarket Nearby. Restaurants Nearby. All Room Ensuit. Security. Ocean View. ...,ogba,0,0,0,0,ogba4,775000.0,1080000.0,1000000.0,0,19,4,700000
2047, oke ira ogba lagos,2,1,1,1,A Luxury Room and Parlour Self Contained Flat ... ...,ogba,1,0,0,1,ogba1,250000.0,380000.0,300000.0,2,3,1,300000
2048, adekoya estate aguda(ogba) ogba lagos,9,5,4,5,Very decent and beautiful 4bedroom duplex at adekoya estate 2people in the compared ... Cheap. Renovated. Furnished. Parking Space. Water Treatment. Street Lights. Supermarket Nearby. Security. Security Doors. All Room Ensuit. Fast Internet. Pop Ceiling. Big Compound. ...,ogba,1,1,0,1,ogba5,1500000.0,1500000.0,1500000.0,3,34,6,1500000
2049, oke ira ogba lagos,3,2,1,2,"Newly built house at Oke Ira, Mini flat, for 500k per annum. Almost totally completed Painting of the entirely building starts next week ... Furnished. New. Parking Space. Water Treatment. Supermarket Nearby. Security. Security Doors. All Room Ensuit. 24 Hours Security. Pop Ceiling. Big Compound. Drainage System. ...",ogba,0,0,0,0,ogba2,550000.0,650000.0,625000.0,0,13,3,500000
2050, adekoya estate aguda(ogba) ogba lagos,7,4,3,4,Executive 3bedroom at adekoya estate very decent and beautiful new house ogba college road ... Cheap. Furnished. New. Children Play Ground. Parking Space. Water Treatment. Street Lights. Supermarket Nearby. Security. Security Doors. All Room Ensuit. Pop Ceiling. Big Compound. 24 Hours Electricity. ...,ogba,1,0,0,1,ogba4,775000.0,1080000.0,1000000.0,2,19,4,1000000
2051, kayode street ogba lagos,2,1,1,1,Mini flat in a serene street off ogba with a walking distance to ogba bus stop All round tiles and painted already pay and pack in @380k ... Cheap. Renovated. Dry. Parking Space. Water Treatment. Supermarket Nearby. Boys Quater. Restaurants Nearby. Drainage System. ...,ogba,1,1,1,1,ogba1,250000.0,380000.0,300000.0,4,3,1,380000
2052, oke ira ogba lagos,2,1,1,1,"250k per annum at Oke Ira lovely mini flat, fenced round with gate with lot of packing space and kitchen cabinets ... Cheap. Furnished. Parking Space. Water Treatment. Supermarket Nearby. Restaurants Nearby. Big Compound. Drainage System. ...",ogba,0,0,0,1,ogba1,250000.0,380000.0,300000.0,1,3,1,250000
2053, kfarm estate ifako ogba ogba lagos,6,4,2,4,"Brand New 3 bedroom all ensuite with wardbrobes at Kfarm Estate, Ogba N650k yearly rent ... Cheap. Dry. New. Parking Space. Security. Security Doors. All Room Ensuit. Big Compound. Drainage System. ...",ogba,0,0,0,0,ogba4,775000.0,1080000.0,1000000.0,0,19,4,700000
2054, college road ifako ogba ogba lagos,5,3,2,3,3bedroom off college road 500k per anum Comes with spacious parlour and kitchen ... Cheap. Parking Space. Water Treatment. Supermarket Nearby. Security. Big Compound. Drainage System. ...,ogba,0,0,0,0,ogba3,650000.0,780000.0000000001,750000.0,0,15,3,500000
2055, .. oke ira ogba lagos,2,1,1,1,2 numbers of Room self Contained at Oke Ira inside Alafia estate For N150k and N170k respectively ALSO AVAILABLE IN OGBA Decent RoomSelf Contained for N200k and N250k yearly rents ... Cheap. Dry. Parking Space. Supermarket Nearby. All Room Ensuit. Drainage System. ...,ogba,0,0,0,0,ogba1,250000.0,380000.0,300000.0,0,3,1,150000
2056, very decent and beautiful 2bedroom at ogba college road ogba lagos,4,2,2,2,Very decent and beautiful 2bedroom at ogba college road ... Cheap. Renovated. Furnished. Water Treatment. Supermarket Nearby. Fast Internet. Big Compound. ...,ogba,0,0,0,1,ogba2,550000.0,650000.0,625000.0,1,13,3,600000
2057, oyemekunstreet ogba bus stop ogba lagos,6,3,3,3,Very decent and beautiful 2bedroom flat at ogba college road ... Cheap. Furnished. New. Parking Space. Water Treatment. Supermarket Nearby. All Room Ensuit. 24 Hours Security. Fast Internet. Pop Ceiling. Big Compound. ...,ogba,0,0,0,1,ogba3,650000.0,780000.0000000001,750000.0,1,15,3,700000
2058, college road ifako ogba ogba lagos,5,3,2,3,3 bedroom apartment 2tolilets in a close off college 600k Pay and Pack In ... Cheap. Renovated. Dry. Parking Space. Supermarket Nearby. Security. Security Doors. All Room Ensuit. Restaurants Nearby. Drainage System. ...,ogba,0,0,0,0,ogba3,650000.0,780000.0000000001,750000.0,0,15,3,600000
2059, enahoro estate ogba bus stop ogba lagos,3,2,1,2,2 bedroom Blocks of Flats House for rent Enahoro estate Ogba Bus-stop Ogba Lagos ... Renovated. Pop Ceiling. All Room Ensuit. Security. Parking Space. Security Doors. 24 Hours Electricity. 24 Hours Security. Street Lights. ...,ogba,1,1,1,1,ogba2,550000.0,650000.0,625000.0,4,13,3,800000
2060, oke ira ogba lagos,5,3,2,3,Decent 2bedroom flat for for rent at Oke Ira for 800k per annum ... ...,ogba,1,1,0,1,ogba3,650000.0,780000.0000000001,750000.0,3,15,3,800000
2061, oke ira ogba lagos,4,2,2,2,Lovely 2bed room flat at Oke Ira ogba Lagos for 800k per annum ... ...,ogba,1,1,1,1,ogba2,550000.0,650000.0,625000.0,4,13,3,800000
2062, ifako ogba ogba lagos,6,3,3,3,"2bedroom flats for rent at Obawole and Okeira, call me on [redacted]. ... ...",ogba,0,0,0,1,ogba3,650000.0,780000.0000000001,750000.0,1,15,3,700000
2063, iju road ifako agege lagos,5,3,2,3,Lovely Finished All Rooms Ensuite All Round Tiled Pantry Guest Toilet Wardrobe Kitchen Cabinet Serene and Secured Estate Easy Proximity One Year Rent Accepted ... New. Parking Space. All Room Ensuit. Big Compound. Pop Ceiling. Street Lights. Drainage System. Security Doors. Security. Water Treatment. 24 Hours Security. ...,ogba,0,0,0,0,ogba3,650000.0,780000.0000000001,750000.0,0,15,3,500000
2064, kadiri street oke ira ogba lagos,2,1,1,1,This is a nice upstairs apartment with rooms all neatly tiled this kinds of apartments are sure to be snatched off the market before long...plus it's situated in a fenced secure compound with sufficient parking ... ...,ogba,1,0,0,1,ogba1,250000.0,380000.0,300000.0,2,3,1,300000
2065, oke ira ogba lagos,6,3,3,3,"A lovely and spacious 3 bedroom flat with wardrobe in all rooms all round tiled and an en suit, in a good environment ... Dry. All Room Ensuit. Big Compound. Parking Space. Water Treatment. Drainage System. ...",ogba,0,0,0,0,ogba3,650000.0,780000.0000000001,750000.0,0,15,3,600000
2066, off college road ogba lagos,7,4,3,4,Very decent 3 bedroom flat ... ...,ogba,1,0,0,1,ogba4,775000.0,1080000.0,1000000.0,2,19,4,1000000
2067, obawole ogba lagos,2,1,1,1,Room self contain ... ...,ogba,0,0,0,0,ogba1,250000.0,380000.0,300000.0,0,3,1,170000
2068, off college road ogba lagos,2,1,1,1,Decent room self contain in a secured and serene estate ... ...,ogba,0,0,0,0,ogba1,250000.0,380000.0,300000.0,0,3,1,200000
2069, ajayi road ajayi road ogba lagos,4,2,2,2,Newly Renovated All Round Tiled All Rooms Ensuite Wardrobe Kitchen Cabinet Easy Proximity Ample Parking Space One Year Rent Accepted ... Renovated. Drainage System. Big Compound. Parking Space. All Room Ensuit. 24 Hours Security. Water Treatment. Street Lights. Security. Security Doors. ...,ogba,0,0,0,0,ogba2,550000.0,650000.0,625000.0,0,13,3,450000
2070, college road ifako ogba ogba lagos,4,2,2,2,Newly Renovated All Round Tiled All Rooms Ensuite Big and Spacious Interlocked Compound Ample Parking Space Wardrobe Kitchen Cabinets Easy Proximity One Year Rent Accepted ... Renovated. Drainage System. Big Compound. Parking Space. All Room Ensuit. 24 Hours Security. Water Treatment. Street Lights. Security. Security Doors. ...,ogba,0,0,0,0,ogba2,550000.0,650000.0,625000.0,0,13,3,500000
2071, college road ifako ogba ogba lagos,2,1,1,1,"Newly Built This is d Mini apartment.It's a beautiful place.. The ground floor is for parking. Mini:- Two toilets, pop, well equipped kitchen with smoke extractor and cooking gas. The sitting rm with split Air condition. ... Serviced. New. Drainage System. Big Compound. Parking Space. Cctv Cameras. 24 Hours Security. Water Treatment. Pop Ceiling. Street Lights. Security. Security Doors. ...",ogba,1,1,1,1,ogba1,250000.0,380000.0,300000.0,4,3,1,500000
2072, near fadunsi street ajayi road ogba lagos,7,4,3,4,"Brand new executive 3bedroom flat with luxury fittings and lovely interior plus prepaid meter and adequate car park. Two toilets, spanish tiles with water heater, massive wardrobe and kitchen cabinet. Fenced with gate and water. ... Furnished. New. Serviced. Security Doors. Parking Space. Water Treatment. Drainage System. Big Compound. Security. Pop Ceiling. Restaurants Nearby. Supermarket Nearby. All Room Ensuit. 24 Hours Security. ...",ogba,1,1,1,1,ogba4,775000.0,1080000.0,1000000.0,4,19,4,1200000
2073, ogba lagos,6,3,3,3,"Decent 3 bedroom flat with 3 toilets and bath's... All rooms have wardrobe, 3 people in a compound...fenced with gate not far from the major road, ... ...",ogba,0,0,0,0,ogba3,650000.0,780000.0000000001,750000.0,0,15,3,600000
2074, ogba lagos,6,3,3,3,A decent 3 bedroom flat apartment upstairs located at a remote area in Egbeda. ... ...,ogba,0,0,0,1,ogba3,650000.0,780000.0000000001,750000.0,1,15,3,700000
2075, .. ifako ogba ogba lagos,10,5,5,5,Duplex ... Renovated. All Room Ensuit. Big Compound. Parking Space. ...,ogba,1,1,0,1,ogba5,1500000.0,1500000.0,1500000.0,3,34,6,1500000
2076, off college road ifako ogba ifako ogba ogba lagos,4,2,2,2,"*TO LET* *Nice Renovated 2 Nos of Spacious 3 Bedroom Flat with Big kitchen, Balcony @ off College Road, Ogba, Ikeja.* *2Toilets / 2bathrooms.* *Rent: 600k Per Annum, Each UP & DOWN.* ... Furnished. Cheap. Renovated. Dry. Security. Governor's Consent. Supermarket Nearby. Restaurants Nearby. Security Doors. Parking Space. 24 Hours Electricity. 24 Hours Security. Drainage System. Street Lights. Survey. Water Treatment. ...",ogba,0,0,0,1,ogba2,550000.0,650000.0,625000.0,1,13,3,600000
2077, off ajayi oke ira ogba lagos,8,4,4,4,"Brand new 3bedrooms flat at Ogba oke ira off Ajayi road, with 4 toilets and 3 baths pop ceiling with wardrobes 1m. ... New. ...",ogba,1,0,0,1,ogba4,775000.0,1080000.0,1000000.0,2,19,4,1000000
2078, ogba off ajayi road oke ira off aguda via excellence hotel. oke ira ogba lagos,5,3,2,3,"Executive brand new 2bedrooms flat at Ogba oke ira off Ajayi road via excellence hotel Aguda 2 in the compound having all rooms ensuite, upstairs, with kitchen cabinet and wardrobes. (Agt Blessing Ogba). ... New. Security. All Room Ensuit. Big Compound. Security Doors. Parking Space. 24 Hours Electricity. 24 Hours Security. ...",ogba,1,1,0,1,ogba3,650000.0,780000.0000000001,750000.0,3,15,3,800000
2079, estate ogba lagos,11,5,6,5,4 bedroom Detached Duplex House for rent Estate Ogba Lagos ... New. ...,ogba,1,1,0,1,ogba5,1500000.0,1500000.0,1500000.0,3,34,6,1500000
2080, ogba lagos,8,4,4,4,"Newly built 2 blocks of 6 numbers of 3 bedroom flats at Ogba behind excellent hotel, corporate tenant preferred, tastefully finished, pop ceiling, wardrobe in all the bedrooms, kitchen cabinets , fenced yard and gate, ... ...",ogba,1,1,1,1,ogba4,775000.0,1080000.0,1000000.0,4,19,4,1300000
2081, aguda(ogba) ogba lagos,6,3,3,3,"VERY DECENT 4 BEDROOM DUPLEX OF 3 TOILETS & 3 BATHS, FULLY TILED WITH WARDROBES, POP CEILING, WATER HEATER @ OFF COLLEGE ROAD OGBA RENT: #1,800,000 P/A ... New. Renovated. Security. Big Compound. Supermarket Nearby. Restaurants Nearby. Security Doors. Parking Space. Pop Ceiling. 24 Hours Security. ...",ogba,1,1,1,1,ogba3,650000.0,780000.0000000001,750000.0,4,15,3,1000000
2082, oke ira ogba lagos,2,1,1,1,Mini flat ... New. Big Compound. Parking Space. ...,ogba,1,1,1,1,ogba1,250000.0,380000.0,300000.0,4,3,1,380000
2083, ifako ogba ogba lagos,5,3,2,3,"Newly built lovely 2bedroom at obawole, ogba. With Pop, wardrobes, 3toilet and bath. Water heater. Rent: Up 700k down 650k.... 2 flats to share compound ... New. All Room Ensuit. Big Compound. Restaurants Nearby. Security Doors. Parking Space. Pop Ceiling. 24 Hours Security. Drainage System. Survey. ...",ogba,0,0,0,1,ogba3,650000.0,780000.0000000001,750000.0,1,15,3,650000
2084, ogba gra ogba gra ogba lagos,5,3,2,3,"Well Finished and Tastefully Adorned 2BedRoom Terrace Duplex with 3Toilet 2Bath. 2 duplexes in a Compound located within Ogba GRA, Ogba, Lagos Price: 1.2m per annual ... Renovated. Security. All Room Ensuit. Big Compound. Fast Internet. Security Doors. Parking Space. 24 Hours Electricity. Pop Ceiling. 24 Hours Security. Street Lights. ...",ogba,1,1,1,1,ogba3,650000.0,780000.0000000001,750000.0,4,15,3,1000000
2085, in a close oke ira ogba lagos,5,3,2,3,House is well built and tastefully finished with modern facilities in a decent environment (a close) ... Cheap. Dry. Furnished. All Room Ensuit. 24 Hours Security. Security. Pop Ceiling. Parking Space. Security Doors. ...,ogba,1,0,0,1,ogba3,650000.0,780000.0000000001,750000.0,2,15,3,750000
2086, ifako ijaiye ifako ogba ogba lagos,4,2,2,2,"Lovely 3brm 2t 2b@yusuf okeira upstair private staircase wit prepaid meter card, terrazole floor. 600k ... Renovated. Parking Space. 24 Hours Electricity. Gym. Security. Big Compound. Free Wifi. 24 Hours Security. ...",ogba,0,0,0,1,ogba2,550000.0,650000.0,625000.0,1,13,3,600000
2087, obawole off ogba ikeja lagos,6,3,3,3,"Well finished house with pop finishing in a secured environment,all tiles,self compound, borehole,e ... ...",ogba,1,0,0,1,ogba3,650000.0,780000.0000000001,750000.0,2,15,3,750000
2088, obawole off ogba ikeja lagos,6,3,3,3,"Well finished house with pop finishing in a secured environment,all tiles,self compound, borehole,etc ... ...",ogba,1,0,0,1,ogba3,650000.0,780000.0000000001,750000.0,2,15,3,750000
2089, ogba lagos,4,2,2,2,2 bedroom Flat / Apartment for rent Ogba Lagos ... Renovated. ...,ogba,0,0,0,1,ogba2,550000.0,650000.0,625000.0,1,13,3,600000
2090, before modupe oke ira ajayi road ogba lagos,5,3,2,3,New ly build house ... Furnished. New. Security. Drainage System. Pop Ceiling. Church Nearby. All Room Ensuit. 24 Hours Security. Supermarket Nearby. Fast Internet. ...,ogba,1,1,0,1,ogba3,650000.0,780000.0000000001,750000.0,3,15,3,800000
2091," off ayo-alabi street oke-ira, ogba ikeja lagos",6,3,3,3,"A Newly Built Luxury 2bedroom Flat with All Rooms Ensuite, wardrobes, kitchen cabinet, shower, water heater, POP, prepaid meter etc ... ...",ogba,1,0,0,1,ogba3,650000.0,780000.0000000001,750000.0,2,15,3,750000
2092, ogba ikeja lagos,7,4,3,4,"A newly built and tastefully finished luxury 3 bedroom flat with all rooms ensuite, pop, floor tiles, well paved compound, security house, water heater, metal doors, upstairs, steel pipe railed balcony, wardrobes, kitchen cabinet, spacious ... ...",ogba,1,1,1,1,ogba4,775000.0,1080000.0,1000000.0,4,19,4,1200000
2093,  toyin street ikeja lagos,8,4,4,4,The property consists of two wings of 4 bedroom duplex located in a serene environment with mixed uses of both residential and commercial. The vacant apartment is the duplex in front. All rooms are ... Supermarket Nearby. All Room Ensuit. Drainage System. Security Doors. Restaurants Nearby. Security. ...,ikeja,0,0,0,1,ikeja4,3000000.0,4000000.0,4000000.0,1,43,8,3800000
2094, allen avenue ikeja lagos,7,4,3,4,The property is a semi-detached duplex ideally for commercial use ( office use). It has good space for parking. ... Old. Supermarket Nearby. Security Doors. Security. ...,ikeja,1,1,0,1,ikeja4,3000000.0,4000000.0,4000000.0,3,43,8,4000000
2095,  opebi ikeja lagos,13,7,6,7," For more information, pricing and private viewings, please contact: ? Adeyemi: 09093272572 ?Daniel: 09093272547 Or send us a DM on Instagram @cwrelagos Twitter: @cwrelagos Facebook: @cwrelagos Email : hello@cwlagos.com Website: www.cwlagos.com ... ...",ikeja,1,1,0,1,ikeja7,6800000.0,6800000.0,6800000.0,3,58,10,6800000
2096,  ikeja gra ikeja gra ikeja lagos,9,5,4,5,Brand New And Tastefully Finished 4Units Of 4Bedroom Terrace Duplex With A Room Bq Each. Location: Ikeja Gra. Features: - Luxury Finishing - Marble Tiles - All Rooms Ensuite - Guest Toilet - Anti-Room - Dinning Area - Fitted Kitchen ... Serviced. Cheap. Dry. Swampy. New. Street Lights. Parking Space. Jacuzzi. Fast Internet. Water Treatment. Boys Quater. Drainage System. 24 Hours Security. Big Compound. Pop Ceiling. Security. All Room Ensuit. 24 Hours Electricity. Supermarket Nearby. Security Doors. ...,ikeja,0,0,0,1,ikeja5,5000000.0,5500000.0,5500000.0,1,52,9,5000000
2097,  toyin street ikeja lagos,6,3,3,3,"The property is a block of flats with the vacant apartment being a ground floor two bedrooms flat. The rooms are ensuite with guest toilet. It located in a gated street. Service charge : N 500,000 ... Old. Big Compound. Supermarket Nearby. Security Doors. Boys Quater. Security. ...",ikeja,0,0,0,1,ikeja3,1500000.0,3260000.0000000005,3000000.0,1,34,6,1500000
2098,"  ikeja gra, ikeja lagos",8,5,3,5,"FOR RENT: Luxurious and Decent (3) Bedroom Flat with a room boys quarter at Ikeja GRA, Lagos FEATURES: - The house is nicely finished and situated within an estate - Well interlocked compound - It is adorned with modern, ... ...",ikeja,0,0,0,0,ikeja5,5000000.0,5500000.0,5500000.0,0,52,9,3500000
2099,  within an estate adeniyi jones ikeja lagos,12,6,6,6,"Service and Furnished 7unit of 5bedroom Terrace Duplex with bq, airconditioning in all rooms and living rooms, inverter read,very big industrial generator, dedicated transformer, CCTV, dedicated bore hole to each duplex and intercom etc at ... New. ...",ikeja,0,0,0,0,ikeja6,6000000.0,6200000.0,6200000.0,0,56,10,5000000
2100,  ikeja gra ikeja lagos,9,5,4,5,"Newly Built and Tastefully Finished 3nos 4bedroom Terrace Duplex plus bq with Swimming Pool, CCTV Camera, Prepaid Metre each Units can park upto 4cars at Ikeja GRA, Ikeja. #7m per Unit. Note: Can be used for ... New. Swimming Pool. Pop Ceiling. Cctv Cameras. Parking Space. ...",ikeja,1,1,0,1,ikeja5,5000000.0,5500000.0,5500000.0,3,52,9,5500000
2101, abc estate adeniyi jones ikeja lagos,12,6,6,6,"A detach 6 bedroom house consisting of: 3 bedroom Guest House 2 Room Service Quarters Ante Room & Large Sitting Area Large Kitchen & Dinning Area Family Lounge Swimming Pool (Non Functional), Laundry, Gatehouse, etc. ABC The property ... Old. Cheap. Drainage System. Survey. Security. Street Lights. Big Compound. Parking Space. ...",ikeja,1,1,0,1,ikeja6,6000000.0,6200000.0,6200000.0,3,56,10,6200000
2102,"  awuse estate, opebi opebi ikeja lagos",7,4,3,4,"Nicely Located 3 Bedroom flat having all room ensuite with BQ at Awuse Estate, Opebi Ikeja, Lagos N.B: Nigerian or Expatriate can take it. Rent: 2M net ... Old. Boys Quater. Security. All Room Ensuit. Parking Space. ...",ikeja,0,0,0,0,ikeja4,3000000.0,4000000.0,4000000.0,0,43,8,2000000
2103,  near chrisland schools opebi ikeja lagos,7,4,3,4,Decent and very spacious 3bedroom. With personal staircase and prepaid meter. Only decent and working class tenants allowed. No discrimination of religion or tribe. Come and inspect today. Form fee applies for new clients. Now ... Dry. Renovated. Furnished. Drainage System. Water Treatment. Pop Ceiling. Big Compound. All Room Ensuit. Parking Space. 24 Hours Security. Restaurants Nearby. ...,ikeja,0,0,0,0,ikeja4,3000000.0,4000000.0,4000000.0,0,43,8,2000000
2104,"  awuse estate, opebi, ikeja, lagos opebi ikeja lagos",7,4,3,4,"3 bedroom Shared Apartment Flat / Apartment for rent Awuse Estate, Opebi, Ikeja, Lagos Opebi Ikeja Lagos ... Security. All Room Ensuit. ...",ikeja,0,0,0,0,ikeja4,3000000.0,4000000.0,4000000.0,0,43,8,2000000
2105,  allen allen avenue ikeja lagos,7,4,3,4,A 6 unit of 3bedroom flat. Cooperate tenants only. Each flat has a maid room. Faciliities include Swimming pool. Elevator. 2 big Generators. Own Transfgormer . well situated property. Gated. ... Serviced. New. Boys Quater. Elevator. Swimming Pool. Big Compound. All Room Ensuit. 24 Hours Electricity. 24 Hours Security. ...,ikeja,1,1,0,1,ikeja4,3000000.0,4000000.0,4000000.0,3,43,8,4000000
2106,  adeniyi jones ikeja lagos,9,5,4,5,"Executive terrace duplex with luxury fittings. with glass shower cubicle, pop ceiling, Spanish tiles, big wardrobes, big kitchen with cabinets and wall shelf plus exit door. Clean compound with prepaid meter and adequate car park. ... Furnished. New. Drainage System. Gym. Water Treatment. Security. Pop Ceiling. Big Compound. Supermarket Nearby. Parking Space. 24 Hours Security. ...",ikeja,0,0,0,0,ikeja5,5000000.0,5500000.0,5500000.0,0,52,9,3500000
2107,"  awuse estate, opebi, ikeja, lagos opebi ikeja lagos",7,4,3,4,"A lovely and spacious 4 units 3 bedroom flats having all room ensuite with BQ at Awuse Estate, Opebi, Ikeja, Lagos ... Old. Boys Quater. All Room Ensuit. Parking Space. ...",ikeja,0,0,0,0,ikeja4,3000000.0,4000000.0,4000000.0,0,43,8,2000000
2108,"  awuse estate, opebi, ikeja opebi ikeja lagos",7,4,3,4,"Newly built 12 units 3 bedroom Flats with BQ at Awuse Estate, Opebi, Ikeja, Lagos N.B: Corporate Tenants only ... New. Boys Quater. All Room Ensuit. Parking Space. ...",ikeja,0,0,0,1,ikeja4,3000000.0,4000000.0,4000000.0,1,43,8,3000000
2109,  off isaac john street ikeja gra ikeja lagos,9,5,4,5,"4 Bedroom terrace duplex for Lease. 3 years required. Rent: 5,000,000 per annum ... Serviced. New. Water Treatment. Street Lights. Swimming Pool. Security. Security Doors. All Room Ensuit. 24 Hours Security. Pop Ceiling. Big Compound. ...",ikeja,0,0,0,1,ikeja5,5000000.0,5500000.0,5500000.0,1,52,9,5000000
2110,  bamishele estate off allen opebi ikeja lagos,7,4,3,4,"This property is located within the heart of opebi ikeja with a world class finishes with a modern facility include swimming pool, fitted kitchen, all rooms fitted with AC, inverter, CCTV camera, court yard, ... Serviced. Cheap. Furnished. New. Excision. Parking Space. Street Lights. All Room Ensuit. Fast Internet. Pop Ceiling. Boys Quater. Child Care. 24 Hours Electricity. Mosques Nearby. Church Nearby. Survey. Water Treatment. Gym. Supermarket Nearby. 24 Hours Security. Free Wifi. Free Coffee. Office Supplies. Children Play Ground. Printing Service. Jacuzzi. Front Desk Service. Security Doors. Restaurants Nearby. Big Compound. Drainage System. Cctv Cameras. Ocean View. Elevator. Swimming Pool. Security. ...",ikeja,1,1,0,1,ikeja4,3000000.0,4000000.0,4000000.0,3,43,8,4000000
2111,  off allen avenue allen avenue ikeja lagos,7,4,3,4,3 bedroom Shared Apartment Flat / Apartment for rent Off Allen Avenue Allen Avenue Ikeja Lagos ... Serviced. New. Swimming Pool. Supermarket Nearby. Security Doors. All Room Ensuit. 24 Hours Security. Pop Ceiling. Boys Quater. Restaurants Nearby. Big Compound. 24 Hours Electricity. ...,ikeja,1,1,0,1,ikeja4,3000000.0,4000000.0,4000000.0,3,43,8,4000000
2112,"  off ogunlani estate, allen, ikeja. allen avenue ikeja lagos",12,6,6,6,"A newly renovated 5bedroomfully detached duplex, with one room Bq, all room ensuit, POP, finishing, Fitted kitchen cabinet, Big Dinning section, All round tiles, All rooms have wardrobe, Ample Parking space, in an Estate in ... Cheap. Renovated. Furnished. Dry. Children Play Ground. Parking Space. Street Lights. Security Doors. All Room Ensuit. Fast Internet. Pop Ceiling. Boys Quater. Big Compound. Drainage System. Supermarket Nearby. Security. 24 Hours Security. ...",ikeja,0,0,0,0,ikeja6,6000000.0,6200000.0,6200000.0,0,56,10,4700000
2113, aba johnson street adeniyi jones ikeja lagos,15,8,7,8,7 Bedroom Detached House with a 3 Bedroom Bungalow on 1200m2 ... Renovated. Security. Parking Space. Church Nearby. Boys Quater. Drainage System. Swimming Pool. Water Treatment. 24 Hours Security. Pop Ceiling. Big Compound. ...,ikeja,1,1,0,1,ikeja8,7000000.0,7000000.0,7000000.0,3,59,10,7000000
2114,"  awuse estate, obepi, ikeja, lagos opebi ikeja lagos",4,2,2,2,2 (Nos) 3 Bedroom Flat in a Block of 6 Flats Rent: N2m/ Annum ... Security. All Room Ensuit. Parking Space. Boys Quater. Drainage System. 24 Hours Security. Big Compound. ...,ikeja,1,1,1,1,ikeja2,950000.0,1540000.0000000002,1300000.0,4,25,5,2000000
2115,  adeniyi jones ikeja lagos,12,6,6,6,"7 units 5 bedroom service and partially furnished luxury duplex with bq, air conditioning, wireless internet service, inverter, with batteries, sound proof sliding doors,Dstv/terrestrial TV,smoke detector in living room and kitchen. Top notch fittings and fixtures,large ... ...",ikeja,0,0,0,0,ikeja6,6000000.0,6200000.0,6200000.0,0,56,10,5500000
2116, oba aladejobi street ikeja gra ikeja lagos,7,4,3,4,"An Exquisite Well Finished and Partly Furnished 8 (Nos) 3 Bedroom Flats with a Room BQ Each at Oba Aladejobi Street, Ikeja GRA. The Block of flats is about 90 Percent Completion ... New. Dry. Furnished. All Room Ensuit. Gym. Elevator. Parking Space. Church Nearby. Boys Quater. Drainage System. Mosques Nearby. 24 Hours Security. Big Compound. Supermarket Nearby. Street Lights. Swimming Pool. Restaurants Nearby. ...",ikeja,1,1,0,1,ikeja4,3000000.0,4000000.0,4000000.0,3,43,8,4000000
2117,"  alhaji basheer shittu street magodo shangisha phase 2, ikeja lagos",11,6,5,6,"Brandnew 8 Units of 5 Bedroom ( all ensuite) luxurious terrace building 2 living room, fitted kitchen, study room, ample parking, bq, laundry room, gym, lush greengarden/recreation area, LOCATION:Alh Basheer Shittu Street, Magodo Estate ( Perfect and prime for a corporate tenant). *Rent:* 6M/ Unit Minimum of ... ...",ikeja,0,0,0,1,ikeja6,6000000.0,6200000.0,6200000.0,1,56,10,6000000
2118,  ikeja gra ikeja gra ikeja lagos,9,5,4,5,IKEJA G R A TO LET/SALE Newly Tasteful Built 3 Nos of 4 Bedrooms Terrace Duplex with a Room Bq LOCATION: Ikeja G R A Ikeja Lagos. Rent N6.5 Millions Naira a Year Each. SALE N150 ... New. Jacuzzi. Boys Quater. Security. All Room Ensuit. Big Compound. Parking Space. Pop Ceiling. Street Lights. C Of O. ...,ikeja,1,1,0,1,ikeja5,5000000.0,5500000.0,5500000.0,3,52,9,5500000
2119,  alfred garden estate oregun ikeja oregun ikeja lagos,7,4,3,4,"Fully furnished 3 bedroom terrace duplex, 2 living rooms with BQ LOCATION: Alfred Garden Estate, Ikeja. Estate is fully secured, exclusive and serviced with pool, gym, club house, children recreation area etc Rent: #5.5m SC. ... Serviced. Jacuzzi. Boys Quater. Security. All Room Ensuit. Big Compound. Parking Space. 24 Hours Electricity. Pop Ceiling. 24 Hours Security. ...",ikeja,1,1,0,1,ikeja4,3000000.0,4000000.0,4000000.0,3,43,8,4000000
2120,"  adeniyi jones ikeja, adeniyi jones ikeja lagos",7,4,3,4,A nice & serviced 3 bedroom flat with a room BQ *Location* Adeniyi Jones Ikeja *Rent* 2M net *Service charge* 404K Which covers 24 Hours Power supply Proximity to every location Clean and adequate water supply. Security Cleaners Gardening services etc ... ...,ikeja,0,0,0,0,ikeja4,3000000.0,4000000.0,4000000.0,0,43,8,2000000
2121,  in an estate at adeniyi jones ikeja lagos adeniyi jones ikeja lagos,11,6,5,6,Very nice spacious and well maintained 5bedroom Semi-detached duplex with a room BQ and security house Price: 3.2m net LOCATION: in Estate at ADENIYI JONES ikeja Lagos ... Jacuzzi. Boys Quater. Security. Parking Space. Pop Ceiling. ...,ikeja,0,0,0,0,ikeja6,6000000.0,6200000.0,6200000.0,0,56,10,4700000
2122,  ikeja gra ikeja lagos,7,4,3,4,"Letting: 3 bedroom terraced Duplex with One Room BQ at GRA, Ikeja Features: All rooms en-suite Fitted Kitchen Serviced with Swimming Pool Needs slight renovation Rental Price: 3.5m Service Charge: 2m Agency Commission: 10% Legal Fee: 10% ... Renovated. Boys Quater. Parking Space. Swimming Pool. Pop Ceiling. ...",ikeja,0,0,0,1,ikeja4,3000000.0,4000000.0,4000000.0,1,43,8,3200000
2123,  ikeja gra ikeja lagos,9,5,4,5,"Letting: Beautifully finished 4 Bedroom Terraced Duplex at GRA, Ikeja Features: All Rooms En-suite 1 Room BQ Fitted Kitchen with Heat Extractor, Gas Hubs, Oven and Microwave Oven Fully Serviced with 24 hours Power & Security, Swimming Pool, Waste Disposal Rental ... Boys Quater. All Room Ensuit. Parking Space. 24 Hours Electricity. 24 Hours Security. ...",ikeja,1,1,0,1,ikeja5,5000000.0,5500000.0,5500000.0,3,52,9,5500000
2124,  adekunle fajuyi ikeja gra ikeja lagos,3,2,1,2,Very nice and spacious 1bedroom Apartment Price:1m per annum Location: Adekunle Fajuyi Rd Ikeja Gra ... Security. Parking Space. ...,ikeja,0,0,0,1,ikeja2,950000.0,1540000.0000000002,1300000.0,1,25,5,1000000
2125,"  kay farm estate, obawale, ogba ikeja lagos",5,3,2,3,"Just Out...... Newly built lovely 2bedroom LOCATION:kfarm estate obawole ogba. With Pop, wardrobes, 3toilet and bath. Water heater. Price: Up 700k down 650k.... ... ...",ikeja,0,0,0,0,ikeja3,1500000.0,3260000.0000000005,3000000.0,0,34,6,900000
2126,  ikeja gra ikeja lagos,9,5,4,5,"Letting: Beautifully finished 4 Bedroom terraced Duplex at GRA, Ikeja Features: All Rooms En-suite 1 Room BQ Fitted Kitchen with Heat Extractor, Gas Hubs, Oven and Microwave Oven Fully Serviced with 24 hours Power & Security, Waste Disposal Rental Price: 7.5m Service ... Boys Quater. All Room Ensuit. Parking Space. 24 Hours Electricity. Pop Ceiling. 24 Hours Security. ...",ikeja,1,1,0,1,ikeja5,5000000.0,5500000.0,5500000.0,3,52,9,5500000
2127,  allen avenue ikeja lagos,8,5,3,5,Newly Built Luxury 3bedroom semi detached duplex with a room Boys Quarter in a serene environment with fitted kitchen cabinets and fitted facilities Price: 3m per annum LOCATION: off Allen Avenue ikeja Lagos ... New. Jacuzzi. Boys Quater. Security. All Room Ensuit. Big Compound. Security Doors. Parking Space. Pop Ceiling. 24 Hours Security. ...,ikeja,0,0,0,0,ikeja5,5000000.0,5500000.0,5500000.0,0,52,9,3500000
2128,  - ikeja gra ikeja lagos,9,5,4,5,"Leasing: Beautifully finished 4 Bedroom semi-detached Duplexes at GRA, Ikeja Features: All rooms en-suite One Room BQ Complex serviced with Gym House and Pool 6 units available All renting to a Single Corporate Tenant or maximum of two Corporate Tenants to ... Boys Quater. All Room Ensuit. Parking Space. Pop Ceiling. ...",ikeja,1,1,0,1,ikeja5,5000000.0,5500000.0,5500000.0,3,52,9,5500000
2129,  allen avenue ikeja lagos,7,4,3,4,Newly Built Luxury 3BEDROOM flats all rooms ensuite with fitted kitchen cabinets and spacious compound Price: 2million per annum LOCATION: off Allen Avenue ikeja Lagos ... New. Security. All Room Ensuit. Parking Space. Pop Ceiling. ...,ikeja,0,0,0,0,ikeja4,3000000.0,4000000.0,4000000.0,0,43,8,2000000
2130, titilope street omole estate ph1 agidingbi ikeja lagos,11,6,5,6,To let 5 bedroom semi detached duplex with a room Bq inside Omole Estate ph1 price N5000000 five millions naira only slightly negotiable ... Serviced. Furnished. Renovated. Cheap. Parking Space. Children Play Ground. Pop Ceiling. Drainage System. Fast Internet. Big Compound. Security Doors. Water Treatment. All Room Ensuit. Boys Quater. Cctv Cameras. Street Lights. 24 Hours Security. Security. Jacuzzi. Elevator. ...,ikeja,0,0,0,0,ikeja6,6000000.0,6200000.0,6200000.0,0,56,10,5000000
2131, ... toyin street ikeja lagos,8,4,4,4,"4 Bedroom flat apartment for short let for 60,000 Naira per day located off Toyin street, Ikeja. All rooms en suite. ... All Room Ensuit. Parking Space. Pop Ceiling. ...",ikeja,0,0,0,0,ikeja4,3000000.0,4000000.0,4000000.0,0,43,8,2000000
2132, off adeniyi jones adeniyi jones ikeja lagos,14,6,8,6,8 bedroom full detached duplex in a massive spacious compound for commercial purposes in a well secured Estate. Has a spacious compound that can park 20 cars at once. Rent is 5 Million per annum ... Renovated. Security Doors. Children Play Ground. Security. Street Lights. Big Compound. Supermarket Nearby. Parking Space. 24 Hours Electricity. 24 Hours Security. ...,ikeja,0,0,0,0,ikeja6,6000000.0,6200000.0,6200000.0,0,56,10,5000000
2133, akiode ojodu...... ikeja lagos,6,3,3,3,"Tastefully finished executive 3bdrm flat with spacious master bedroom at AKIODE OJODU,Available for Rent Urgently..... ... Cheap. Renovated. Security Doors. Security. Street Lights. Big Compound. Parking Space. 24 Hours Electricity. 24 Hours Security. ...",ikeja,0,0,0,0,ikeja3,1500000.0,3260000.0000000005,3000000.0,0,34,6,900000
2134," omole ph.1,estate..... ikeja lagos",2,1,1,1,"Tastefully finished executive mini flat with wardrobe at OMOLE PH.1,ESTATE,Available for Rent urgently...... ... Cheap. Renovated. Security Doors. Security. Pop Ceiling. Street Lights. Parking Space. 24 Hours Electricity. 24 Hours Security. ...",ikeja,1,1,1,1,ikeja1,500000.0,800000.0,685000.0,4,11,2,800000
2135," omole ph.1,estate.. ikeja lagos",10,5,5,5,"Tastefully finished executive 4bdrm terrace duplex with Bq,all room en-suite SELF COMPOUND at OMOLE PH.1,ESTATE...Available for Rent Urgently... ... Renovated. Security Doors. Security. Pop Ceiling. Street Lights. All Room Ensuit. Parking Space. 24 Hours Electricity. 24 Hours Security. ...",ikeja,0,0,0,0,ikeja5,5000000.0,5500000.0,5500000.0,0,52,9,3500000
2136, off opebi road opebi ikeja lagos,8,4,4,4,"Luxurious and serviced 2 units 4 bedrooms flat on first floor at off opebi Road Opebi, Ikeja. Rent: N3million SC: N500,000 ... ...",ikeja,0,0,0,1,ikeja4,3000000.0,4000000.0,4000000.0,1,43,8,3000000
2137, joel ogunike ikeja gra. lagos mainland ikeja gra ikeja lagos,10,5,5,5,Executive 5bed Rooms Size Office Space at Ikeja GRA. Good road secured environment and It has all amenities a good and nice Office should has. ... Drainage System. Boys Quater. Water Treatment. Security Doors. Security. Street Lights. All Room Ensuit. Parking Space. Fast Internet. 24 Hours Security. ...,ikeja,0,0,0,0,ikeja5,5000000.0,5500000.0,5500000.0,0,52,9,4000000
2138, .river valley estate.ojodu berger. ikeja lagos,10,5,5,5,"Tastefully finished executive 4bdrm duplex with all room en-suite SELF COMPOUND at RIVER VALLEY ESTATE,Ojodu berger,Available for Rent Urgently. ... Cheap. Renovated. Security Doors. Security. Pop Ceiling. Street Lights. All Room Ensuit. Parking Space. 24 Hours Electricity. 24 Hours Security. ...",ikeja,0,0,0,0,ikeja5,5000000.0,5500000.0,5500000.0,0,52,9,3500000
2139," ogundele street, ajayi rd.ogba.... ikeja lagos",4,2,2,2,"Tastefully finished executive 2bdrm flat with master bedroom,4 occupants only in the compound at AJAYI ROAD OKE-IRA OGBA,Available for Rent urgently..... ... Cheap. Renovated. Security Doors. Security. Street Lights. Parking Space. 24 Hours Electricity. 24 Hours Security. ...",ikeja,0,0,0,0,ikeja2,950000.0,1540000.0000000002,1300000.0,0,25,5,800000
2140, - adeniyi jones ikeja lagos,7,4,3,4,clean tasfully built pop all room ensuite all round tiles well fitted kitchen cabinet ... Serviced. New. Security. Pop Ceiling. Street Lights. Big Compound. All Room Ensuit. Parking Space. Fast Internet. 24 Hours Electricity. 24 Hours Security. Restaurants Nearby. ...,ikeja,0,0,0,0,ikeja4,3000000.0,4000000.0,4000000.0,0,43,8,2500000
2141," adeniyi jones, ikeja, lagos adeniyi jones ikeja lagos",6,3,3,3,"This is an Open plan office space on 3floors measuring 443sqm with parking, along Adeniyi Jones, Ikeja, Lagos. ... New. ...",ikeja,1,1,1,1,ikeja3,1500000.0,3260000.0000000005,3000000.0,4,34,6,3500000
2142, olowora ojodu berger ikeja lagos olowora ojodu lagos,7,4,3,4,*TO LET* 3 Bedrooms Duplex at Magodo Isheri Rent: N1.5 Millions. Call Femi on [redacted] or WhatsApp no [redacted]. ... Cheap. Dry. Security Doors. Security. Pop Ceiling. Big Compound. All Room Ensuit. Parking Space. 24 Hours Security. ...,ikeja,0,0,0,0,ikeja4,3000000.0,4000000.0,4000000.0,0,43,8,2000000
2143, olowora..berger ojodu. ikeja lagos,4,2,2,2,"Tastefully finished executive brand new 2bdrm flat with master bedroom,pop, at OLOWORA,Ojodu berger,Available for Rent urgently...... ... Cheap. New. Security Doors. Security. Pop Ceiling. Street Lights. Big Compound. All Room Ensuit. Parking Space. 24 Hours Electricity. 24 Hours Security. ...",ikeja,0,0,0,0,ikeja2,950000.0,1540000.0000000002,1300000.0,0,25,5,800000
2144, budland estate ojodu..... ikeja lagos,8,4,4,4,"Tastefully finished executive pent house 3bdrm flat upstairs all room en-suite at BUDLAND ESTATE,OJODU BESIDE OJODU GRAMMAR SCHOOL,Available for Rent Urgently...... ... Cheap. Renovated. Security Doors. Security. Pop Ceiling. Street Lights. Big Compound. All Room Ensuit. Parking Space. 24 Hours Electricity. 24 Hours Security. ...",ikeja,0,0,0,0,ikeja4,3000000.0,4000000.0,4000000.0,0,43,8,2000000
2145, olutoye crescent adeniyi jones ikeja lagos,13,7,6,7,"IKEJA TOLET/LEASE DIRECT BRIEF 6 Bedrooms Fully Detached Duplex with 4 Rooms Bq on 2500sqm (4 Plots) at Adeniyi Jones Ikeja Lagos. It's Good for School, Hospital and Cooperate Office. Rent N7 Millions Naira a ... Cheap. Dry. Boys Quater. Security Doors. Governor's Consent. Children Play Ground. Security. Big Compound. All Room Ensuit. Parking Space. 24 Hours Security. ...",ikeja,1,1,0,1,ikeja7,6800000.0,6800000.0,6800000.0,3,58,10,6800000
2146, fani kayode ikeja gra ikeja lagos,9,5,4,5,IKEJA G R A TOLET/SALE DIRECT BRIEF Newly Tasteful Built 3 Nos of 4 Bedrooms Terrace Duplex with a Room Bq at Ikeja G R A Ikeja Lagos. Rent N6.5 Millions Naira a Year Each. ... Cheap. Furnished. New. Drainage System. Security Doors. Child Care. Pop Ceiling. Big Compound. Cctv Cameras. All Room Ensuit. Parking Space. 24 Hours Security. Boys Quater. Water Treatment. Children Play Ground. Security. Jacuzzi. ...,ikeja,1,1,0,1,ikeja5,5000000.0,5500000.0,5500000.0,3,52,9,5500000
2147, by okupe estate maryland ikeja lagos,8,4,4,4,"4 bedroom terrace duplex for rent with a room bq by Okupe Estate Anthony - Maryland, Lagos All in one lovely big compound with CCTV camera everywhere Rent: N4 Million Naira per annum Donâ€™t miss this offer, call ... Security. Supermarket Nearby. Restaurants Nearby. ...",ikeja,1,1,0,1,ikeja4,3000000.0,4000000.0,4000000.0,3,43,8,4000000
2148, afred garden oregun ikeja lagos,4,2,2,2,"This property is located in oregun at Alfred garden estate in oregun its a very clean spacious executively built mini flat in a highly serene well secured estate (alfred garden). well fitted kitchen cabinet, wadrobes. ... ...",ikeja,1,0,1,1,ikeja2,950000.0,1540000.0000000002,1300000.0,3,25,5,1500000
2149, ikeja g r a ikeja lagos ikeja gra ikeja lagos,9,5,4,5,TOLET Newly Tasteful Built 3 Nos of 4 Bedrooms Terrace Duplex with a Room Bq at Ikeja G R A Ikeja Lagos. Rent N7 Millions Naira a Year . Call Femi on 08023049893 or WhatsApp no 08034124358. ... Cheap. Serviced. Dry. Furnished. New. Security Doors. Governor's Consent. Pop Ceiling. Big Compound. Cctv Cameras. All Room Ensuit. Parking Space. 24 Hours Security. Boys Quater. Water Treatment. Children Play Ground. Security. Jacuzzi. ...,ikeja,1,1,0,1,ikeja5,5000000.0,5500000.0,5500000.0,3,52,9,5500000
2150, oduduwa street ikeja g r a ikeja lagos ikeja gra ikeja lagos,9,5,4,5,IKEJA G R A TOLET/SALE DIRECT BRIEF Newly Tasteful Built 3 Nos of 4 Bedrooms Terrace Duplex with a Room Bq at Ikeja G R A Ikeja Lagos. Rent N6.5 Millions Naira a Year Each. ... Cheap. Furnished. New. Security Doors. Child Care. Pop Ceiling. C Of O. Street Lights. Big Compound. Cctv Cameras. All Room Ensuit. Parking Space. 24 Hours Security. Boys Quater. Water Treatment. Children Play Ground. Security. ...,ikeja,1,1,0,1,ikeja5,5000000.0,5500000.0,5500000.0,3,52,9,5500000
2151," opposite omole ph.1,estate gate.... agidingbi ikeja lagos",2,1,1,1,"Brand new executive one roomself contain studio apartment at AKIODE AREA OJODU,OPPOSITE OMOLE PH.1,ESTATE GATE,Available for Rent Urgently...... ... Cheap. New. Security Doors. Security. Street Lights. Parking Space. 24 Hours Electricity. 24 Hours Security. ...",ikeja,0,0,0,0,ikeja1,500000.0,800000.0,685000.0,0,11,2,400000
2152, cement mangoro mangoro ikeja lagos,8,4,4,4,"Superb 3bedroom flat Apartment, with wardrobe kitchen cabinet all tiles floor. With pop ceiling, Serene and Secured Environment. In an Estate at Cement Ikeja Lagos ... Cheap. Renovated. Furnished. Pop Ceiling. Supermarket Nearby. Parking Space. 24 Hours Electricity. 24 Hours Security. ...",ikeja,0,0,0,0,ikeja4,3000000.0,4000000.0,4000000.0,0,43,8,2000000
2153, opebi opebi ikeja lagos,7,4,3,4,standard 3 bed room flat at ikeja in good location with god road network ... Furnished. Security Doors. Security. Pop Ceiling. Street Lights. Big Compound. All Room Ensuit. Supermarket Nearby. Jacuzzi. 24 Hours Electricity. 24 Hours Security. ...,ikeja,0,0,0,0,ikeja4,3000000.0,4000000.0,4000000.0,0,43,8,2300000
2154, g.r.a ikeja gra ikeja lagos,11,6,5,6,This massive 5 bedroom duplex is fully furnished. ... Serviced. Furnished. Big Compound. All Room Ensuit. ...,ikeja,1,1,0,1,ikeja6,6000000.0,6200000.0,6200000.0,3,56,10,6200000
2155, ikeja ikeja gra ikeja lagos,9,5,4,5,Newly built 4 bedroom duplex. ... New. ...,ikeja,1,1,0,1,ikeja5,5000000.0,5500000.0,5500000.0,3,52,9,5500000
2156, ... maryland ikeja lagos,8,4,4,4,"TO LET A superd units of ensuite 3bedrooms flat + 1rm bq in a nice area of Maryland, ideal for expatriate, corporate organization and so on - N2.2m per annum Price_ #2.2m per annum ... ...",ikeja,0,0,0,0,ikeja4,3000000.0,4000000.0,4000000.0,0,43,8,2200000
2157, fani kayode street ikeja ikeja gra ikeja lagos,9,5,4,5,IKEJA G R A TOLET/SALE DIRECT BRIEF Newly Tasteful Built 3 Nos of 4 Bedrooms Terrace Duplex with a Room Bq at Ikeja G R A Ikeja Lagos. Rent N6.5 Millions Naira a Year Each. ... Cheap. New. Security Doors. Child Care. Pop Ceiling. Big Compound. Cctv Cameras. All Room Ensuit. Parking Space. 24 Hours Security. Boys Quater. Water Treatment. Children Play Ground. Security. Jacuzzi. ...,ikeja,1,1,0,1,ikeja5,5000000.0,5500000.0,5500000.0,3,52,9,5500000
2158, onipetesi estate mangoro ikeja lagos,3,1,2,1,A portable 2 bedroom flat (1 toilet and bathroom) Rent :400k Agency : 60k Legal: 60k Caution: 30k ... ...,ikeja,0,0,0,0,ikeja1,500000.0,800000.0,685000.0,0,11,2,400000
2159, valley estate cement ikeja cement agege lagos,6,3,3,3,"Executive 3bedroom flat Apartment, with wardrobe kitchen cabinet all tiles floor pop ceiling. Hygiene water supply, Serene and Very Secured Enivronment, At Valley Estate Cement Ikeja Lagos ... Cheap. Furnished. New. Pop Ceiling. Supermarket Nearby. Parking Space. 24 Hours Electricity. 24 Hours Security. ...",ikeja,0,0,0,0,ikeja3,1500000.0,3260000.0000000005,3000000.0,0,34,6,900000
2160," ladipo kuku street, off allen avenue, lagos. toyin street ikeja lagos",5,3,2,3,"The property is a 3bedroom flat that is off Toyin street and Allen Avenue, Ikeja. It is easily accessible and newly renovated with bq on the ground floor. The Master's bedroom is ensiut with regular ... Renovated. Parking Space. ...",ikeja,0,0,0,0,ikeja3,1500000.0,3260000.0000000005,3000000.0,0,34,6,1000000
2161, oduduwa avenue ikeja lagos ikeja gra ikeja lagos,9,5,4,5,IKEJA G R A TOLET DIRECT BRIEF Newly Tasteful Built 3 Nos of 4 Bedrooms Terrace Duplex with a Room Bq at Ikeja G R A Ikeja Lagos. Rent N7 Millions Naira a Year Each. ... Cheap. Dry. Furnished. New. Security Doors. Child Care. Pop Ceiling. C Of O. Big Compound. Cctv Cameras. All Room Ensuit. Parking Space. 24 Hours Security. Boys Quater. Water Treatment. Children Play Ground. Security. ...,ikeja,1,1,0,1,ikeja5,5000000.0,5500000.0,5500000.0,3,52,9,5500000
2162, fani kayode street ikeja g r a ikeja lagos ikeja gra ikeja lagos,9,5,4,5,IKEJA G R A TOLET/SALE DIRECT BRIEF Newly Tasteful Built 3 Nos of 4 Bedrooms Terrace Duplex with a Room Bq at Ikeja G R A Ikeja Lagos. Rent N6.5 Millions Naira a Year Each. ... Cheap. Serviced. Dry. New. Security Doors. Pop Ceiling. C Of O. Street Lights. Big Compound. Cctv Cameras. All Room Ensuit. Parking Space. 24 Hours Security. Boys Quater. Water Treatment. Children Play Ground. Security. Jacuzzi. ...,ikeja,1,1,0,1,ikeja5,5000000.0,5500000.0,5500000.0,3,52,9,5500000
2163, . allen avenue ikeja lagos,12,6,6,6,5 bedroom duplex new house all room en suite with security @ Ikeja GRA price 4 millon naira ... New. ...,ikeja,0,0,0,0,ikeja6,6000000.0,6200000.0,6200000.0,0,56,10,4700000
2164, .. adeniyi jones ikeja lagos,6,3,3,3,superclean pop all round tiles all room ensuite interlocking compound prepaid meter fenced and gated ... Old. Dry. Pop Ceiling. Big Compound. All Room Ensuit. Parking Space. Fast Internet. 24 Hours Electricity. 24 Hours Security. ...,ikeja,0,0,0,0,ikeja3,1500000.0,3260000.0000000005,3000000.0,0,34,6,1400000
2165, ikeja g r a ikeja lagos ikeja gra ikeja lagos,9,5,4,5,IKEJA G R A TOLET DIRECT BRIEF Newly Tasteful Built 3 Nos of 4 Bedrooms Terrace Duplex with a Room Bq at Ikeja G R A Ikeja Lagos. Rent N7 Millions Naira a Year Each. ... Cheap. Dry. New. Boys Quater. Governor's Consent. Big Compound. Cctv Cameras. All Room Ensuit. Parking Space. 24 Hours Security. ...,ikeja,1,1,0,1,ikeja5,5000000.0,5500000.0,5500000.0,3,52,9,5500000
2166, ikeja gra ikeja lagos,2,1,1,1,clean pop all round tiles big compound ... Old. Dry. Security. All Room Ensuit. 24 Hours Electricity. Pop Ceiling. Big Compound. Restaurants Nearby. Parking Space. Fast Internet. ...,ikeja,1,1,1,1,ikeja1,500000.0,800000.0,685000.0,4,11,2,1000000
2167, ikeja gra ikeja lagos,4,2,2,2,"super clean 1 sitting room all round tiles interlocking compound 1bedroom, 2toilet, serviced apartment fancy fitted kitchen and store, and packing space with fence gate. ... Old. Serviced. Dry. Cheap. Security. All Room Ensuit. 24 Hours Security. 24 Hours Electricity. Pop Ceiling. Street Lights. Big Compound. Restaurants Nearby. Parking Space. Fast Internet. Supermarket Nearby. ...",ikeja,0,0,0,1,ikeja2,950000.0,1540000.0000000002,1300000.0,1,25,5,1000000
2168," off awolowo way,ikeja obafemi awolowo way ikeja lagos",7,4,3,4,"3 Bedroom flat all rooms ensuite plus visitors toilet and an ample parking space for letting at off awolowo way,ikeja.The rent is 1 million naira.minimum rent of 1 year.The property is suitable for 100% Residential ... Parking Space. Mosques Nearby. Church Nearby. Supermarket Nearby. Security Doors. All Room Ensuit. Pop Ceiling. Restaurants Nearby. Big Compound. ...",ikeja,0,0,0,0,ikeja4,3000000.0,4000000.0,4000000.0,0,43,8,2000000
2169, adeniyi jones ikeja lagos,12,8,4,8,"Location: Ikeja Industrial For Lease warehouse capacity of 24,111 sqft with office space , concrete design all around, spacious compound good for storage or manufacturing at Ikeja industrial area ikeja Lagos. Rent rent 1300 per sqft ... Cheap. 24 Hours Security. Big Compound. ...",ikeja,1,1,0,1,ikeja8,7000000.0,7000000.0,7000000.0,3,59,10,7000000
2170, ikeja gra ikeja lagos,7,4,3,4,"For Rent 3 Bedroom luxury apartment with Bq stylish and tastefully finished offering an exquisite, spacious and bright interior combining beautiful period features with stunning contemporary, Fitted Modern Separate Kitchen,GYM, HOT TUB, POOL, swimming pool ... Serviced. New. Children Play Ground. Jacuzzi. Street Lights. Security Doors. All Room Ensuit. Pop Ceiling. Boys Quater. Big Compound. Drainage System. 24 Hours Electricity. Cctv Cameras. Water Treatment. Gym. Swimming Pool. Security. 24 Hours Security. ...",ikeja,1,1,0,1,ikeja4,3000000.0,4000000.0,4000000.0,3,43,8,4000000
2171, off toyin street toyin street ikeja lagos,6,3,3,3,"4 Bedroom Duplex with 3toilets/3 bathrooms for letting at off toyin street,ikeja.The rent is 1.5 million naira per anum.minimum rent of 1 year.The property is suitable for both Residential & Commercial Purpose ... Parking Space. Mosques Nearby. Church Nearby. Street Lights. Supermarket Nearby. 24 Hours Security. Restaurants Nearby. Big Compound. ...",ikeja,0,0,0,1,ikeja3,1500000.0,3260000.0000000005,3000000.0,1,34,6,1500000
2172," off toyin street,ikeja toyin street ikeja lagos",6,3,3,3,"Standard and sizeable 3 Bedroom flat with 3 toilet3/3 bathrooms,2 rooms ensuite for letting at off toyin street,ikeja.The rent is 900,000 naira.minimum rent of 1 year,(prefarably family).The property is suitable for 100% Residential Purpose ... Parking Space. Mosques Nearby. Church Nearby. Water Treatment. Street Lights. Supermarket Nearby. Security. All Room Ensuit. 24 Hours Security. Restaurants Nearby. Big Compound. ...",ikeja,0,0,0,0,ikeja3,1500000.0,3260000.0000000005,3000000.0,0,34,6,900000
2173, ikeja gra ikeja lagos,10,6,4,6,"5 units of luxury 4 bedroom terrace duplexes tastefully finished. It consists of 4 bedrooms all en-suite bedrooms, 2 balconies, 2 living rooms, a fitted kitchen, a store, Interlocked paving stone external flooring, walk ways ... Serviced. Cheap. Renovated. Dry. Parking Space. Street Lights. Security Doors. All Room Ensuit. Pop Ceiling. Boys Quater. Big Compound. Drainage System. 24 Hours Electricity. Water Treatment. Swimming Pool. Supermarket Nearby. Security. 24 Hours Security. ...",ikeja,0,0,0,0,ikeja6,6000000.0,6200000.0,6200000.0,0,56,10,4700000
2174, adeniyi jones ikeja lagos,7,4,3,4,"New House of 6 Units 3 Bedroom luxury apartments with Bq stylish and tastefully finished offering an exquisite, spacious and bright interior combining beautiful period features with stunning contemporary located at Akura Villas Adeniye Jones Fully ... Serviced. Cheap. Renovated. Dry. Parking Space. Street Lights. Security Doors. All Room Ensuit. Pop Ceiling. Boys Quater. Restaurants Nearby. Big Compound. Drainage System. 24 Hours Electricity. Water Treatment. Gym. Supermarket Nearby. Security. 24 Hours Security. ...",ikeja,0,0,0,1,ikeja4,3000000.0,4000000.0,4000000.0,1,43,8,3000000
2175, peace estate oregun ikeja lagos,9,5,4,5,4 bedroom terrace duplex 2 sitting rooms with a room boy quarter all rooms ensuite wih AC serviced in Peace Estate oregun Ikeja Rent 2.5M ... Serviced. Cheap. Parking Space. Water Treatment. Street Lights. Security. All Room Ensuit. 24 Hours Security. Boys Quater. Big Compound. Drainage System. ...,ikeja,0,0,0,0,ikeja5,5000000.0,5500000.0,5500000.0,0,52,9,3500000
2176, salvation opebi ikeja lagos,2,1,1,1,"A Room Self Contain for letting at off opebi by salvation street,ikeja.The rent is 300,000 naira.minimum rent of 1 year.The property is suitable for 100% Residential Purpose ... Renovated. New. Parking Space. Mosques Nearby. Church Nearby. Supermarket Nearby. All Room Ensuit. 24 Hours Security. Restaurants Nearby. ...",ikeja,0,0,0,0,ikeja1,500000.0,800000.0,685000.0,0,11,2,400000
2177, off awolowo way obafemi awolowo way ikeja lagos,9,5,4,5,"Brand New 4 Bedroom Fully Detached Duplex plus a room bq for lease at off awolowo way,ikeja.The rent is 3 million naira,minimum rent of 2 years.The property is suitable for both Residential and Commercial Purpose. ... New. Parking Space. Mosques Nearby. Church Nearby. Street Lights. Supermarket Nearby. Security. Security Doors. All Room Ensuit. 24 Hours Security. Pop Ceiling. Restaurants Nearby. Big Compound. ...",ikeja,0,0,0,0,ikeja5,5000000.0,5500000.0,5500000.0,0,52,9,3500000
2178, alausa ikeja lagos,7,4,3,4,"For Rent Newly built 3 bedroom fully detached duplex (all en-suite) Stylish And Tastefully Finished Offering An Exquisite, Spacious And Bright Interior Combining Beautiful Period Features With Stunning Contemporary, 2 balconies, 2 living rooms, a ... Cheap. Children Play Ground. Parking Space. Street Lights. Security Doors. All Room Ensuit. Pop Ceiling. Restaurants Nearby. Big Compound. Drainage System. Water Treatment. Supermarket Nearby. Security. 24 Hours Security. ...",ikeja,0,0,0,1,ikeja4,3000000.0,4000000.0,4000000.0,1,43,8,3500000
2179, off awolowo way obafemi awolowo way ikeja lagos,2,1,1,1,"Mini Flat for letting at off awolowo way,ikeja.The rent is 500,000 naira.Minimum rent of 1 year.The property is suitable for 100% Residential Purpose. ... Renovated. Parking Space. Mosques Nearby. Church Nearby. Street Lights. Supermarket Nearby. Security. All Room Ensuit. 24 Hours Security. Restaurants Nearby. Big Compound. ...",ikeja,0,0,0,1,ikeja1,500000.0,800000.0,685000.0,1,11,2,500000
2180, off oregun oregun ikeja lagos,2,1,1,1,"Newly Renovated Mini Flat for letting at off Oregun,ikeja.The rent is 500,000 naira.minimum rent of 1 year.The property is suitable for 100% Residential Purpose ... Renovated. Parking Space. Mosques Nearby. Church Nearby. Street Lights. Supermarket Nearby. Security. 24 Hours Security. Restaurants Nearby. Big Compound. ...",ikeja,0,0,0,1,ikeja1,500000.0,800000.0,685000.0,1,11,2,500000
2181, off allen avenue allen avenue ikeja lagos,2,1,1,1,"Room Self Contain for letting at off allen avenue,ikeja.The rent is 400,000 naira.minimum rent of 1 year.The property is suitable for 100% Residential Purpose ... Renovated. Parking Space. Mosques Nearby. Church Nearby. Supermarket Nearby. Security. All Room Ensuit. 24 Hours Security. Restaurants Nearby. Big Compound. ...",ikeja,0,0,0,0,ikeja1,500000.0,800000.0,685000.0,0,11,2,400000
2182, off awolowo way obafemi awolowo way ikeja lagos,6,3,3,3,"4 bedroom duplex for letting at off awolowo way,ikeja.The rent is 1.500,000 naira.minimum rent of 1 year.The property is suitable for Both Residential & Commercial Purpose ... Renovated. Parking Space. Mosques Nearby. Church Nearby. Street Lights. Supermarket Nearby. Security. Restaurants Nearby. ...",ikeja,0,0,0,1,ikeja3,1500000.0,3260000.0000000005,3000000.0,1,34,6,1500000
2183, off awolowo way awolowo way ikeja lagos,4,2,2,2,"2 Bedroom flat with 2 toilets/2 bathrooms for letting at off awolowo way,ikeja.The rent is 800,000 naira.minimum rent of 1 year.The property is suitable for 100% Residential Purpose ... Renovated. Parking Space. Mosques Nearby. Church Nearby. Supermarket Nearby. Security. Security Doors. 24 Hours Security. Restaurants Nearby. Big Compound. ...",ikeja,0,0,0,0,ikeja2,950000.0,1540000.0000000002,1300000.0,0,25,5,800000
2184, omole phase 1 ikeja gra ikeja lagos,12,6,6,6,"It is a newly renovated house in a serene neighborhood with a spacious parking space, self compound, all rooms ensuite. The roads to accessed the house are well tarred. There is also quarter's for workers ... Renovated. Furnished. New. Children Play Ground. Parking Space. Jacuzzi. Security Doors. All Room Ensuit. Fast Internet. Pop Ceiling. Boys Quater. Restaurants Nearby. Big Compound. Drainage System. Water Treatment. Swimming Pool. Security. ...",ikeja,0,0,0,1,ikeja6,6000000.0,6200000.0,6200000.0,1,56,10,6000000
2185, off allen avenue allen avenue ikeja lagos,2,1,1,1,"Room Self Contain in a secure estate for letting at off allen avenue,ikeja.The rent is 300,000 naira.minimum rent of 1 year.The property is suitable for 100% Residential Purpose ... Renovated. Parking Space. Mosques Nearby. Church Nearby. Street Lights. Supermarket Nearby. Security. All Room Ensuit. 24 Hours Security. Restaurants Nearby. Big Compound. ...",ikeja,0,0,0,0,ikeja1,500000.0,800000.0,685000.0,0,11,2,400000
2186, oduduwa crescent ikeja gra ikeja lagos,11,6,5,6,5 bedroom Detached Bungalow House for rent Oduduwa crescent Ikeja GRA Ikeja Lagos ... ...,ikeja,1,1,0,1,ikeja6,6000000.0,6200000.0,6200000.0,3,56,10,6200000
2187, alausa ikeja lagos,7,4,3,4,"For Rent Newly build 3 bedroom duplex with, Bq (all en-suite) Stylish And Tastefully Finished Offering An Exquisite, Spacious And Bright Interior big balconies, 2 living rooms, a store, Fitted Modern Kitchen, , Security ... Serviced. Cheap. New. Children Play Ground. Street Lights. Security Doors. All Room Ensuit. Pop Ceiling. Boys Quater. Restaurants Nearby. Big Compound. Drainage System. Water Treatment. Supermarket Nearby. Security. 24 Hours Security. ...",ikeja,0,0,0,1,ikeja4,3000000.0,4000000.0,4000000.0,1,43,8,3500000
2188, ikeja gra ikeja lagos,7,4,3,4,"For Rent: New house 3 bedroom flat offering an exquisite, spacious and bright interior combining beautiful period features with stunning contemporary styling which is tastefully finished and beautifully presented at GRA Ikeja Fully tile, Granite and ... Serviced. New. Parking Space. Jacuzzi. Street Lights. Security Doors. All Room Ensuit. Pop Ceiling. Boys Quater. Big Compound. Drainage System. 24 Hours Electricity. Cctv Cameras. Water Treatment. Gym. Swimming Pool. Supermarket Nearby. Security. 24 Hours Security. ...",ikeja,1,1,0,1,ikeja4,3000000.0,4000000.0,4000000.0,3,43,8,4000000
2189, salvation opebi ikeja lagos,2,1,1,1,"Mini Flat for letting at opebi by salvation street,ikeja.The rent is 400,000 naira.minimum rent of 1 year.The property is suitable for 100% Residential Purpose ... Renovated. Parking Space. Mosques Nearby. Church Nearby. Street Lights. Supermarket Nearby. Security. Restaurants Nearby. Big Compound. ...",ikeja,0,0,0,0,ikeja1,500000.0,800000.0,685000.0,0,11,2,400000
2190, off awolowo way obafemi awolowo way ikeja lagos,2,1,1,1,"Newly Renovated 2 units mini flat for letting at off awolowo way,ikeja.The rent is 1 million naira for each unit.minimum rent of 1 year.The property is suitable for 100% Residential Purpose ... Renovated. Parking Space. Mosques Nearby. Church Nearby. Street Lights. Supermarket Nearby. Security. 24 Hours Security. Restaurants Nearby. Big Compound. ...",ikeja,1,1,1,1,ikeja1,500000.0,800000.0,685000.0,4,11,2,1000000
2191, ikeja gra ikeja lagos,7,4,3,4,"For Rent newly renovated 3 Bedroom luxury apartment with Bq, serviced and tastefully finished offering an exquisite, spacious and bright interior combining beautiful features with stunning contemporary, Fitted Modern Separate Kitchen, swimming pool, at at ... Serviced. Renovated. New. Jacuzzi. Street Lights. Swimming Pool. Security. Security Doors. All Room Ensuit. 24 Hours Security. Pop Ceiling. Boys Quater. Big Compound. 24 Hours Electricity. ...",ikeja,1,1,0,1,ikeja4,3000000.0,4000000.0,4000000.0,3,43,8,4000000
2192, allen avenue ikeja lagos,8,4,4,4,Furnished apartment ... Renovated. Parking Space. 24 Hours Electricity. Big Compound. All Room Ensuit. Pop Ceiling. 24 Hours Security. ...,ikeja,0,0,0,1,ikeja4,3000000.0,4000000.0,4000000.0,1,43,8,3000000
2193, oregun ikeja lagos,6,3,3,3,3bedroom flat ... Renovated. Big Compound. Parking Space. ...,ikeja,0,0,0,0,ikeja3,1500000.0,3260000.0000000005,3000000.0,0,34,6,1000000
2194, ladoke akintola off isaac john ikeja gra ikeja gra ikeja lagos,8,4,4,4,Duplex for lease at Ikeja Gra very commercial use ... Big Compound. Parking Space. C Of O. Pop Ceiling. Street Lights. Supermarket Nearby. Security Doors. Drainage System. All Room Ensuit. Security. Water Treatment. Cctv Cameras. ...,ikeja,1,1,0,1,ikeja4,3000000.0,4000000.0,4000000.0,3,43,8,4000000
2195, remi fani kayode ikeja gra ikeja lagos,11,5,6,5,A newly built 5 bedroom duplex in a serene neighborhood ... New. Street Lights. Drainage System. Church Nearby. Boys Quater. Security. Water Treatment. Restaurants Nearby. Big Compound. Parking Space. Pop Ceiling. Supermarket Nearby. Security Doors. All Room Ensuit. Cctv Cameras. Mosques Nearby. ...,ikeja,1,1,0,1,ikeja5,5000000.0,5500000.0,5500000.0,3,52,9,5500000
2196, amore street off toyin allen ikeja allen avenue ikeja lagos,9,5,4,5,A 4 Bedrooms Duplex with BQ in a Serene Neighborhood ... Serviced. Renovated. Furnished. Street Lights. Church Nearby. Boys Quater. Security. Water Treatment. Restaurants Nearby. Big Compound. Parking Space. Pop Ceiling. Supermarket Nearby. 24 Hours Security. Security Doors. All Room Ensuit. Mosques Nearby. ...,ikeja,0,0,0,0,ikeja5,5000000.0,5500000.0,5500000.0,0,52,9,3800000
2197," abel oreniyi street, awuse estate, opebi ikeja opebi ikeja lagos",7,4,3,4,A 3 Bedrooms Flat with BQ in a Serene Neighborhood ... Serviced. Renovated. Furnished. 24 Hours Electricity. Children Play Ground. Street Lights. Church Nearby. Boys Quater. Security. Water Treatment. Restaurants Nearby. Big Compound. Parking Space. Pop Ceiling. Supermarket Nearby. 24 Hours Security. Security Doors. All Room Ensuit. Swimming Pool. ...,ikeja,0,0,0,0,ikeja4,3000000.0,4000000.0,4000000.0,0,43,8,2500000
2198, ikeja lagos,8,4,4,4,"A 4 bedroom duplex for rent with all rooms ensuite, palour with toilet, space for dinning, kitchen with cabinet and parking space in the compound. Location - Ikeja Rent - 3M ... ...",ikeja,0,0,0,1,ikeja4,3000000.0,4000000.0,4000000.0,1,43,8,3000000
2199, ikeja lagos,8,4,4,4,"A 4 bedroom duplex for rent with all rooms ensuite, palour with toilet, space for dinning, kitchen with cabinet and parking space in the compound. Location - Ikeja Rent - 2M ... ...",ikeja,0,0,0,0,ikeja4,3000000.0,4000000.0,4000000.0,0,43,8,2000000
2200, ikeja lagos,4,2,2,2,"A serviced 2 bedroom flat for rent with all rooms ensuite, palour with toilet, space for dinning, fitted kitchen wit cabinet, gas cooker, water heater etc, standby generator, swimming pool and parking space in the ... ...",ikeja,1,1,1,1,ikeja2,950000.0,1540000.0000000002,1300000.0,4,25,5,2200000
2201, ikeja gra ikeja lagos,8,4,4,4,"A very tasteful and lovely 3 bedroom mini flat apartment for - 2. 5m with ultra modern facilities used, very accessible and tied road network, it has unit dedicated prepaid metre, it is simply one ... ...",ikeja,0,0,0,0,ikeja4,3000000.0,4000000.0,4000000.0,0,43,8,2500000
2202, ikeja gra ikeja lagos,10,5,5,5,"Very tasteful and lovely 4 bedroom duplex apartment with ultra modern facilities used, very accessible and tied road network, it has unit dedicated prepaid metre, it is simply one of the best apartment available for ... Security. Parking Space. Church Nearby. 24 Hours Electricity. Mosques Nearby. 24 Hours Security. Restaurants Nearby. Big Compound. ...",ikeja,0,0,0,0,ikeja5,5000000.0,5500000.0,5500000.0,0,52,9,4000000
2203, ikeja lagos,10,5,5,5,"Very tasteful and lovely 4 bedroom detached duplex apartment with ultra modern facilities used, very accessible and tied road network, it has unit dedicated prepaid metre, it is simply one of the best apartment available ... ...",ikeja,0,0,0,0,ikeja5,5000000.0,5500000.0,5500000.0,0,52,9,3500000
2204, ... adeniyi jones ikeja lagos,8,4,4,4,"Exquisitely finished 3bedroom Flats in an Estate at Adeniyi Jones Very tasteful, gated, round with fence, security incline area, clean environment, enormous car park, good tap water and borehole, tiled, all axis motorable, academically inclined ... ...",ikeja,0,0,0,0,ikeja4,3000000.0,4000000.0,4000000.0,0,43,8,2700000
2205, adeniyi jones ikeja lagos,10,5,5,5,"Exquisitely finished 4 bedroom detached duplex at adeniyi jones estate Very tasteful, gated, round with fence, security incline area, clean environment, enormous car park, good tap water and borehole, tiled, all axis motor able, academically ... ...",ikeja,0,0,0,0,ikeja5,5000000.0,5500000.0,5500000.0,0,52,9,3500000
2206, opebi ikeja lagos,10,5,5,5,"Exquisitely finished 4 Bedroom Terrace Duplex Available Off Opebi Very tasteful, gated, round with fence, security incline area, clean environment, enormous car park, good tap water and borehole, tiled, all axis motorable, academically inclined environment, ... ...",ikeja,0,0,0,0,ikeja5,5000000.0,5500000.0,5500000.0,0,52,9,3500000
2207, ikeja lagos,6,3,3,3,"Exquisitely finished 2 bedroom apartment at omole gra Very tasteful, gated, round with fence, security incline area, clean environment, enormous car park, good tap water and borehole, tiled, all axis motorable, academically inclined environment, corporate ... ...",ikeja,0,0,0,1,ikeja3,1500000.0,3260000.0000000005,3000000.0,1,34,6,1500000
2208, ikeja gra ikeja lagos,6,3,3,3,"A exquisitely and lovely 2 bedroom mini flat at ikeja gra - 1. 8m very tasteful, gated, round with fence, security incline area, clean environment, enormous car park, good tap water and borehole, tiled, all ... Parking Space. Church Nearby. Supermarket Nearby. 24 Hours Electricity. Mosques Nearby. 24 Hours Security. Restaurants Nearby. ...",ikeja,0,0,0,1,ikeja3,1500000.0,3260000.0000000005,3000000.0,1,34,6,1800000
2209, ikeja lagos,3,2,1,2,"A very fantastic and Very tasteful mini flat at omole gra, gated, round with fence, security incline area, clean environment, enormous car park, good tap water and borehole, tiled, all axis motorable, academically inclined environment, ... Security. 24 Hours Electricity. Mosques Nearby. 24 Hours Security. Restaurants Nearby. Big Compound. ...",ikeja,0,0,0,0,ikeja2,950000.0,1540000.0000000002,1300000.0,0,25,5,800000
2210, ikeja lagos,10,5,5,5,"A massive and lovely 4 bedroom duplex apartment with ultra modern facilities used, very accessible and tied road network, it has unit dedicated prepaid metre, it is simply one of the best apartment available for ... ...",ikeja,0,0,0,0,ikeja5,5000000.0,5500000.0,5500000.0,0,52,9,3500000
2211, ikeja gra ikeja gra ikeja lagos,8,4,4,4,3 bedroom Flat / Apartment for rent Ikeja GRA Ikeja GRA Ikeja Lagos ... Serviced. New. Security. All Room Ensuit. Boys Quater. Supermarket Nearby. 24 Hours Electricity. Swimming Pool. 24 Hours Security. Pop Ceiling. ...,ikeja,1,1,0,1,ikeja4,3000000.0,4000000.0,4000000.0,3,43,8,4000000
2212, ikeja gra ikeja lagos,8,4,4,4,"Exquisitely finished 3 bedroom apartment at omole gra Very tasteful, gated, round with fence, security incline area, clean environment, enormous car park, good tap water and borehole, tiled, all axis motorable, academically inclined environment, corporate ... Security. Parking Space. Church Nearby. Supermarket Nearby. 24 Hours Electricity. Mosques Nearby. 24 Hours Security. Restaurants Nearby. Big Compound. ...",ikeja,0,0,0,0,ikeja4,3000000.0,4000000.0,4000000.0,0,43,8,2500000
2213, ... opebi ikeja lagos,10,5,5,5,"Exquisitely finished 4 Bedrooms Semi Detached Duplex with a Bq Inside an Estate at Opebi Very tasteful, gated, round with fence, security incline area, clean environment, enormous car park, good tap water and borehole, tiled, ... ...",ikeja,0,0,0,0,ikeja5,5000000.0,5500000.0,5500000.0,0,52,9,3500000
2214, ikeja lagos,3,2,1,2,"Exquisitely finished mini flat at adeniyi jones estate Very tasteful, gated, round with fence, security incline area, clean environment, enormous car park, good tap water and borehole, tiled, all axis motorable, academically inclined environment, corporate ... Church Nearby. Supermarket Nearby. 24 Hours Electricity. Mosques Nearby. 24 Hours Security. ...",ikeja,0,0,0,0,ikeja2,950000.0,1540000.0000000002,1300000.0,0,25,5,800000
2215, adeniyi jones ikeja lagos,6,3,3,3,"Very tasteful and lovely 2 bedroom luxury apartment at adeniyi jones estate with ultra modern facilities used, very accessible and tied road network, it has unit dedicated prepaid metre, it is simply one of the ... ...",ikeja,0,0,0,1,ikeja3,1500000.0,3260000.0000000005,3000000.0,1,34,6,1500000
2216," awuse estate, opebi opebi ikeja lagos",11,6,5,6,Jus out to let in Awuse estate. Opebi A nice and modern 5 bedroom semi detached duplex * Has all room ensuite * Has a compound of it's own * Has a paved compound Note : Ideal for commercial ... Pop Ceiling. 24 Hours Security. All Room Ensuit. Water Treatment. Big Compound. ...,ikeja,0,0,0,0,ikeja6,6000000.0,6200000.0,6200000.0,0,56,10,4700000
2217, showemimo str ikeja gra ikeja gra ikeja lagos,9,5,4,5,"To Let: A 4 Bedroom Terrace duplex with a Room boysquarter at Oladipo Bateye street, off Sowemimo road, ikeja GRA, Lagos. All the Rooms are ensuit with Visitors toilet. Well Finished and furnished apartment in a serene ... Cheap. Furnished. New. Water Treatment. Pop Ceiling. Big Compound. Security Doors. 24 Hours Security. All Room Ensuit. Boys Quater. Parking Space. ...",ikeja,0,0,0,1,ikeja5,5000000.0,5500000.0,5500000.0,1,52,9,5000000
2218, akora estate adeniyi jones ikeja lagos,9,5,4,5,Lovely 4bedroom duplex Semi detached with self compound Easy access Security Lovely estate ... Furnished. Boys Quater. Street Lights. Big Compound. All Room Ensuit. Security Doors. Parking Space. 24 Hours Security. ...,ikeja,0,0,0,0,ikeja5,5000000.0,5500000.0,5500000.0,0,52,9,3500000
2219, allen avenue road ikeja allen avenue ikeja lagos,7,4,3,4,Executive 3bedroom ground floor office use Cleaner environment Easy access Good location ... Renovated. Furnished. 24 Hours Security. All Room Ensuit. Big Compound. Security Doors. Street Lights. Water Treatment. ...,ikeja,0,0,0,0,ikeja4,3000000.0,4000000.0,4000000.0,0,43,8,2000000
2220," salvation bus stop opebi ikeja, lagos opebi ikeja lagos",5,3,2,3,3 bedroom office space On a major road Easy access Upstairs Good for any kind of business ... Supermarket Nearby. Parking Space. Water Treatment. Big Compound. Restaurants Nearby. Street Lights. ...,ikeja,0,0,0,0,ikeja3,1500000.0,3260000.0000000005,3000000.0,0,34,6,1400000
2221, ikeja lagos,2,1,1,1," A room & palour self contain for rent with a palour, bedroom, kitchen with cabinet, toilet & bathroom and parking space in the compound. ... ...",ikeja,1,0,0,1,ikeja1,500000.0,800000.0,685000.0,2,11,2,700000
2222, ikeja lagos,6,3,3,3,"A 5 units of 3 bedroom flat for rent with all rooms ensuite, palour with toilet, space for dinning, kitchen with cabinet, a room BQ for each flat and parking space in the compound for ... ...",ikeja,1,0,0,1,ikeja3,1500000.0,3260000.0000000005,3000000.0,2,34,6,3000000
2223, ikeja lagos,12,6,6,6,"A 6 bedroom fully detached duplex for rent with all rooms ensuite, palour with toilet, space for dinning, family palour up stairs, kichen with cabinet, a room BQ & parking space inn the compound. Location - ... ...",ikeja,1,1,0,1,ikeja6,6000000.0,6200000.0,6200000.0,3,56,10,6200000
2224, ikeja lagos,6,3,3,3,"A 3 bedroom flat for rent with masters bedroom ensuite while 2 rooms share toilet & bathroom, palour with toilet, space for dinning, kitchen with cabinet and parking space in the compound. Location - ikeja Rent ... ...",ikeja,1,0,0,1,ikeja3,1500000.0,3260000.0000000005,3000000.0,2,34,6,3000000
2225, opebi ikeja lagos,6,3,3,3,3 bedroom Flat / Apartment for rent Opebi Ikeja Lagos ... ...,ikeja,0,0,0,1,ikeja3,1500000.0,3260000.0000000005,3000000.0,1,34,6,1500000
2226, arowojobe estate marylandland maryland ikeja lagos,10,5,5,5,"JUST OUT TO LET A very spacious & newly renovated 5 bedrm duplex with bq and security house ,all en-suite , self compound all floor tiled, spacious kitchen, prepaid meter , very massive ... Renovated. Furnished. Cheap. Dry. Serviced. Cctv Cameras. Pop Ceiling. Drainage System. Survey. Supermarket Nearby. Children Play Ground. All Room Ensuit. Boys Quater. 24 Hours Security. C Of O. Restaurants Nearby. Street Lights. Water Treatment. Big Compound. 24 Hours Electricity. Security. Parking Space. ...",ikeja,0,0,0,0,ikeja5,5000000.0,5500000.0,5500000.0,0,52,9,3500000
2227, toyin street ikeja lagos,4,2,2,2,3bedroom flat ... Renovated. Parking Space. Big Compound. ...,ikeja,1,0,0,1,ikeja2,950000.0,1540000.0000000002,1300000.0,2,25,5,1300000
2228, ikeja lagos,2,1,1,1,"A mini flat for rent which includes a bedroom, palour, kitchen, toilet & bathroom. ... ...",ikeja,1,1,1,1,ikeja1,500000.0,800000.0,685000.0,4,11,2,800000
2229, ikeja lagos,8,4,4,4,"A 4 bedroom semi detached duplex for rent with all rooms ensuite, palour with toilet, space for dinning, kitchen with cabinet and parking space in the compound. ... ...",ikeja,1,1,0,1,ikeja4,3000000.0,4000000.0,4000000.0,3,43,8,4000000
2230, ikeja lagos,6,3,3,3,"A 3 bedroom flat for rent with masters bedroom ensuite, 2 bedroom share toilet & bathroom, palour with toilet, kitchen with cabinet and parking space in the compound. ... ...",ikeja,0,0,0,1,ikeja3,1500000.0,3260000.0000000005,3000000.0,1,34,6,2000000
2231, ikeja lagos,6,3,3,3,"A 3 bedroom flat for rent with masters bedroom ensuite, 2 rooms share toilet & bathroom, palour, kitchen with cabinet and parking space in the com[pound. ... ...",ikeja,0,0,0,1,ikeja3,1500000.0,3260000.0000000005,3000000.0,1,34,6,1500000
2232, toyin street ikeja lagos,6,3,3,3,3bedroom flat ... Renovated. Big Compound. Parking Space. All Room Ensuit. Pop Ceiling. ...,ikeja,0,0,0,1,ikeja3,1500000.0,3260000.0000000005,3000000.0,1,34,6,1500000
2233, oregun oregun ikeja lagos,2,1,1,1,Newly Renovated All Round Tiled Big and Spacious Fenced Round With Gate Water Available Easy Proximity One Year Rent Accepted Good Light Secured Location Kitchen Cabinet ... Renovated. Big Compound. Parking Space. 24 Hours Security. Water Treatment. Street Lights. Security. Security Doors. ...,ikeja,0,0,0,0,ikeja1,500000.0,800000.0,685000.0,0,11,2,400000
2234, off toyin street toyin street ikeja lagos,2,1,1,1,Lovely Finished Executive Serene and Secured Estate Big and Spacious All Round Tiled Kitchen Cabinet Wardrobe Interlocked Compound Ample Parking Space Easy Proximity One Year Rent Accepted ... Renovated. Big Compound. Parking Space. All Room Ensuit. 24 Hours Security. Water Treatment. Street Lights. Security. Security Doors. ...,ikeja,0,0,0,1,ikeja1,500000.0,800000.0,685000.0,1,11,2,650000
2235, adeniyi jones ikeja lagos,11,6,5,6,5 bedroom Terraced Duplex House for rent Adeniyi Jones Ikeja Lagos ... Renovated. Furnished. Cctv Cameras. 24 Hours Electricity. All Room Ensuit. Big Compound. Jacuzzi. Parking Space. Pop Ceiling. Boys Quater. Fast Internet. 24 Hours Security. ...,ikeja,0,0,0,0,ikeja6,6000000.0,6200000.0,6200000.0,0,56,10,5000000
2236, ikeja lagos,8,4,4,4,"A well tiled, beautiful 4 bedroom semi detached duplex is available for rent in ikeja It has a spacious living room and is very close to the main road. The house is located in a clean ... ...",ikeja,0,0,0,1,ikeja4,3000000.0,4000000.0,4000000.0,1,43,8,3000000
2237, ikeja lagos,6,3,3,3,"3 bedroom fully detached apartment with three toilet, two bathrooms space for car park with security house ... ...",ikeja,1,1,1,1,ikeja3,1500000.0,3260000.0000000005,3000000.0,4,34,6,3500000
2238, ikeja lagos,6,3,3,3,"A renovated house three bedroom apartment with three toilet, two bathrooms space for car park with security house fence rounds and with gate Price-4 million naira per annum Total Package--6.8 million naira ... ...",ikeja,1,1,1,1,ikeja3,1500000.0,3260000.0000000005,3000000.0,4,34,6,3500000
2239, ikeja lagos,6,3,3,3,"A well tiled, beautiful 3 bedroom flat is available for rent in Ikeja It has a spacious living room and is very close to the main road. The house is located in a clean and ... ...",ikeja,0,0,0,1,ikeja3,1500000.0,3260000.0000000005,3000000.0,1,34,6,2800000
2240, ikeja lagos,6,3,3,3,"A 2 units of 3 bedroom serviced flat for rent with all rooms ensuite, palour with toilet, space for dinning, fitted kitchen with cabinet, fridge, microwave, deep freezer, oven, AC, elevator, swimming pool, standby generator ... ...",ikeja,1,1,1,1,ikeja3,1500000.0,3260000.0000000005,3000000.0,4,34,6,3500000
2241, ikeja lagos,6,3,3,3,"A serviced 3 bedroom flat for rent with all rooms ensite, palour with toilet, space for dinning, kitchen with cabinet,gas cooker, washing machine, AC, swimming & a BQ etc pool and parking space in the ... ...",ikeja,0,0,0,1,ikeja3,1500000.0,3260000.0000000005,3000000.0,1,34,6,2500000
2242, adeniyi jones ikeja lagos,11,6,5,6,A Bar and 4 Bedroom Duplex For Rent at Adeniyi Jones IK775 ... ...,ikeja,0,0,0,0,ikeja6,6000000.0,6200000.0,6200000.0,0,56,10,5000000
2243, 0 ikeja gra ikeja lagos,13,7,6,7,"Leasing: Commercial 6 Bedroom detached Duplex on Large Grounds at GRA, Ikeja Features: 2 Living Rooms 6 en-suite Bedrooms 2 Rooms BQ Sited on 3377sqm Needs a lot of renovation 6 month rent moratorium to be granted to accommodate renovations Lease Price:Â  N12m ... ...",ikeja,1,1,0,1,ikeja7,6800000.0,6800000.0,6800000.0,3,58,10,6800000
2244," shangisha phase 2, magodo, ikeja lagos",9,5,4,5,. ... ...,ikeja,0,0,0,0,ikeja5,5000000.0,5500000.0,5500000.0,0,52,9,3500000
2245, allen allen avenue ikeja lagos,6,3,3,3,"Tastefully finished house all round tiles ,all ensuit wardrobe , very lovely and decent place , serene environment. ... Cheap. Renovated. Security. All Room Ensuit. Big Compound. Security Doors. Parking Space. 24 Hours Security. Street Lights. ...",ikeja,0,0,0,1,ikeja3,1500000.0,3260000.0000000005,3000000.0,1,34,6,2000000
2246, awuse estate opebi ikeja lagos,9,5,4,5,"Letting: Fully furnished 4 Bedroom Apartment at Awuse Estate, Opebi Features: Fully furnished Living and Bedrooms All Bedrooms en-suite Fully serviced with 24 hours Power and Swimming Pool Rental Price: 5m P.A. Agency Commission: 10% of total consideration Legal Fee: 10% ... Furnished. All Room Ensuit. Parking Space. 24 Hours Electricity. Swimming Pool. Pop Ceiling. ...",ikeja,0,0,0,1,ikeja5,5000000.0,5500000.0,5500000.0,1,52,9,5000000
2247, ikeja gra ikeja lagos,7,4,3,4,3 Bedroom Flat for Rent at Ikeja GRA IK815 ... ...,ikeja,0,0,0,1,ikeja4,3000000.0,4000000.0,4000000.0,1,43,8,3500000
2248, at ikeja gra ikeja lagos,5,3,2,3,This is an amazing 2 bedroom serviced flat located in a quiet serenity here in maryland crescent Maryland. Description: â€¢ 2 bedroom flat fully serviced â€¢ Standard swimming pool â€¢ Good road network â€¢ Amazing accessibility to all major banks ... Serviced. New. Cctv Cameras. Big Compound. Restaurants Nearby. Security Doors. 24 Hours Security. Drainage System. Street Lights. Church Nearby. Jacuzzi. Mosques Nearby. Security. All Room Ensuit. Supermarket Nearby. Parking Space. 24 Hours Electricity. Swimming Pool. Pop Ceiling. Water Treatment. ...,ikeja,1,0,0,1,ikeja3,1500000.0,3260000.0000000005,3000000.0,2,34,6,3000000
2249," omole phase 2, ikeja lagos",11,6,5,6,5 bedroom fully detached house with ACs in all the rooms and nicely finished for 2.5 million. Omole phase 2. Call for Immediate inspection ... ...,ikeja,0,0,0,0,ikeja6,6000000.0,6200000.0,6200000.0,0,56,10,4700000
2250, ikeja omole omole phase 2 ojodu lagos,8,4,4,4,Direct letting Newly built 10 nos of 3bedrooms in omole phase 2 The owner wants a company that can take all...2m per units ... ...,ikeja,0,0,0,0,ikeja4,3000000.0,4000000.0,4000000.0,0,43,8,2000000
2251, . ikeja gra ikeja lagos,7,4,3,4,"Letting: Fully Furnished 3 Bedroom Flat at GRA, Ikeja Features: Exquisitely finished 3 en-suite Bed Rooms 2 Living Rooms One Room BQ Lush green, well-manicured compound. Fitted Kitchen with Heat Extractor, Gas Hubs, Refrigerator/Freezer, Oven, Microwave Oven and Washing Machine Bathroom finished with ... Serviced. Boys Quater. All Room Ensuit. Gym. Parking Space. Swimming Pool. Pop Ceiling. 24 Hours Security. ...",ikeja,1,1,0,1,ikeja4,3000000.0,4000000.0,4000000.0,3,43,8,4000000
2252, 0 ikeja gra ikeja lagos,11,6,5,6,"For Rent:- Exquisitely Finished 5 Bedroom Detached House with 2 rooms servants quarters on 700sqm of land. Located at Ladoke Akintola street, Gra Ikeja, Lagos. Price:- N15million per annum ... Boys Quater. ...",ikeja,1,1,0,1,ikeja6,6000000.0,6200000.0,6200000.0,3,56,10,6200000
2253, awuse estate off opebi opebi ikeja lagos,7,4,3,4,A lovely apartment for rent in a beautiful Awuse Estate off Opebi ikeja with w bq Rent 3.5m Brokers 10% Legal 10% Security deposit 10% No service charge Call us @ Vicals Property and Real Estate ... Serviced. Renovated. Boys Quater. Governor's Consent. Cctv Cameras. Big Compound. Restaurants Nearby. Security Doors. 24 Hours Security. Security. All Room Ensuit. Supermarket Nearby. Parking Space. 24 Hours Electricity. C Of O. Water Treatment. ...,ikeja,0,0,0,1,ikeja4,3000000.0,4000000.0,4000000.0,1,43,8,3500000
2254, off isaac john street ikeja gra ikeja lagos,9,5,4,5,"Tastefully finished serviced 4 Bedroom Terrace Duplex. Rent: 5,000,000 per annum Term: 3 years Please Note that 3 years Lease prefer. ... ...",ikeja,0,0,0,1,ikeja5,5000000.0,5500000.0,5500000.0,1,52,9,5000000
2255, . ikeja gra ikeja lagos,7,4,3,4,"Letting: Serviced 3 Bedroom Flat at GRA, Ikeja Features: Brand new and well finished 2 en-suite Rooms Fitted Kitchen Bathroom finished with Jacuzzi and nice shower cubicles Spacious Compound Serviced with Swimming Pool, 24 hours security and Generator back-up Rental Price: 4m Agency Fee: ... ...",ikeja,1,1,0,1,ikeja4,3000000.0,4000000.0,4000000.0,3,43,8,4000000
2256, adeniyi jones ikeja lagos,6,3,3,3,2bedroom flat ... Renovated. All Room Ensuit. Big Compound. Parking Space. ...,ikeja,0,0,0,0,ikeja3,1500000.0,3260000.0000000005,3000000.0,0,34,6,1000000
2257, 0 adeniyi jones ikeja lagos,9,5,4,5,"Letting: 4 Bedroom Terraced Duplex at Adeniyi Jones Brand new Apartment All Rooms en-suite One Room BQ Fitted Kitchen with Heat Extractor, Gas Cooker, Oven and Microwave Oven All Rooms fitted with AC Located in a Serviced mini- Estate Off ... Boys Quater. All Room Ensuit. Gym. Parking Space. Swimming Pool. Pop Ceiling. ...",ikeja,0,0,0,0,ikeja5,5000000.0,5500000.0,5500000.0,0,52,9,4000000
2258, .. opebi ikeja lagos,8,4,4,4,3bedroom flat ... Renovated. Boys Quater. All Room Ensuit. Big Compound. Parking Space. Pop Ceiling. ...,ikeja,0,0,0,0,ikeja4,3000000.0,4000000.0,4000000.0,0,43,8,2000000
2259, mobolaji bank anthony way ikeja lagos,9,5,4,5,"A newly built four bedroom duplex in a private estate estate at ikeja. The estate is tarred and serene, has 24 hr security and ample supply of electricity. The sitting is ridiculously large and neatly ... New. Security. All Room Ensuit. Big Compound. Supermarket Nearby. 24 Hours Electricity. 24 Hours Security. Street Lights. ...",ikeja,1,1,0,1,ikeja5,5000000.0,5500000.0,5500000.0,3,52,9,5500000
2260, 1 adeniyi jones ikeja lagos,7,4,3,4,"Letting: Block of Flats Off Adeniyi Jones, Ikeja Features: 7 Flats available One BQ per Flat Master Bedroom en-suite Adequate Parking Space Generator House All Units Letting to Single Corporate Tenant Rental Price: 10.5m P.A (1.5m per Flat) Agency Commission: 10% of total consideration Legal ... All Room Ensuit. ...",ikeja,1,1,0,1,ikeja4,3000000.0,4000000.0,4000000.0,3,43,8,4000000
2261, opebi ikeja lagos,8,4,4,4,3bedroom duplex ... New. All Room Ensuit. Big Compound. Parking Space. 24 Hours Electricity. Pop Ceiling. 24 Hours Security. ...,ikeja,1,1,0,1,ikeja4,3000000.0,4000000.0,4000000.0,3,43,8,4000000
2262, .. awolowo way ikeja lagos,4,2,2,2,"VERY DECENT 2 BEDROOM FLAT OF 2 TOILET & 2 BATHS, FULLY TILED, KITCHEN CABINETS & STORE, GRD FLOOR OFF AWOLOWO WAY, IKEJA Rent: #800,000 P/A ... New. Renovated. Security. Big Compound. Supermarket Nearby. Restaurants Nearby. Security Doors. Parking Space. Drainage System. ...",ikeja,0,0,0,0,ikeja2,950000.0,1540000.0000000002,1300000.0,0,25,5,800000
2263, allen avenue ikeja lagos,10,5,5,5,Duplex ... Renovated. Boys Quater. All Room Ensuit. Big Compound. Parking Space. Pop Ceiling. ...,ikeja,0,0,0,0,ikeja5,5000000.0,5500000.0,5500000.0,0,52,9,3500000
2264, ladipo bateye street ikeja gra ikeja lagos,8,4,4,4,"To Let: A 4 Bedroom Terrace duplex with a Room boysquarter at Oladipo Bateye street, off Sowemimo road, Ikeja GRA, Lagos. All the Rooms are ensuit with Visitors toilet. Well Finished and furnished apartment in a serene ... ...",ikeja,1,1,0,1,ikeja4,3000000.0,4000000.0,4000000.0,3,43,8,4000000
2265, ikeja off awolowo way. awolowo way ikeja lagos,4,2,2,2,"Very clean and lovely 2bedrooms flat at Ikeja off awolowo way, having all round tiles, 2 toilets and baths. (Agt Joe). ... Security. Big Compound. Security Doors. Parking Space. Water Treatment. ...",ikeja,0,0,0,0,ikeja2,950000.0,1540000.0000000002,1300000.0,0,25,5,800000
2266, mangoro ikeja lagos,5,3,2,3,2 bedroom Flat / Apartment for rent Mangoro Ikeja Lagos ... New. Renovated. Security. Supermarket Nearby. Restaurants Nearby. Security Doors. Parking Space. Pop Ceiling. 24 Hours Security. Street Lights. Water Treatment. ...,ikeja,0,0,0,0,ikeja3,1500000.0,3260000.0000000005,3000000.0,0,34,6,1100000
2267," shangisha phase 2, magodo, ikeja lagos",9,5,4,5,. ... ...,ikeja,0,0,0,0,ikeja5,5000000.0,5500000.0,5500000.0,0,52,9,3500000
2268, opebi ikeja lagos,5,3,2,3,Office space ... Renovated. Big Compound. Parking Space. ...,ikeja,0,0,0,0,ikeja3,1500000.0,3260000.0000000005,3000000.0,0,34,6,1200000
2269, at ikeja gra ikeja lagos,7,4,3,4,This is an amazing 6 Unit of 3 bedroom Block of flat located in a quiet serenity here in GRA Ikeja. Description: â€¢ 3 bedroom flat â€¢ Good road network â€¢ Amazing accessibility to all major banks around ... New. Boys Quater. Big Compound. Restaurants Nearby. Security Doors. 24 Hours Security. Drainage System. Street Lights. Church Nearby. Security. All Room Ensuit. Supermarket Nearby. Parking Space. 24 Hours Electricity. Swimming Pool. Pop Ceiling. Water Treatment. ...,ikeja,0,0,0,1,ikeja4,3000000.0,4000000.0,4000000.0,1,43,8,3500000
2270, awuse estate opebi ikeja lagos,6,3,3,3,"Newly and speciously built 4 nos 3 bedrooms flat at Awuse Estate, off salvation bus stop Opebi, Ikeja. With pop, all rooms ensuite ... ...",ikeja,1,0,0,1,ikeja3,1500000.0,3260000.0000000005,3000000.0,2,34,6,3000000
2271, ikeja gra ikeja lagos,11,6,5,6,"Letting: Exquisitely finished 5 Bedroom Semi-detached Duplex at GRA, Ikeja Features: Brand New Beautifully finished 3 Living Rooms (One on each Floor) 1 Room BQ Two units available Fitted Kitchen with Heat Extractor, Gas Hubs, Oven, Microwave Oven, Fridge/Freezer, Washing Machine Rental Price: ... Boys Quater. All Room Ensuit. Parking Space. Pop Ceiling. ...",ikeja,1,1,0,1,ikeja6,6000000.0,6200000.0,6200000.0,3,56,10,6200000
2272, awuse estate opebi ikeja lagos,7,4,3,4,"This is an amazing 3 bedroom serviced duplex located in a quiet serenity at awuse estate, Opebi. Description: â€¢ 3 bedroom duplex â€¢ Good road network â€¢ Amazing accessibility to all major banks around, supermarket and shopping malls, Pharmaceutical ... Serviced. Cheap. Old. Big Compound. Restaurants Nearby. Security Doors. 24 Hours Security. Drainage System. Street Lights. Security. All Room Ensuit. Supermarket Nearby. Parking Space. 24 Hours Electricity. Pop Ceiling. Water Treatment. ...",ikeja,0,0,0,0,ikeja4,3000000.0,4000000.0,4000000.0,0,43,8,2000000
2273, ikeja gra ikeja lagos,7,4,3,4,"Letting: 3 Bedroom Office Flat at GRA, Ikeja Price: N2.5m ... ...",ikeja,0,0,0,0,ikeja4,3000000.0,4000000.0,4000000.0,0,43,8,2500000
2274, - adeniyi jones ikeja lagos,7,6,1,6,"For Lease: Newly Built Office Space at Adeniyi Jones, Ikeja, Lagos. Features: Total space of 450sqm across 3 floors Newly renovated Parking space for 15cars 6 toilets (2 on each floor) Leasing to a single Corporate Tenant Lease Price: ?15,000,000 ... ...",ikeja,1,1,0,1,ikeja6,6000000.0,6200000.0,6200000.0,3,56,10,6200000
2275, opebi ikeja lagos,7,4,3,4,"Modern interior, wardrobe, fitted kitchen cabinets, Borehole, fittings and serene compound. ... ...",ikeja,0,0,0,0,ikeja4,3000000.0,4000000.0,4000000.0,0,43,8,2000000
2276, adeniyi jones ikeja lagos,10,5,5,5,Detached house ... Renovated. Boys Quater. All Room Ensuit. Big Compound. Parking Space. Swimming Pool. Pop Ceiling. 24 Hours Security. ...,ikeja,1,1,0,1,ikeja5,5000000.0,5500000.0,5500000.0,3,52,9,5500000
2277, ikeja gra ikeja lagos,9,5,4,5,"Letting: Spacious 4 Bedroom Terraced Duplex at GRA, Ikeja Features: Beautifully finished Spacious Living RoomsÂ  1 Room BQ Fitted Kitchen with Heat Extractor, Gas Hubs, Oven, Microwave Oven Shower Cubicle Rental Price: 5m P.A ... ...",ikeja,0,0,0,1,ikeja5,5000000.0,5500000.0,5500000.0,1,52,9,5000000
2278, ikeja gra ikeja lagos,9,5,4,5,"Letting: Very Spacious 4 Bedroom Terraced Duplex at GRA, Ikeja Features: Brand New Beautifully finished 3 Living Rooms (One on each Floor) 1 Room BQ Fitted Kitchen with Heat Extractor, Gas Hubs, Oven, Microwave Oven Serviced with dedicated Elevator Located in a mini ... ...",ikeja,1,1,0,1,ikeja5,5000000.0,5500000.0,5500000.0,3,52,9,5500000
2279, allen avenue ikeja lagos,7,4,3,4,etting 6nos of 3 bedroom flats @Off Allen Avenue Ikeja 2.8m per flat ... ...,ikeja,0,0,0,0,ikeja4,3000000.0,4000000.0,4000000.0,0,43,8,2800000
2280, .. awolowo way ikeja lagos,4,2,2,2,2bedroom flat ... Renovated. Big Compound. Parking Space. ...,ikeja,0,0,0,1,ikeja2,950000.0,1540000.0000000002,1300000.0,1,25,5,1000000
2281, 0 ikeja gra ikeja lagos,11,6,5,6,"Letting: 5 Room Detached Duplex on Spacious Grounds at GRA, Ikeja Ground Floor: pen space and one en-suite Room Upper floor: 3 en-suite Rooms 1 Room open space Bungalow 3 Room BQ Adequate Parking space for 20 Cars Rental Price: 12m ... ...",ikeja,1,1,0,1,ikeja6,6000000.0,6200000.0,6200000.0,3,56,10,6200000
2282, opebi ikeja lagos,10,5,5,5,Detached duplex ... New. Boys Quater. All Room Ensuit. Big Compound. Parking Space. Pop Ceiling. ...,ikeja,1,1,0,1,ikeja5,5000000.0,5500000.0,5500000.0,3,52,9,5500000
2283, opebi ikeja lagos,8,4,4,4,"3 bedrooms flat for office use Location: at Ojolowo Street, Opebi, Ikeja. Rent: 2 Million per annum. ... ...",ikeja,0,0,0,0,ikeja4,3000000.0,4000000.0,4000000.0,0,43,8,2000000
2284, gra ikeja lagos,7,4,3,4,TO LET : 3BEDROOM FLAT FOR RENT AT OMOLE PHASE2 VERY GOOD LOCATION UP STAIRS YEARLY RENT 1.3M ... ...,ikeja,0,0,0,0,ikeja4,3000000.0,4000000.0,4000000.0,0,43,8,2000000
2285, ikeja gra ikeja lagos,9,5,4,5,"Letting:Â  4 Bedroom Terraced Duplex at GRA, Ikeja Features: Beautifully finished 1 Room BQ Fitted Kitchen with Heat Extractor, Gas Hubs, Oven, Microwave Oven Shower Cubicle Rental Price: 5m P.A ... ...",ikeja,0,0,0,1,ikeja5,5000000.0,5500000.0,5500000.0,1,52,9,5000000
2286, 0 ikeja gra ikeja lagos,10,5,5,5,"Letting: 5 Bedroom Fully detached Duplex at GRA, Ikeja Features: All Rooms en-suite 3 Room BQ Situated on large rounds (1,500 sqm) Adaptable to mixed use (commercial or residential) Rental Price: 14m P.A Agency Commission: 10% Legal Fee: 10% ... ...",ikeja,1,1,0,1,ikeja5,5000000.0,5500000.0,5500000.0,3,52,9,5500000
2287, oregun ikeja lagos,8,4,4,4,4 bedroom Commercial Property for rent Oregun Ikeja Lagos ... Old. Renovated. Security. Supermarket Nearby. Restaurants Nearby. Security Doors. Street Lights. Printing Service. ...,ikeja,0,0,0,0,ikeja4,3000000.0,4000000.0,4000000.0,0,43,8,2000000
2288," along oregun road, ikeja oregun ikeja lagos",10,5,5,5, An open space on three floors measures as follows: Basement 249sqm Ground floor 234sqm First Floor 234sqm totalling 717sqm ... Serviced. Elevator. Front Desk Service. 24 Hours Electricity. Drainage System. ...,ikeja,1,1,0,1,ikeja5,5000000.0,5500000.0,5500000.0,3,52,9,5500000
2289, ikeja gra ikeja lagos,5,3,2,3,"Letting: 2 Bedroom Office Flat at GRA, Ikeja Price: 1.5m ... ...",ikeja,0,0,0,1,ikeja3,1500000.0,3260000.0000000005,3000000.0,1,34,6,1500000
2290, 0 ikeja gra ikeja lagos,9,5,4,5,"For Rent: Newly Renovated 12 Nos 4 Bedroom Terraced Houses on 3 floors with a BQ each Location: Ikeja GRA. Rent: N4m net. Service charge: N850,000 excluding diesel and IKEDC. Diesel deposit: N690,000 per quarter. ... Serviced. Renovated. ...",ikeja,0,0,0,0,ikeja5,5000000.0,5500000.0,5500000.0,0,52,9,4000000
2291, - adeniyi jones ikeja lagos,10,5,5,5,"**Excellent* *Brand* *New* *Terrace* *Duplexes* *For* *lease* @ *Adeniyi* *jones* *ikeja** Brand New Fully Furnished and serviced 5 Bedrooms Terrace Duplexes @ Adeniyi jones ikeja #6.5m Service charge per duplex #500,000 Description of property ; ... ...",ikeja,1,1,0,1,ikeja5,5000000.0,5500000.0,5500000.0,3,52,9,5500000
2292, allen avenue ikeja lagos,8,4,4,4,Duplex ... Renovated. Boys Quater. All Room Ensuit. Big Compound. Parking Space. Pop Ceiling. ...,ikeja,0,0,0,0,ikeja4,3000000.0,4000000.0,4000000.0,0,43,8,2800000
2293, opebi ikeja lagos,5,3,2,3,2bedroom flat ... Renovated. Big Compound. Parking Space. Pop Ceiling. ...,ikeja,0,0,0,0,ikeja3,1500000.0,3260000.0000000005,3000000.0,0,34,6,1200000
2294, gra ikeja gra ikeja lagos,7,4,3,4,Lovely and spacious 3bedroom duplex with a room bq swimming pool children playground at Ikeja GRA 4m service charge 1m. ... New. Renovated. Security. All Room Ensuit. Big Compound. Fast Internet. Security Doors. Parking Space. 24 Hours Electricity. Pop Ceiling. 24 Hours Security. Street Lights. ...,ikeja,1,1,0,1,ikeja4,3000000.0,4000000.0,4000000.0,3,43,8,4000000
2295, adeniyi jones ikeja lagos,9,5,4,5,Newly Built 4bedroom fully detached duplex with a room Boys Quarter Price: 3.5m LOCATION: ADENIYI JONES IKEJA ... New. Jacuzzi. Boys Quater. Security. All Room Ensuit. Parking Space. Pop Ceiling. ...,ikeja,0,0,0,0,ikeja5,5000000.0,5500000.0,5500000.0,0,52,9,3500000
2296, ... opebi ikeja lagos,8,4,4,4,4bedroom flat at off Salvation road opebi ikeja ... Renovated. All Room Ensuit. Big Compound. Parking Space. Pop Ceiling. ...,ikeja,0,0,0,0,ikeja4,3000000.0,4000000.0,4000000.0,0,43,8,2000000
2297," unilag estate, gra, magodo ikeja lagos",7,4,3,4,. ... ...,ikeja,0,0,0,0,ikeja4,3000000.0,4000000.0,4000000.0,0,43,8,2000000
2298, opebi ikeja lagos,10,5,5,5,4bedroom terrace duplex ... Renovated. Boys Quater. All Room Ensuit. Big Compound. Parking Space. Pop Ceiling. C Of O. ...,ikeja,1,1,0,1,ikeja5,5000000.0,5500000.0,5500000.0,3,52,9,5500000
2299, adeniyi jones ikeja lagos,6,3,3,3,2bedroom flat ... Renovated. All Room Ensuit. Big Compound. Parking Space. Pop Ceiling. ...,ikeja,0,0,0,0,ikeja3,1500000.0,3260000.0000000005,3000000.0,0,34,6,1000000
2300, coker estate alausa ikeja lagos,6,3,3,3,"3bedroom apartment at Coker Estate Alausa Rent N2m per annum, Legal Fee N200k , Agency Fee N400k, Refundable Deposits N200k, ... ...",ikeja,0,0,0,1,ikeja3,1500000.0,3260000.0000000005,3000000.0,1,34,6,2000000
2301, opebi ikeja lagos,4,2,2,2,3bedroom flat ... Renovated. Big Compound. Parking Space. ...,ikeja,1,1,1,1,ikeja2,950000.0,1540000.0000000002,1300000.0,4,25,5,1600000
2302, shogunle street ikeja gra ikeja lagos,4,2,2,2,Executive miniflat at Ikeja for rent pay and parking apartment Good road network Enough parking space Spacious rooms All room ensuite Constant Water and power Supply ... Renovated. Security. All Room Ensuit. Big Compound. Security Doors. Parking Space. Pop Ceiling. 24 Hours Security. Street Lights. ...,ikeja,0,0,0,0,ikeja2,950000.0,1540000.0000000002,1300000.0,0,25,5,800000
2303, ikeja gra ikeja lagos,11,6,5,6,4 bedroom Flat / Apartment for rent Ikeja GRA Ikeja Lagos ... Serviced. New. Furnished. Renovated. Boys Quater. Cctv Cameras. Big Compound. Restaurants Nearby. Security Doors. 24 Hours Security. Street Lights. Printing Service. Security. All Room Ensuit. Supermarket Nearby. Parking Space. 24 Hours Electricity. Swimming Pool. Pop Ceiling. Children Play Ground. Water Treatment. ...,ikeja,1,1,0,1,ikeja6,6000000.0,6200000.0,6200000.0,3,56,10,6200000
2304, allen avenue ikeja lagos,8,4,4,4,Duplex ... Renovated. Boys Quater. All Room Ensuit. Big Compound. Parking Space. Pop Ceiling. ...,ikeja,0,0,0,0,ikeja4,3000000.0,4000000.0,4000000.0,0,43,8,2500000
2305," shangisha phase 2, gra, magodo ikeja lagos",7,4,3,4,. ... ...,ikeja,0,0,0,0,ikeja4,3000000.0,4000000.0,4000000.0,0,43,8,2500000
2306, ikeja lagos,6,3,3,3,very clean and spacious 3 bedroom flat for rent in Ikeja. all round tiles clean road good environment ... ...,ikeja,0,0,0,1,ikeja3,1500000.0,3260000.0000000005,3000000.0,1,34,6,2500000
2307, mangoro ikeja lagos,3,2,1,2,1 bedroom mini flat Mini flat Flat / Apartment for rent Mangoro Ikeja Lagos ... New. Renovated. Security. Supermarket Nearby. Restaurants Nearby. Security Doors. Parking Space. Pop Ceiling. 24 Hours Security. Street Lights. Water Treatment. ...,ikeja,0,0,0,0,ikeja2,950000.0,1540000.0000000002,1300000.0,0,25,5,800000
2308, airport road airport road(ikeja) ikeja lagos,6,3,3,3,"Newly Built 3 bedroom flat at Airport Road, Ikeja. 1.5m Yearly rent. Total package 1.8m ... New. Swampy. ...",ikeja,0,0,0,1,ikeja3,1500000.0,3260000.0000000005,3000000.0,1,34,6,1500000
2309, toyin street ikeja lagos,2,1,1,1,Mini flat ... Renovated. Big Compound. Parking Space. ...,ikeja,0,0,0,1,ikeja1,500000.0,800000.0,685000.0,1,11,2,650000
2310," olowora isheri, isheri ikeja lagos",5,3,2,3,. ... ...,ikeja,0,0,0,0,ikeja3,1500000.0,3260000.0000000005,3000000.0,0,34,6,1100000
2311, allen avenue ikeja lagos,2,1,1,1,Shop ... Renovated. All Room Ensuit. Big Compound. Parking Space. Pop Ceiling. ...,ikeja,1,1,1,1,ikeja1,500000.0,800000.0,685000.0,4,11,2,1000000
2312, opebi ikeja lagos,11,6,5,6,5bedroom duplex ... Renovated. Boys Quater. All Room Ensuit. Big Compound. Parking Space. Pop Ceiling. ...,ikeja,0,0,0,0,ikeja6,6000000.0,6200000.0,6200000.0,0,56,10,4700000
2313, ikeja gra ikeja lagos,8,4,4,4,Serviced 3bedroom flat ... Renovated. Boys Quater. All Room Ensuit. Big Compound. Parking Space. 24 Hours Electricity. Swimming Pool. Pop Ceiling. 24 Hours Security. Water Treatment. ...,ikeja,1,1,0,1,ikeja4,3000000.0,4000000.0,4000000.0,3,43,8,4000000
2314, obafemi awolowo way ikeja lagos,6,3,3,3,2bedroom flat ... Renovated. All Room Ensuit. Big Compound. Parking Space. Pop Ceiling. ...,ikeja,0,0,0,0,ikeja3,1500000.0,3260000.0000000005,3000000.0,0,34,6,1300000
2315, alausa ikeja lagos,8,4,4,4,3bedroom flat ... New. All Room Ensuit. Big Compound. Parking Space. Pop Ceiling. ...,ikeja,0,0,0,0,ikeja4,3000000.0,4000000.0,4000000.0,0,43,8,2000000
2316," awolowo road ,ikeja awolowo way ikeja lagos",5,3,2,3,"Tastefully finished house , office space on the road very accessible to anywhere good location for business clean compound ... Cheap. Security. All Room Ensuit. Big Compound. Security Doors. Parking Space. 24 Hours Electricity. 24 Hours Security. Street Lights. ...",ikeja,1,1,1,1,ikeja3,1500000.0,3260000.0000000005,3000000.0,4,34,6,3500000
2317, 0 ikeja gra ikeja lagos,9,5,4,5,"Letting: Luxury 4 Bedroom Detached Duplex at GRA, Ikeja Renting in the quiet, serene and exclusive environment of GRA, Ikeja is this newly-built 4 Bedroom detached Duplex with a room service quarters. Following are features: One Storey Building 4 ... ...",ikeja,1,1,0,1,ikeja5,5000000.0,5500000.0,5500000.0,3,52,9,5500000
2318, 0 ikeja gra ikeja lagos,9,5,4,5,"For Rent: 4 Bedroom Semi-Detached Duplex at Ikeja GRA Features: located in a serene environment with good road network spacious sitting room Large compound for parking Vitrified floor tiles Fitted kitchen Laundry room All rooms are en-suite and fitted with wardrobes. Price: N5,500,000 Per ... ...",ikeja,1,1,0,1,ikeja5,5000000.0,5500000.0,5500000.0,3,52,9,5500000
2319, 0 ikeja gra ikeja lagos,5,3,2,3,"Selling: Beautifully Finished and Furnished 2 Bedroom Flat at GRA, Ikeja Features: Exquisitely furnished Living Room with American styled attached Kitchen Fully fitted Kitchen with Heat Extractor, Gas Hub, Oven and Microwave Oven 2 Fully furnished en-suite Bedrooms Located in ... Furnished. All Room Ensuit. Parking Space. Pop Ceiling. ...",ikeja,1,1,1,1,ikeja3,1500000.0,3260000.0000000005,3000000.0,4,34,6,3500000
2320, 0 ikeja gra ikeja lagos,11,6,5,6,"Letting: Spacious 5 Bedroom Bungalow at GRA, Ikeja Features: 5 en-suite rooms Spacious with Garden Swimming Pool Generators Rental Price: 8m P.A (Neg.) Agency Commission: 10% Legal Fee: 10% ... ...",ikeja,1,1,0,1,ikeja6,6000000.0,6200000.0,6200000.0,3,56,10,6200000
2321, 0 ikeja gra ikeja lagos,7,4,3,4,"Letting: Fully furnished 3 Bedroom Flat at GRA, Ikeja Features: 3 en-suite Rooms 1 Room BQ Fitted Kitchen with Gas Cooker, Oven, Microwave Oven, Freezer and Refrigerator Fully Serviced with Generator and 24 Hours Power Rental Price: N12m P.A. (Service Charge ... ...",ikeja,1,1,0,1,ikeja4,3000000.0,4000000.0,4000000.0,3,43,8,4000000
2322," ikeja gra, ikeja lagos",7,4,3,4,"3 bedroom serviced flats with bq , swimming pool ,security ,24 hours electricity etc. Rent 3.5 million per annum and service charge of 2million per annum ... ...",ikeja,0,0,0,1,ikeja4,3000000.0,4000000.0,4000000.0,1,43,8,3500000
2323," salvation road, omega courts, opebi ikeja lagos",6,3,3,3,"RENT TO OWN (R.T.O) SCHEME Massive work ongoing in our Rent To Own (RTO) in Opebi,Ikeja. Join early investors to benefit from this rare investment opportunity in the heart of Lekki. FANTASTIC FEATURES: A/C in Bedrooms & Living ... ...",ikeja,1,0,0,1,ikeja3,1500000.0,3260000.0000000005,3000000.0,2,34,6,3200000
2324, oladipupo kuku allen avenue ikeja lagos,8,4,4,4,"5 bedroom wing of duplex off Allen Avenue, Ikeja. 5 bedrooms, 4 toilets/shower, study, kitchen, store, living/dining, family lounge, lock-up garage with 1 room Bq with a shared kitchenette and shower/toilet. N3.5m per annum ... ...",ikeja,0,0,0,1,ikeja4,3000000.0,4000000.0,4000000.0,1,43,8,3500000
2325, mangoro ikeja lagos,9,5,4,5,4 bedroom Flat / Apartment for rent Mangoro Ikeja Lagos ... New. Security. Supermarket Nearby. Restaurants Nearby. Security Doors. Parking Space. Pop Ceiling. 24 Hours Security. Street Lights. ...,ikeja,0,0,0,0,ikeja5,5000000.0,5500000.0,5500000.0,0,52,9,3500000
2326, 0 ikeja gra ikeja lagos,11,6,5,6,"Letting: Luxury 5 Bedroom Terraced Duplex at GRA, Ikeja Features: 3 Living Rooms 5 en-suite Bedrooms 1 Room BQ All Rooms finished with POP and high Ceilings Large Bed Rooms Master Bedroom finished with Jacuzzi Fitted Kitchen with Refrigerator, Freezer, Washing Machine, Heat ... Boys Quater. All Room Ensuit. Parking Space. 24 Hours Electricity. Pop Ceiling. ...",ikeja,1,1,0,1,ikeja6,6000000.0,6200000.0,6200000.0,3,56,10,6200000
2327, ikeja toyin street ikeja lagos,2,1,1,1,Nice looking Roomself at Ikeja off toyin street 400k....yearly rent ... New. Cheap. Security. All Room Ensuit. Big Compound. Supermarket Nearby. Security Doors. Parking Space. 24 Hours Electricity. 24 Hours Security. Street Lights. ...,ikeja,0,0,0,0,ikeja1,500000.0,800000.0,685000.0,0,11,2,400000
2328, .. opebi ikeja lagos,5,3,2,3,2brdroom flat ... Renovated. Big Compound. Parking Space. ...,ikeja,0,0,0,1,ikeja3,1500000.0,3260000.0000000005,3000000.0,1,34,6,1500000
2329, off allen avenue ikeja lagos,7,4,3,4,"*A BRAND NEW AND WELL FINISHED BLOCK OF 6Nos OF 3 BEDROOM FLAT EACH, ALL ROOM ENSUITE WITH GUEST TOILET. OFF ALLEN AVENUE* *IKEJA*. ... New. ...",ikeja,0,0,0,0,ikeja4,3000000.0,4000000.0,4000000.0,0,43,8,2000000
2330, . ikeja gra ikeja lagos,5,3,2,3,"Letting: Letting: Well-finished 3 Bedroom Flat at GRA, Ikeja Features: Brand new and well finished 2 en-suite Rooms One Room BQ Fitted Kitchen Bathroom finished with nice shower cubicles 24 hours security and Generator back-up Rental Price: 4m Service Charge: 2m Agency Fee: 10% Legal Fee: ... Serviced. Furnished. Boys Quater. Parking Space. ...",ikeja,1,1,1,1,ikeja3,1500000.0,3260000.0000000005,3000000.0,4,34,6,3500000
2331, awuse estate opebi ikeja lagos,7,4,3,4,"Letting: Fully furnished 3 Bedroom Flat at Awuse Estate, Opebi Features: Fully furnished Living and Bedrooms All Bedrooms en-suite Fully serviced with 24 hours Power and Swimming Pool Rental Price: 4m P.A. Agency Commission: 10% of total consideration Legal Fee: 10% of ... 24 Hours Electricity. Swimming Pool. Pop Ceiling. 24 Hours Security. ...",ikeja,1,1,0,1,ikeja4,3000000.0,4000000.0,4000000.0,3,43,8,4000000
2332, 0 ikeja gra ikeja lagos,11,6,5,6,"For Rent: Furnished 5 Bedroom Detached Duplex with 2 room BQ at Ikeja GRA Features: Air conditioner Tastefully finished All rooms en-suite Two Lounges Fitted Kitchen with Heat Extractor, Gas Hub, Oven, Microwave Oven and Freezer Refrigerator Jacuzzi POP Ceilings Spacious Compound Compound finished with Interlocked ... ...",ikeja,1,1,0,1,ikeja6,6000000.0,6200000.0,6200000.0,3,56,10,6200000
2333, . ikeja gra ikeja lagos,5,3,2,3,"Letting: Well-finished 2 Bedroom Flat at GRA, Ikeja Features: Brand new and well finished 2 en-suite Rooms Fitted Kitchen Bathroom finished with nice shower cubicles Spacious Compound Serviced with Swimming Pool, 24 hours security and Generator back-up Rental Price: 3.5m Agency Fee: 10% Legal Fee: ... ...",ikeja,1,1,1,1,ikeja3,1500000.0,3260000.0000000005,3000000.0,4,34,6,3500000
2334, omole phase 2 ikeja lagos,6,3,3,3,Newly built 10 nos of 3bedrooms in omole phase 2 The owner wants a company that can take all...2m per units ... ...,ikeja,0,0,0,1,ikeja3,1500000.0,3260000.0000000005,3000000.0,1,34,6,2000000
2335, opebi ikeja lagos,10,5,5,5,Duplex ... Renovated. Boys Quater. All Room Ensuit. Big Compound. Parking Space. Pop Ceiling. 24 Hours Security. ...,ikeja,0,0,0,0,ikeja5,5000000.0,5500000.0,5500000.0,0,52,9,3500000
2336, 0 ikeja gra ikeja lagos,7,4,3,4,"Letting: Neatly finished serviced Flat at GRA, ikeja Features: Big Living Room 3 en-suite Bedrooms 1 Room Service Quarters All Rooms including Kitchen finished with AC's All Rooms finished with State-of-the-Art Sanitary Wares Fitted Kitchen with Heat Extractor, Gas Hubs, Oven and ... Pop Ceiling. ...",ikeja,1,1,0,1,ikeja4,3000000.0,4000000.0,4000000.0,3,43,8,4000000
2337, toyin street ikeja lagos,10,5,5,5,4bedroom duplex ... Renovated. All Room Ensuit. Big Compound. Parking Space. Pop Ceiling. ...,ikeja,0,0,0,0,ikeja5,5000000.0,5500000.0,5500000.0,0,52,9,3500000
2338, ikeja lagos,6,3,3,3,a newly renovated 3 bedroom flat with room BQ for both office and residential use in an estate ikeja for 2.5m per annum ... ...,ikeja,0,0,0,1,ikeja3,1500000.0,3260000.0000000005,3000000.0,1,34,6,2500000
2339, 1 ikeja gra ikeja lagos,9,5,4,5,"Letting: 5 Units of Luxury 4 Bedroom Terraced Duplexes Features: Exquisitely finished 2 Living Rooms 4 en-suite Rooms 1 Room BQ Fitted Kitchen with Heat Extractor, Gas Hubs, Oven and Microwave Oven Adequate parking space Leasing to a Single Corporate Tenant Price: N6m ... Boys Quater. All Room Ensuit. Parking Space. Pop Ceiling. ...",ikeja,1,1,0,1,ikeja5,5000000.0,5500000.0,5500000.0,3,52,9,5500000
2340, ikeja gra ikeja lagos,10,5,5,5,Terrace duplex ... Renovated. Boys Quater. All Room Ensuit. Big Compound. Parking Space. Pop Ceiling. ...,ikeja,1,1,0,1,ikeja5,5000000.0,5500000.0,5500000.0,3,52,9,5500000
2341, alausa ikeja lagos,6,3,3,3,Newly built 3bedroom detached duplex in Alausa Ikeja for rent. The property is located in a very serene and secured area in Alausa. The finishing is very well done. The duplex comes with an inbuilt ... ...,ikeja,1,1,1,1,ikeja3,1500000.0,3260000.0000000005,3000000.0,4,34,6,3500000
2342, 0 ikeja gra ikeja lagos,9,5,4,5,"For Rent: 4 Bedroom Semi-Detached Duplex at GRA, Ikeja Features: All rooms fitted with AC All Rooms En-suite Fitted Kitchen with Heat Extractor Two living Rooms (Ground and First Floor) Masters Bedroom finished with Bath Tub Shower Cubicle Adequate Parking Space POP Ceiling Rent Price: ... All Room Ensuit. Parking Space. Pop Ceiling. ...",ikeja,0,0,0,1,ikeja5,5000000.0,5500000.0,5500000.0,1,52,9,5000000
2343, toyin street ikeja lagos,6,3,3,3,2bedroom flat ... New. All Room Ensuit. Big Compound. Parking Space. Pop Ceiling. ...,ikeja,0,0,0,0,ikeja3,1500000.0,3260000.0000000005,3000000.0,0,34,6,1400000
2344, .. adeniyi jones ikeja lagos,2,1,1,1,Self contain ... New. Big Compound. Parking Space. Pop Ceiling. ...,ikeja,0,0,0,0,ikeja1,500000.0,800000.0,685000.0,0,11,2,400000
2345, - allen avenue ikeja lagos,6,3,3,3,Newly refurbished 3 bedroom duplex with 1 room BQ. For rent in Ikeja. It has a spacious living room and is very close to the main road. The house is located in a clean and secured ... Renovated. ...,ikeja,1,0,0,1,ikeja3,1500000.0,3260000.0000000005,3000000.0,2,34,6,3000000
2346, toyin street ikeja lagos,8,4,4,4,Flat ... New. All Room Ensuit. Big Compound. Parking Space. Pop Ceiling. ...,ikeja,0,0,0,0,ikeja4,3000000.0,4000000.0,4000000.0,0,43,8,2000000
2347, akira estate adeniyi jones ikeja lagos,8,4,4,4,is 4bedroom fully detached Duplexs with a room bq inside Akora estate ... New. ...,ikeja,1,1,0,1,ikeja4,3000000.0,4000000.0,4000000.0,3,43,8,4000000
2348, adeniyi jones ikeja adeniyi jones ikeja lagos,2,1,1,1,"HOT NEW LETTINGS Shared rooms in a serene environment LOCATION:Adeniyi Jones, Ikeja!!!. 24 HOURS POWER supply. Proximity to different locations. Clean and adequate water supply. Security, cleaning and gardening services. Ensuite Room 1: N600k, SC: N100k ... Serviced. Parking Space. 24 Hours Electricity. 24 Hours Security. Security. Pop Ceiling. ...",ikeja,0,0,0,1,ikeja1,500000.0,800000.0,685000.0,1,11,2,600000
2349," 51 oluwaleimu street, allen avenue allen avenue ikeja lagos",7,4,3,4,"Green bliss apartments This is exquisitely furnished and serviced apartment. - furnished and serviced apartments; - 24 hours electricity - 24 hours security - internet - parking space - in-house party - in-house training, coaching space - ... Serviced. Cheap. New. Furnished. Swimming Pool. Pop Ceiling. 24 Hours Electricity. Drainage System. 24 Hours Security. Gym. ...",ikeja,0,0,0,1,ikeja4,3000000.0,4000000.0,4000000.0,1,43,8,3000000
2350," oluwaleimu street, allen allen avenue ikeja lagos",7,4,3,4,- 24 hours electricity - 24 hours security - properly guarded neighborhood - beautiful compound - 24 hours water supply - DSTV installed - 43 Inches brand new TV - All room suite( 6 by 6 king size beds) - Gas cooker - Brand ... Furnished. New. Serviced. 24 Hours Electricity. Supermarket Nearby. Big Compound. Free Wifi. Front Desk Service. Water Treatment. Drainage System. 24 Hours Security. All Room Ensuit. Restaurants Nearby. ...,ikeja,0,0,0,1,ikeja4,3000000.0,4000000.0,4000000.0,1,43,8,3000000
2351," 51 oluwaleimu street, allen avenue allen avenue ikeja lagos",7,4,3,4,"furnished and serviced apartments; - 24 hours electricity - 24 hours security - internet - parking space - in-house party - in-house training, coaching space - spacious rooms and sitting rooms, all en-suite - gas ... Serviced. Furnished. ...",ikeja,0,0,0,1,ikeja4,3000000.0,4000000.0,4000000.0,1,43,8,3000000
2352, ikeja gra ikeja lagos,8,4,4,4,A white 4 bedroom flat detached duplex ... New. Furnished. Swimming Pool. Big Compound. C Of O. Free Wifi. Drainage System. 24 Hours Electricity. All Room Ensuit. Parking Space. Gym. Pop Ceiling. ...,ikeja,1,1,0,1,ikeja4,3000000.0,4000000.0,4000000.0,3,43,8,4000000
2353, alfred gardens estate oregun ikeja lagos,10,5,5,5,24/7 electricity power supply pool and Bar gym and mini supermarket close to Ojota ... Renovated. Serviced. Security Doors. All Room Ensuit. Swimming Pool. Fast Internet. Pop Ceiling. Boys Quater. Street Lights. Free Wifi. Security. Supermarket Nearby. Parking Space. Governor's Consent. Child Care. Front Desk Service. Children Play Ground. 24 Hours Security. Mosques Nearby. Big Compound. Church Nearby. C Of O. 24 Hours Electricity. Drainage System. Gym. Cctv Cameras. Water Treatment. Restaurants Nearby. ...,ikeja,0,0,0,1,ikeja5,5000000.0,5500000.0,5500000.0,1,52,9,5000000
2354," opic, isheri north, ikeja lagos",7,4,3,4,A beautiful and well maintained 3 bedroom duplex is available for rent in a serene and secured estate in OPIC. PRICE: 1.3M ... ...,ikeja,0,0,0,0,ikeja4,3000000.0,4000000.0,4000000.0,0,43,8,2000000
2355," olanrewaju street off billing sway ,oregun oregun ikeja lagos",3,2,1,2,"Newly complete d mini flat twoo toilet one bathroom,pop finishing at olanrewaju street off Billing sway Oregun ... Serviced. New. Children Play Ground. Ocean View. Printing Service. 24 Hours Electricity. Pop Ceiling. ...",ikeja,0,0,0,0,ikeja2,950000.0,1540000.0000000002,1300000.0,0,25,5,800000
2356, obawole off ogba ikeja lagos,6,3,3,3,"Well finished house with pop finishing in a secured environment,all tiles,self compound, borehole,e ... ...",ikeja,0,0,0,0,ikeja3,1500000.0,3260000.0000000005,3000000.0,0,34,6,900000
2357, obawole off ogba ikeja lagos,6,3,3,3,"Well finished house with pop finishing in a secured environment,all tiles,self compound, borehole,etc ... ...",ikeja,0,0,0,0,ikeja3,1500000.0,3260000.0000000005,3000000.0,0,34,6,900000
2358," ikeja gra, ikeja lagos",9,5,4,5,"Letting: 4 Bedroom Bungalow at GRA, Ikeja Features: 4 en-suite Rooms 1 Room BQ Master Bedroom with Steam Bath Spacious Compound Needs a bit of renovation Rental Price: 6.5m P.A. Agency Fee: 10% Legal Fee: 10% ... ...",ikeja,1,1,0,1,ikeja5,5000000.0,5500000.0,5500000.0,3,52,9,5500000
2359, off allen avenue ikeja allen avenue ikeja lagos,4,2,2,2,"Well Finished 2 Bedroom Flat off Allen Avenue, Ikeja. Comes either Furnished or Unfurnished. Rent is N1.3m per annum unfurnished and N1.8 per annum furnished. ... ...",ikeja,1,0,0,1,ikeja2,950000.0,1540000.0000000002,1300000.0,2,25,5,1300000
2360," off ayo-alabi street oke-ira, ogba ikeja lagos",6,3,3,3,"A Newly Built Luxury 2bedroom Flat with All Rooms Ensuite, wardrobes, kitchen cabinet, shower, water heater, POP, prepaid meter etc ... ...",ikeja,0,0,0,0,ikeja3,1500000.0,3260000.0000000005,3000000.0,0,34,6,900000
2361, ogba ikeja lagos,7,4,3,4,"A newly built and tastefully finished luxury 3 bedroom flat with all rooms ensuite, pop, floor tiles, well paved compound, security house, water heater, metal doors, upstairs, steel pipe railed balcony, wardrobes, kitchen cabinet, spacious ... ...",ikeja,0,0,0,0,ikeja4,3000000.0,4000000.0,4000000.0,0,43,8,2000000
2362," ikeja gra, ikeja gra ikeja lagos",9,5,4,5,"4 bedroom duplex in Millennium Estate (behind Area F ) in ikeja GRA. The rooms are quite spacious. The estate provides 24 hour light, good security and play area for kids. ... ...",ikeja,0,0,0,0,ikeja5,5000000.0,5500000.0,5500000.0,0,52,9,3500000
2363, millennium estate ikeja gra ikeja lagos,7,4,3,4,4b Bedroom Maisonette in a serene and secured Estate. ... ...,ikeja,1,1,0,1,ikeja4,3000000.0,4000000.0,4000000.0,3,43,8,4000000
2364, off adeniyi jones . ikeja adeniyi jones ikeja lagos,8,4,4,4,For Lease Newly Built & Tastefully finished 4 units 3 Bedroom flat with BQ each @ Adeniyi Jones. Ikeja. ( Corprate tenant required) Rent: #8Million P.A. ( 2years payable ... ...,ikeja,1,1,0,1,ikeja4,3000000.0,4000000.0,4000000.0,3,43,8,4000000
2365, estate off adeniyi jones adeniyi jones ikeja lagos,11,6,5,6,"**Excellent* *Brand* *New* *Terrace* *Duplexes* *For* *lease* @ *Adeniyi* *jones* *ikeja** Brand New Fully Furnished and serviced 5 Bedrooms Terrace Duplexes @ Adeniyi jones ikeja #6.5m Service charge per duplex #500,000 Description of property ; 1.Brand new 2.fully furnished ... ...",ikeja,1,1,0,1,ikeja6,6000000.0,6200000.0,6200000.0,3,56,10,6200000
2366, alfred garden oregun oregun ikeja lagos,6,3,3,3,A 3bedroom duplex with rm inbuilt boy'squater. ... Renovated. Boys Quater. Swimming Pool. 24 Hours Electricity. Children Play Ground. Water Treatment. 24 Hours Security. Supermarket Nearby. Gym. ...,ikeja,1,1,1,1,ikeja3,1500000.0,3260000.0000000005,3000000.0,4,34,6,3500000
2367, olaiya street alausa ikeja lagos,4,2,2,2,3 bedroom apartment for rent in alausa ... Renovated. Big Compound. Water Treatment. Drainage System. Security. Parking Space. ...,ikeja,0,0,0,0,ikeja2,950000.0,1540000.0000000002,1300000.0,0,25,5,900000
2368, adeniyi jones ikeja adeniyi jones ikeja lagos,7,4,3,4,"To let 3bedroom flat Ensuite with 1room bq each@adeniyi Jones Ikeja, price #2m per annum ... Renovated. Pop Ceiling. 24 Hours Electricity. Parking Space. 24 Hours Security. Big Compound. Boys Quater. All Room Ensuit. ...",ikeja,0,0,0,0,ikeja4,3000000.0,4000000.0,4000000.0,0,43,8,2000000
2369, adeniyi jones adeniyi jones ikeja lagos,9,5,4,5,Newly renovated 4 bedroom duplex located in a serene and well secured estate is up for rent. ... Renovated. Supermarket Nearby. Security Doors. 24 Hours Security. Big Compound. All Room Ensuit. Street Lights. ...,ikeja,0,0,0,0,ikeja5,5000000.0,5500000.0,5500000.0,0,52,9,3500000
2370, sslvation opebi ikeja lagos,4,2,2,2,"Beautiful and spacious 4bedroom flat, semi furnished, comfy, cozy, serene environment. ... Old. Child Care. Parking Space. Supermarket Nearby. Big Compound. Restaurants Nearby. ...",ikeja,1,1,1,1,ikeja2,950000.0,1540000.0000000002,1300000.0,4,25,5,1700000
2371, ajisafe ikeja gra ikeja lagos,9,5,4,5,"LoveLy 4,Bedroom Terrace house, a compound of 3,unites, ample packing space ... Dry. New. Cheap. Serviced. Swimming Pool. Supermarket Nearby. 24 Hours Security. Boys Quater. Drainage System. Security. Big Compound. Pop Ceiling. Street Lights. Parking Space. 24 Hours Electricity. Gym. Cctv Cameras. All Room Ensuit. Security Doors. ...",ikeja,1,1,0,1,ikeja5,5000000.0,5500000.0,5500000.0,3,52,9,5500000
2372, omole phase 2 lagos ikeja lagos,5,3,2,3,NEWLY BUILT LUXURY TWO BEDROOM DUPLEX FOR RENT IN OMOLE PHASE 2. RENT 1.1M ... Furnished. New. 24 Hours Security. Security Doors. Security. Pop Ceiling. Street Lights. All Room Ensuit. ...,ikeja,0,0,0,0,ikeja3,1500000.0,3260000.0000000005,3000000.0,0,34,6,1100000
2373," oshorun estate, opic, isheri north content from nigeria property centre read more at: https://nigeriapropertycentre.com/for-rent/houses/detached-duplexes/lagos/isheri-north/opic/591137-top-notch-and-newly-built-4-bedroom-duplex ikeja lagos",9,5,4,5,Top-notch and newly built 4 bedroom duplex in opic @ Oshorun estate for 1.5m annual rent. Rent: 2 yrs rent required. Total package is 3.6m ... ...,ikeja,0,0,0,0,ikeja5,5000000.0,5500000.0,5500000.0,0,52,9,3500000
2374, 117 opebi road ikeja agungi lekki lagos,3,2,1,2,1 bedroom mini flat Self Contain Flat / Apartment for rent 117 Opebi road ikeja Agungi Lekki Lagos ... Furnished. Renovated. Serviced. Cheap. New. Jacuzzi. Water Treatment. Parking Space. Children Play Ground. Security. Mosques Nearby. Restaurants Nearby. Street Lights. Elevator. 24 Hours Electricity. Supermarket Nearby. Gym. Cctv Cameras. Pop Ceiling. Boys Quater. Swimming Pool. Security Doors. Big Compound. All Room Ensuit. 24 Hours Security. ...,ikeja,0,0,0,1,ikeja2,950000.0,1540000.0000000002,1300000.0,1,25,5,1200000
2375," magodo, gra, magodo ikeja lagos",6,3,3,3,"Tastefully finished 3 bedroom flat, all rooms en-suite, fitted kitchen , large parking and in a nice environment ... ...",ikeja,0,0,0,1,ikeja3,1500000.0,3260000.0000000005,3000000.0,1,34,6,1800000
2376," otedola estate, omole phase 2, ikeja lagos",7,4,3,4,To let : 3bedroom flat for rent at otedola estate allroom ensuit self compound very good location yearly rent 1. 5m ... ...,ikeja,0,0,0,0,ikeja4,3000000.0,4000000.0,4000000.0,0,43,8,2000000
2377, off oduduwa way ikeja gra ikeja lagos,10,5,5,5,"Tastefully built 5 bedroom duplex with a room Bq, jacuzee,pop,marble floor, gascooker.,microwav. Etc ... ...",ikeja,1,1,0,1,ikeja5,5000000.0,5500000.0,5500000.0,3,52,9,5500000
2378, omole phase 2 ikeja lagos,7,4,3,4,"Welcome to our Tasteful 3bedroom terrace duplex with enclosed gate strategically located in the heart of Omole Phase Two. All rooms en suite ,Full P.O.P , Water Heater and wardrobes. This property location have an ... ...",ikeja,0,0,0,0,ikeja4,3000000.0,4000000.0,4000000.0,0,43,8,2000000
2379," salvation road after wema bank, omega courts, opebi ikeja lagos",10,5,5,5,"RENT TO OWN (R.T.O) SCHEME Massive work ongoing in our Rent To Own (RTO) in Opebi,Ikeja. Join early investors to benefit from this rare investment opportunity in the heart of Lekki. 15 years Super flexible payment plan ... ...",ikeja,0,0,0,0,ikeja5,5000000.0,5500000.0,5500000.0,0,52,9,4800000
2380," ikeja gra, ikeja gra ikeja lagos",9,5,4,5,"PROPERTY DESCRIPTION: Newly Built 4 Bedroom Semi-Detached Duplex Spread across 3 Floors. LOCATION: Ikeja GRA, Ikeja PRICE: N8,000,000 (Eight Million Naira) Per Annum FEATURES; * Top Notch Fittings & Finishings * All Rooms Ensuit & very Spacious * 3 Sitting Rooms * ... ...",ikeja,1,1,0,1,ikeja5,5000000.0,5500000.0,5500000.0,3,52,9,5500000
2381, adeniyi jones adeniyi jones ikeja lagos,9,5,4,5,"??????Short let!!!! Detached 4 bedrooms duplex with a mini flat boy's quarters inside an estate @ Adeniyi Jones, Ikeja.. #10million. ... Renovated. Serviced. Furnished. Parking Space. Boys Quater. Street Lights. Security. 24 Hours Electricity. All Room Ensuit. Drainage System. Water Treatment. Big Compound. Security Doors. Pop Ceiling. 24 Hours Security. ...",ikeja,1,1,0,1,ikeja5,5000000.0,5500000.0,5500000.0,3,52,9,5500000
2382, 7 ajisafe street ikeja g.r.a ikeja gra ikeja lagos,5,3,2,3,"Paramount luxury apartments is located in the well secured place in G.R.a and in a serene environment with a swimming pool, gym, parking space and also furnished and unfurnished. ... Serviced. Renovated. 24 Hours Security. 24 Hours Electricity. Front Desk Service. Gym. Free Wifi. Parking Space. Restaurants Nearby. Swimming Pool. Water Treatment. Supermarket Nearby. Pop Ceiling. Street Lights. ...",ikeja,1,0,0,1,ikeja3,1500000.0,3260000.0000000005,3000000.0,2,34,6,3000000
2383, 8&10 shonny highway shonibare estate maryland maryland ikeja lagos,4,2,2,2,2 bedroom Mini flat Flat / Apartment for rent 8&10 shonny highway shonibare estate maryland Maryland Ikeja Lagos ... Dry. Renovated. 24 Hours Security. Big Compound. Parking Space. Swimming Pool. Water Treatment. Supermarket Nearby. Pop Ceiling. Street Lights. ...,ikeja,1,1,1,1,ikeja2,950000.0,1540000.0000000002,1300000.0,4,25,5,2200000
2384, adeniyi jones ikeja lagos,7,4,3,4,3 bedroom Flat / Apartment for rent Adeniyi Jones Ikeja Lagos ... ...,ikeja,0,0,0,0,ikeja4,3000000.0,4000000.0,4000000.0,0,43,8,2000000
2385, isaac john ikeja gra ikeja lagos,2,1,1,1,"A 650 Square metre space inside a business premises is available for long lease on Isaac John Street, Ikeja, GRA. ... Big Compound. 24 Hours Security. Drainage System. ...",ikeja,1,1,1,1,ikeja1,500000.0,800000.0,685000.0,4,11,2,1000000
2386, ikeja gra ikeja gra ikeja lagos,5,3,2,3,Newly Built ... New. Furnished. Serviced. Children Play Ground. Street Lights. All Room Ensuit. Drainage System. Child Care. Swimming Pool. Cctv Cameras. Security. Big Compound. Water Treatment. 24 Hours Electricity. Parking Space. Security Doors. Pop Ceiling. 24 Hours Security. ...,ikeja,1,1,1,1,ikeja3,1500000.0,3260000.0000000005,3000000.0,4,34,6,3500000
2387, oladipo bateye street ikeja gra ikeja lagos,9,5,4,5,"A 4 Bedroom Terrace duplex with a Room boysquarter at Oladipo Bateye street, off Sowemimo road, ikeja GRA, Lagos. All the Rooms are ensuit with Visitors toilet. Well Finished and furnished apartment in a serene environment ... Renovated. ...",ikeja,0,0,0,1,ikeja5,5000000.0,5500000.0,5500000.0,1,52,9,5000000
2388, off allen allen avenue ikeja lagos,7,4,3,4,"PROPERTY DESCRIPTION: 6 No. of 3 Bedroom Luxury Flats. LOCATION: Off Allen Avenue Ikeja. RENT: N4,000,000 (Four Million Naira) Per Annum FEATURES * Concierge with access control device. * Three bedrooms all ensuite with french windows. * Tastefully finished sitting room. * ... Dry. New. Serviced. Big Compound. Pop Ceiling. Gym. Street Lights. Security. Elevator. Security Doors. All Room Ensuit. Swimming Pool. Boys Quater. Cctv Cameras. Drainage System. 24 Hours Security. Water Treatment. Parking Space. ...",ikeja,1,1,0,1,ikeja4,3000000.0,4000000.0,4000000.0,3,43,8,4000000
2389, oba ladejobi ikeja gra ikeja lagos,12,6,6,6,Beautiful 6 Bedroom Semi-detached duplex with roof top terrace finished to an extremely high standard in a great neighbourhood. 2 units Available. ... New. Supermarket Nearby. Parking Space. Boys Quater. Restaurants Nearby. ...,ikeja,1,1,0,1,ikeja6,6000000.0,6200000.0,6200000.0,3,56,10,6200000
2390," 24 oba akinjobi way, ikeja, gra, lagos, ikeja gra, ikeja, lagos ikeja gra ikeja lagos",5,3,2,3,Serviced 2 bedroom flat with CofO ... New. Serviced. 24 Hours Electricity. Children Play Ground. Parking Space. Drainage System. Security. Child Care. Water Treatment. Street Lights. Security Doors. C Of O. Big Compound. Pop Ceiling. All Room Ensuit. Swimming Pool. 24 Hours Security. Survey. ...,ikeja,1,1,1,1,ikeja3,1500000.0,3260000.0000000005,3000000.0,4,34,6,3500000
2391, opebi road ikeja opebi ikeja lagos,7,4,3,4,Very lovely environment Easy access Good road networking ... Cheap. Security Doors. Big Compound. Security. Supermarket Nearby. Parking Space. ...,ikeja,0,0,0,0,ikeja4,3000000.0,4000000.0,4000000.0,0,43,8,2000000
2392," shonny str, shonibare estate maryland ikeja mobolaji bank anthony way ikeja lagos",8,5,3,5,3bedroom flat plus 1 Room BQ. N 3.5million. All rooms ensuite. Service charge excluding diesel is 1million at shonny Shonibare estate maryland ... Furnished. Dry. Serviced. Swimming Pool. Pop Ceiling. Water Treatment. Parking Space. Security Doors. Security. Big Compound. All Room Ensuit. 24 Hours Security. Boys Quater. Cctv Cameras. ...,ikeja,0,0,0,0,ikeja5,5000000.0,5500000.0,5500000.0,0,52,9,3500000
2393, shonibare estate mobolaji bank anthony way ikeja lagos,11,6,5,6,Serviced 2wings of 5bedroom house plus a room BQ off shonny way Shonibare estate. It has a central generator. 4 rooms ensuite. It can be used for both commercial or residential purposes. Service ... Furnished. Renovated. Serviced. Pop Ceiling. Parking Space. Security Doors. Security. Big Compound. All Room Ensuit. 24 Hours Security. Boys Quater. Cctv Cameras. ...,ikeja,0,0,0,0,ikeja6,6000000.0,6200000.0,6200000.0,0,56,10,4700000
2394, orileyimu str off allen allen avenue ikeja lagos,2,1,1,1,Newly built Back of Duplex with is own gate Easy access to 2 diffrent roads Allen and Toyin Nice environment ... New. Furnished. Water Treatment. Parking Space. All Room Ensuit. 24 Hours Security. Big Compound. ...,ikeja,0,0,0,0,ikeja1,500000.0,800000.0,685000.0,0,11,2,450000
2395," emeka anyaoku millennium estate, muiz banire street, ikeja gra ikeja gra ikeja lagos",9,5,4,5,"24hrs electricity supply, 24hrs security, clean water supply, very clean environment, near police command, low service charge, highly secured environ. ... Serviced. Furnished. Street Lights. Fast Internet. 24 Hours Security. All Room Ensuit. Water Treatment. Security. Big Compound. 24 Hours Electricity. Parking Space. Cctv Cameras. ...",ikeja,0,0,0,0,ikeja5,5000000.0,5500000.0,5500000.0,0,52,9,3500000
2396," afariogun street, off awolowo way, ikeja, lagos obafemi awolowo way ikeja lagos",4,2,2,2,"Three bedrooms flat, office use only ... Cheap. Dry. Renovated. Furnished. Cctv Cameras. 24 Hours Electricity. Security. Restaurants Nearby. C Of O. Parking Space. Supermarket Nearby. ...",ikeja,0,0,0,0,ikeja2,950000.0,1540000.0000000002,1300000.0,0,25,5,800000
2397,  peace est aboru iyana ipaja lagos pipeline alimosho lagos,7,4,3,4,Newly refurbished 3bedroom bungalow self compound at peace Est baruwa ipaja road Lagos pop ceiling kitchen cabinets and Waldrope all rooms ensuite all round tiles and fenced gated and bole hole and the area is ... Serviced. Cheap. Renovated. Furnished. Dry. New. Parking Space. Street Lights. All Room Ensuit. Fast Internet. Pop Ceiling. Child Care. 24 Hours Electricity. Mosques Nearby. Survey. Water Treatment. Gym. Supermarket Nearby. 24 Hours Security. Free Wifi. Free Coffee. C Of O. Children Play Ground. Printing Service. Front Desk Service. Security Doors. Restaurants Nearby. Big Compound. Drainage System. Cctv Cameras. Security. ...,iyana ipaja,0,0,0,0,iyana ipaja4,650000.0,650000.0,650000.0,0,15,3,500000
2398,  an estate inside aboru iyana ipaja lagos alimosho lagos,6,3,3,3,Newly built 2bed king size at an estate Aboru Iyana Ipaja Lagos with pop ceiling kitchen cabinets and Waldrope all rooms ensuite all round tiles and fenced gated and bole hole and the area is ... Serviced. Furnished. Dry. New. Excision. Parking Space. Street Lights. All Room Ensuit. Fast Internet. Pop Ceiling. Boys Quater. Governor's Consent. Child Care. 24 Hours Electricity. Mosques Nearby. Church Nearby. Survey. Water Treatment. Gym. Supermarket Nearby. 24 Hours Security. Office Supplies. C Of O. Children Play Ground. Printing Service. Front Desk Service. Security Doors. Restaurants Nearby. Big Compound. Drainage System. Cctv Cameras. Elevator. Security. ...,iyana ipaja,0,0,0,1,iyana ipaja3,500000.0,550000.0,515000.0,1,11,2,500000
2399,  t alimosho lagos,4,2,2,2,Newly renovated miniflat at John str iyana ipaja closet to the bus stp of iyana ipaja Lagos and it's all round tiles and fenced gated and bole hole and the area is Attributed with constant ... Serviced. Renovated. Furnished. Dry. New. Excision. Parking Space. Street Lights. All Room Ensuit. Fast Internet. Governor's Consent. Child Care. 24 Hours Electricity. Mosques Nearby. Church Nearby. Survey. Water Treatment. Gym. Supermarket Nearby. 24 Hours Security. Free Wifi. Free Coffee. Office Supplies. C Of O. Children Play Ground. Printing Service. Front Desk Service. Security Doors. Restaurants Nearby. Big Compound. Drainage System. Cctv Cameras. Security. ...,iyana ipaja,0,0,0,0,iyana ipaja2,400000.0,500000.0,485000.0,0,6,1,250000
2400,  hilltop estate iyana ipaja lagos pipeline alimosho lagos,4,2,2,2,Newly built 2bed at Hiltop estate Aboru Iyana Ipaja Lagos all round tiles and fenced gated and bole hole and the area is Attributed with constant power supply of electricity good road network and good ... Serviced. Furnished. Dry. Old. New. Parking Space. Street Lights. Fast Internet. Governor's Consent. Child Care. 24 Hours Electricity. Mosques Nearby. Church Nearby. Survey. Water Treatment. Gym. Supermarket Nearby. 24 Hours Security. Free Wifi. Free Coffee. Office Supplies. Children Play Ground. Printing Service. Front Desk Service. Security Doors. Restaurants Nearby. Big Compound. Drainage System. Cctv Cameras. Security. ...,iyana ipaja,0,0,0,1,iyana ipaja2,400000.0,500000.0,485000.0,1,6,1,400000
2401,  peace avenue evergreen est aboru iyana ipaja lagos alimosho lagos,6,3,3,3,Tentatively new 3bed rm flat at peace avenue evergreen Est aboru iyana ipaja Lagos with pop ceilings kitchen cabinet and wardropes with enough parking space no landlord and no racial discrimination against tribe nor religion ... Serviced. Cheap. Renovated. Furnished. Dry. New. Free Coffee. Office Supplies. Children Play Ground. Parking Space. Jacuzzi. Street Lights. Front Desk Service. All Room Ensuit. Fast Internet. Pop Ceiling. Restaurants Nearby. Big Compound. Drainage System. Child Care. 24 Hours Electricity. Cctv Cameras. Mosques Nearby. Church Nearby. Survey. Water Treatment. Supermarket Nearby. Security. 24 Hours Security. Free Wifi. ...,iyana ipaja,0,0,0,0,iyana ipaja3,500000.0,550000.0,515000.0,0,11,2,400000
2402, iyana ipaja ipaja lagos,5,3,2,3,"Very neat 2 bedroom flats on ground and upper floors by Water bus stop, Iyana Ipaja, Lagos. Rent:#550,000 p.a (Upper Floor) Rent:#600,000 p.a (Ground Floor) Agency and legal fees @ 10% each ... Renovated. Drainage System. Water Treatment. Security Doors. Security. Pop Ceiling. Big Compound. All Room Ensuit. Parking Space. Fast Internet. ...",iyana ipaja,1,1,0,1,iyana ipaja3,500000.0,550000.0,515000.0,3,11,2,550000
2403, prime garden estate aboru iyana ipaja ipaja lagos,6,3,3,3,"Executive Newly 2bedroom flat Apartment, with wardrobe kitchen cabinet pop ceiling water heater all ties floor security guard @ Prime Garden Estate Iyana Ipaja ... Furnished. New. Pop Ceiling. All Room Ensuit. 24 Hours Electricity. 24 Hours Security. ...",iyana ipaja,1,1,0,1,iyana ipaja3,500000.0,550000.0,515000.0,3,11,2,550000
2404, iyana paja road iyana ipaja ipaja lagos,8,4,4,4,"Executive 3bedroom Flat Apartment, with wardrobe kitchen cabinet pop ceiling All ties floor. Interlocking compound with good security Network, At prime Garden Estate Iyana paja ... Renovated. Furnished. Security. Pop Ceiling. Big Compound. All Room Ensuit. Supermarket Nearby. 24 Hours Electricity. 24 Hours Security. ...",iyana ipaja,1,1,0,1,iyana ipaja4,650000.0,650000.0,650000.0,3,15,3,650000
2405, prime garden estate iyana paja iyana ipaja ipaja lagos,8,4,4,4,"Executive 3bedroom flat apartment, with wardrobe kitchen cabinet all ties floor. With good security network. At prime garden estate iyana paja ... Cheap. Renovated. Furnished. Security. Big Compound. All Room Ensuit. Supermarket Nearby. 24 Hours Electricity. 24 Hours Security. ...",iyana ipaja,0,0,0,0,iyana ipaja4,650000.0,650000.0,650000.0,0,15,3,500000
2406," command, ikola road. iyana ipaja ipaja lagos",5,3,2,3,all round tiles all room ensuite visitors toilet floored n spacious compound no landlord ... New. Cheap. All Room Ensuit. 24 Hours Security. 24 Hours Electricity. Office Supplies. Street Lights. Big Compound. Survey. ...,iyana ipaja,0,0,0,0,iyana ipaja3,500000.0,550000.0,515000.0,0,11,2,400000
2407, pleasure iyana ipaja ipaja lagos,6,3,3,3,clean All round tiles all room ensuite Visitors toilet big compound parking space big kitchen with wall tiles and very close to the bus stop ... Old. Dry. New. Cheap. All Room Ensuit. 24 Hours Security. 24 Hours Electricity. Street Lights. Big Compound. Restaurants Nearby. Parking Space. Fast Internet. Supermarket Nearby. ...,iyana ipaja,0,0,0,1,iyana ipaja3,500000.0,550000.0,515000.0,1,11,2,500000
2408, aboru iyana ipaja ipaja lagos,6,3,3,3,Lovely 3 bedroom flat all tiles floor upstairs all rooms ensuit with wardrobe 9ice kitchen with cabinet with dinning space fenced gate water at Harmony estate Aboru Iyana Ipaja 500k ... Parking Space. Governor's Consent. ...,iyana ipaja,0,0,0,1,iyana ipaja3,500000.0,550000.0,515000.0,1,11,2,500000
2409, iyana ipaja aboru egbeda alimosho lagos,2,1,1,1,1bedroom self contain with nice compound. ... Cheap. Dry. New. Parking Space. Big Compound. 24 Hours Electricity. ...,iyana ipaja,0,0,0,1,iyana ipaja1,150000.0,250000.0,200000.0,1,2,1,150000
2410, ishola okosule inside aboru iyana ipaja lagos pipeline alimosho lagos,2,1,1,1,Standard single room at ishola okosule inside aboru iyana ipaja Lagos and the area is Attributed with constant power supply of electricity good road network and good drinking water hospitals schools and other social amenities ... Serviced. Cheap. Renovated. Dry. Free Coffee. C Of O. Children Play Ground. Parking Space. Street Lights. Security Doors. Fast Internet. Restaurants Nearby. Drainage System. Child Care. 24 Hours Electricity. Cctv Cameras. Mosques Nearby. Church Nearby. Survey. Water Treatment. Supermarket Nearby. Security. 24 Hours Security. Free Wifi. ...,iyana ipaja,0,0,0,0,iyana ipaja1,150000.0,250000.0,200000.0,0,2,1,90000
2411, iyana ipaja aboru egbeda alimosho lagos,2,1,1,1,A room self contain with nice compound. ... Cheap. Dry. New. Parking Space. Big Compound. Drainage System. 24 Hours Electricity. ...,iyana ipaja,0,0,0,1,iyana ipaja1,150000.0,250000.0,200000.0,1,2,1,150000
2412, iyana ipaja aboru egbeda alimosho lagos,6,3,3,3,Good ... Cheap. Dry. New. Parking Space. Big Compound. ...,iyana ipaja,0,0,0,0,iyana ipaja3,500000.0,550000.0,515000.0,0,11,2,300000
2413, governors road alimosho iyana-ipaja extension egbeda alimosho lagos,2,1,1,1,Lovely Spacious 1bedroom mini flat with upstairs with all round tiles water running fenced compound gate and maximum security ... Cheap. New. Parking Space. Security Doors. Supermarket Nearby. Street Lights. 24 Hours Security. Restaurants Nearby. Security. All Room Ensuit. Big Compound. ...,iyana ipaja,1,1,1,1,iyana ipaja1,150000.0,250000.0,200000.0,4,2,1,250000
2414, hitop estate alimosho iyana-ipaja extension egbeda alimosho lagos,2,1,1,1,It is lovely and spacious roomself with water running fenced compound gate and maximum security ... Cheap. New. Furnished. Parking Space. Security Doors. Supermarket Nearby. Street Lights. 24 Hours Security. Restaurants Nearby. Security. All Room Ensuit. Big Compound. ...,iyana ipaja,0,0,0,1,iyana ipaja1,150000.0,250000.0,200000.0,1,2,1,150000
2415, iyana ipaja ipaja lagos,4,2,2,2,A decent 2 bedroom flat available for rent in Iyana Ipaja The house is located in a clean and secured environment. Its also very close to the main road. ... ...,iyana ipaja,0,0,0,0,iyana ipaja2,400000.0,500000.0,485000.0,0,6,1,300000
2416, iyana ipaja ipaja lagos,4,2,2,2,Two bedroom flat fence gate water with 2 toilet all round tiles and P.O.P ... ...,iyana ipaja,0,0,0,1,iyana ipaja2,400000.0,500000.0,485000.0,1,6,1,400000
2417, aboru iyana ipaja ipaja lagos,4,2,2,2,Beautiful 2 bedroom flat upstairs at Aboru Iyana Ipaja. Pop ceiling and ll facilities. Rent is #500k p.a. ... ...,iyana ipaja,1,1,0,1,iyana ipaja2,400000.0,500000.0,485000.0,3,6,1,500000
2418, iyana ipaja ipaja lagos,7,4,3,4,Executive 3 bedroom flat at *Prime Garden estate Aboru Iyana Ipaja*. Very secured estate. All round tiles and pop ceiling. All rooms ensuites with visitors toilet. Jacuzzi in master bedroom. Wardrobe in all rooms . ... New. Renovated. Security. All Room Ensuit. Big Compound. Supermarket Nearby. Restaurants Nearby. Security Doors. Parking Space. Pop Ceiling. 24 Hours Security. Drainage System. ...,iyana ipaja,1,1,0,1,iyana ipaja4,650000.0,650000.0,650000.0,3,15,3,650000
2419, iyana ipaja ipaja lagos,4,2,2,2,Decent 2 bedroom Apartment for rent in Ipaja. Close to the road Clean and secured environment ... ...,iyana ipaja,0,0,0,0,iyana ipaja2,400000.0,500000.0,485000.0,0,6,1,350000
2420, iyana ipaja ipaja lagos,4,2,2,2,A decent 2 bedroom flat available for rent in Iyana ipaja The house is located in a clean and secured environment. Its also very close to the main road. ... ...,iyana ipaja,1,1,1,1,iyana ipaja2,400000.0,500000.0,485000.0,4,6,1,550000
2421, iyana ipaja ipaja lagos,4,2,2,2,Decent 2 bedroom Apartment for rent in iyana ipaja. Close to the main road Good water Clean environment ... ...,iyana ipaja,0,0,0,1,iyana ipaja2,400000.0,500000.0,485000.0,1,6,1,400000
2422, iyana ipaja ipaja lagos,4,2,2,2,"VERY DECENT 2 BEDROOMS FLAT, ALL ROOMS ENSUITE, UPSTAIRS, FULLY TILED WITH WARDROBES, POP CEILING @ ABORU, IYANA IPAJA RENT: #500,000 P/A ... New. Renovated. All Room Ensuit. Big Compound. Supermarket Nearby. Restaurants Nearby. Parking Space. Pop Ceiling. 24 Hours Security. Drainage System. ...",iyana ipaja,1,1,0,1,iyana ipaja2,400000.0,500000.0,485000.0,3,6,1,500000
2423, hiltop estate iyana ipaja lagos alimosho lagos,4,2,2,2,MO INFLOWS PROPERTIES. *New Letting In Hilltop Estate Iyana-ipaja* TO LET?? A brand new 2 bedroom flat with two toilets and fully tiled floors all round located in a very secured and beautiful estate (Hilltop Estate) Iyana-ipaja. *Rent ... New. Security. Parking Space. 24 Hours Security. ...,iyana ipaja,0,0,0,1,iyana ipaja2,400000.0,500000.0,485000.0,1,6,1,450000
2424, pipeline alimosho lagos,7,4,3,4,3 bedroom Flat / Apartment for rent Pipeline Alimosho Lagos ... New. Renovated. Security. All Room Ensuit. Supermarket Nearby. Restaurants Nearby. Security Doors. Parking Space. Pop Ceiling. 24 Hours Security. Street Lights. Printing Service. Water Treatment. ...,iyana ipaja,1,1,0,1,iyana ipaja4,650000.0,650000.0,650000.0,3,15,3,650000
2425, iyana ipaja ipaja lagos,4,2,2,2,"Clean and sharp 2 bedroom flats in a serene environment in , Iyana Ipaja, Lagos. Rent : #550K & #600K p.a respectively ... ...",iyana ipaja,1,1,1,1,iyana ipaja2,400000.0,500000.0,485000.0,4,6,1,550000
2426, orile agege agege lagos,9,5,4,5,4 bedroom Flat / Apartment for rent orile agege Agege Lagos ... New. Security. All Room Ensuit. Supermarket Nearby. Restaurants Nearby. Security Doors. Parking Space. Pop Ceiling. 24 Hours Security. Street Lights. Water Treatment. ...,iyana ipaja,1,1,0,1,iyana ipaja5,1200000.0,1200000.0,1200000.0,3,29,5,1200000
2427, prime estate iyana ipaja ipaja lagos,6,3,3,3,Executive 3 bedroom flat at Prime Garden Estate Aboru Iyana Ipaja. Very secured estate. All round tiles and pop ceiling. All rooms ensuites with visitors toilet. Jacuzzi in master bedroom. Wardrobe in all rooms . ... ...,iyana ipaja,1,1,1,1,iyana ipaja3,500000.0,550000.0,515000.0,4,11,2,650000
2428," prime garden estate,aboru iyana ipaja . alimosho lagos",7,4,3,4,Executive 3 bedroom flat at prime Garden estate Aboru iyana ipaja . ... New. ...,iyana ipaja,1,1,0,1,iyana ipaja4,650000.0,650000.0,650000.0,3,15,3,650000
2429, an estate inside aboru iyana ipaja alimosho lagos,6,3,3,3,Newly built 2-bed king-size with pop ceiling kitchen cabinets and Wardrobe all rooms ensuite all round tiles and fenced gated and bole hole and the area is Attributed with a constant power supply of electricity ... ...,iyana ipaja,0,0,0,1,iyana ipaja3,500000.0,550000.0,515000.0,1,11,2,500000
2430, hilltop estate iyana ipaja lagos alimosho lagos,4,2,2,2,Newly built 2 bedroom at Hiltop estate Aboru Iyana Ipaja Lagos all round tiles and fenced gated and bole hole and the area is Attributed with a constant power supply of electricity good road network ... ...,iyana ipaja,0,0,0,1,iyana ipaja2,400000.0,500000.0,485000.0,1,6,1,400000
2431," plot 350, wilson emelike street, hilltop estate aboru, iyana-ipaja egbeda alimosho lagos",2,1,1,1,"A two bedroom flat located in hilltop estate, a secure conducive and accessible area closeby to the Lagos abeokuta expressway with all the necessary amenities to ease healthy living. It is well ventilated and spacious ... Renovated. Dry. Cheap. Security Doors. 24 Hours Security. Drainage System. Big Compound. Supermarket Nearby. Water Treatment. Restaurants Nearby. Security. Pop Ceiling. ...",iyana ipaja,1,1,1,1,iyana ipaja1,150000.0,250000.0,200000.0,4,2,1,300000
2432,  adekunle yaba lagos,7,4,3,4,"Newly Built 3 bedroom flat all en-suit with a visitor's toilet at Adekunle, Yaba For rent at N1.8m per annum. Total package is N2.5m with service charge, refundable caution fee and agent/agreement. ... Serviced. Cheap. Dry. New. Big Compound. Security. All Room Ensuit. Parking Space. ...",yaba,1,0,0,1,yaba4,1500000.0,2000000.0,1800000.0,2,34,6,1800000
2433,  onike yaba lagos,9,5,4,5,Newly Built Luxury finished Serene environment and secured estate Massive car park space Accessible road network ... Dry. New. Street Lights. Big Compound. Supermarket Nearby. All Room Ensuit. Drainage System. 24 Hours Security. Children Play Ground. Survey. Cctv Cameras. Security Doors. Security. Child Care. ...,yaba,0,0,0,1,yaba5,3000000.0,3260000.0,3200000.0,1,43,8,3000000
2434,  adekunle yaba lagos,2,1,1,1," Search using property ID Property Listing ID Title Listing Type Location Area Property Type Listing Category Bedrooms Property Price Garage Bathrooms Description Added to Blog Date Listed No of Pics 438 Mini flat at Adekunle rent Yaba Mini Flat Featured 1 350000 yes 1 Mini flat for rent at Adekunle Yaba Lagos Rent: N350,000 Kindly call the phone numbers below for more info; APRO GLOBAL ... Security. Supermarket Nearby. Restaurants Nearby. ...",yaba,0,0,0,0,yaba1,450000.0,600000.0,500000.0,0,8,2,350009
2435,  moore road sabo yaba lagos,7,4,3,4,"This is a lovely Brand New Executive 3 Bedroom Flat @ Moore Road Yaba. It is well furnished with well made wardrobes and a nice kitchen cabinets with all the rooms ensuite with guest toilet, ... Serviced. Furnished. New. Parking Space. Security. Security Doors. All Room Ensuit. 24 Hours Security. Pop Ceiling. Big Compound. ...",yaba,1,1,1,1,yaba4,1500000.0,2000000.0,1800000.0,4,34,6,2500000
2436,  borno way adekunle yaba lagos,16,8,8,8,This is Big Office @ Adekunle. The whole building for rent or Sales. Rent is 4M naira per year and Sale 90M naira ... Parking Space. Security. Security Doors. 24 Hours Security. Big Compound. ...,yaba,1,1,0,1,yaba8,4000000.0,4000000.0,4000000.0,3,50,9,4000000
2437,  carter adekunle yaba lagos,7,4,3,4,"This is a lovely Newly Built Executive 3 Bedroom Flat @ Adekunle Yaba. It is well furnished with well made wardrobes and a nice kitchen cabinets with all the rooms ensuite with guest toilet, parking space, ... Serviced. Furnished. New. Parking Space. Security. Security Doors. All Room Ensuit. 24 Hours Security. Pop Ceiling. Big Compound. ...",yaba,1,0,0,1,yaba4,1500000.0,2000000.0,1800000.0,2,34,6,1800000
2438,  brown akoka yaba lagos,5,3,2,3,"New Lovely Executive 2 Bedroom Flat @ Akoka Yaba. It is well furnished with well made wardrobes and a nice kitchen cabinets with all the rooms ensuite with guest toilet, parking space, borehole water. Rent ... Serviced. Furnished. New. Parking Space. Security. Security Doors. All Room Ensuit. 24 Hours Security. Pop Ceiling. Big Compound. ...",yaba,0,0,0,1,yaba3,1000000.0,1500000.0,1300000.0,1,27,5,1200000
2439,  zanzi estate yaba lagos,7,4,3,4,"This is a lovely, Clean Spacious 3 Bedroom Flat @ Onike Yaba. It is well furnished with well made wardrobes and a nice kitchen cabinets with all the rooms ensuite with guest toilet, big parking ... Furnished. Parking Space. Security. Security Doors. All Room Ensuit. 24 Hours Security. Big Compound. ...",yaba,0,0,0,1,yaba4,1500000.0,2000000.0,1800000.0,1,34,6,1500000
2440,  ogungbamila akoka yaba lagos,2,1,1,1,"This is a lovely Serviced Miniflat @ Akoka Yaba. It is well furnished with well made wardrobes and a nice kitchen cabinets with one toilet and bathroom, parking space. Rent is 500k per year Serviced ... Serviced. Furnished. New. Parking Space. Security. Security Doors. 24 Hours Security. Pop Ceiling. Big Compound. ...",yaba,1,0,0,1,yaba1,450000.0,600000.0,500000.0,2,8,2,500000
2441,"  morroco, waec area. yaba lagos",6,3,3,3,3 Bedroom Flat for rent in a Block of 4 Flats in a big compound with Car park. Rent: 1m ... ...,yaba,0,0,0,1,yaba3,1000000.0,1500000.0,1300000.0,1,27,5,1000000
2442,"  folaagoro road, yaba, lagos. fola agoro yaba lagos",11,6,5,6,"Newly Renovated 5 Bedroom Duplex House with visitor's toilet & kitchen storage space. On the ground floor, there is a Large Parlour & a room (guest room) & the kitchen. Upstairs are 4 ensuite rooms & another ... ...",yaba,1,1,0,1,yaba6,3000000.0,3000000.0,3000000.0,3,43,8,3000000
2443,  queens street alagomeji yaba lagos,6,3,3,3,"This is a 4 Bedroom Self-Compound House for rent in Alagomeji, Yaba. It's suitable for both Residential or Commercial/Office Use. Rent: 3m Per Annum ... ...",yaba,1,1,1,1,yaba3,1000000.0,1500000.0,1300000.0,4,27,5,1800000
2444,  in a secute & gated estate in yaba. yaba lagos,8,4,4,4,"This is a very Spacious 3 Bedroom all rooms ensuite flat + visitor's toilet, Spacious kitchen with fitted kitchen cabinets & balconies. Spacious Compound that can accommodate over 15 cars. ONLY 4 FLATS TO SHARE COMPOUND. Rent: ... ...",yaba,0,0,0,1,yaba4,1500000.0,2000000.0,1800000.0,1,34,6,1500000
2445,"  off commercial avenue, sabo, yaba. sabo yaba lagos",7,4,3,4,Fully Serviced & Spacious 3 Bedroom all rooms ensuite flat. Prepaid Meter Installed Sufficient Car Park in the Compound. Annual Rent: 1.8m Annual Service Charge: 357k Monthly Diesel Deposit: 30k ... ...,yaba,1,0,0,1,yaba4,1500000.0,2000000.0,1800000.0,2,34,6,1800000
2446,"  off queens street, alagomeji, yaba alagomeji yaba lagos",6,3,3,3,"Lovely 3 Bedroom Duplex + 1 Room Bq. Personal Compound, Borehole Water, Sufficient Car Park etc. Suitable For Personal Residential or Office Usage. Rent: 2m Per Annum ... ...",yaba,1,1,1,1,yaba3,1000000.0,1500000.0,1300000.0,4,27,5,1800000
2447,"  in a serene & gated estate in onike, yaba. onike yaba lagos",9,5,4,5,"Lovely & Spacious 4 Bedroom all rooms en-suite flat in a Gated, Serene & Secure Estate in Onike, Yaba, Lagos. Features include Prepaid Meter, Spacious Car Park inside & outside the Compound. Spacious kitchen + kitchen ... ...",yaba,0,0,0,0,yaba5,3000000.0,3260000.0,3200000.0,0,43,8,2000000
2448,"  commercial avenue, sabo, yaba. sabo yaba lagos",7,4,3,4,"Newly Renovated & Furnished 3 Bedroom all rooms ensuite flat with visitor's toilet, large balcony, etc. All rooms & the Sitting Room are furnished with Air Conditioning System. All the bathrooms & kitchen have water heater installed ... ...",yaba,1,1,1,1,yaba4,1500000.0,2000000.0,1800000.0,4,34,6,2500000
2449,"  off commercial avenue, sabo, yaba. sabo yaba lagos",5,3,2,3,"Spacious 2 bedroom flat all rooms ensuite, adequate electricity, security, located in a serene environment at Sabo, Yaba, Lagos. Rent: 1.5m ... ...",yaba,1,1,1,1,yaba3,1000000.0,1500000.0,1300000.0,4,27,5,1500000
2450,"  off hebert macaulay way, alagomeji, yaba. alagomeji yaba lagos",6,3,3,3,"Newly Built 3 Bedroom Flat with Prepaid Meter & Car Park. Location: Alagomeji, Yaba. Rent: 1.5m Annual Maintenance Fee: 300k Agency 10% Legal 10% ... New. ...",yaba,1,1,1,1,yaba3,1000000.0,1500000.0,1300000.0,4,27,5,1500000
2451,"  off hebert macaulay way, adekunle, yaba. adekunle yaba lagos",7,4,3,4,"3 Bedroom ensuite flat with water Heater, balcony, prepaid meter & car park. Only 3 tenants in the Compound. Rent: 1.3m ... ...",yaba,0,0,0,0,yaba4,1500000.0,2000000.0,1800000.0,0,34,6,1300000
2452,  in a serene & gated estate onike yaba lagos,7,4,3,4,"This is a Lovely Spacious 3 Bedroom all rooms ensuite flat with a private staircase, large kitchen with kitchen storage area, Balcony, Prepaid Meter & large Compound. Only 2 Tenants to Share Compound. Rent: 1.3m Legal 10% Agency ... ...",yaba,0,0,0,0,yaba4,1500000.0,2000000.0,1800000.0,0,34,6,1300000
2453,"  olonade street, alagomeji, yaba. alagomeji yaba lagos",7,4,3,4,"Lovely 3 Bedroom ensuite flat for rent in Alagomeji, Yaba. Located in a Gated & Serene Environment in Alagomeji, Yaba. Rent: 1.5m ... ...",yaba,0,0,0,1,yaba4,1500000.0,2000000.0,1800000.0,1,34,6,1500000
2454,  off onike roundabout onike yaba lagos,6,3,3,3,Spacious 3 Bedroom Flat with Car Park & Prepaid Meter Rent: 1.3m ... ...,yaba,1,0,0,1,yaba3,1000000.0,1500000.0,1300000.0,2,27,5,1300000
2455, sabo yaba lagos,8,4,4,4,"Exquisitely finished 3 Bedrooms Flats Available at Sabo Yaba Very tasteful, gated, round with fence, security incline area, clean environment, enormous car park, good tap water and borehole, tiled, all axis motorable, academically inclined environment, ... ...",yaba,0,0,0,0,yaba4,1500000.0,2000000.0,1800000.0,0,34,6,1400000
2456,  akoka yaba lagos,2,1,1,1," *Newly renovated Miniflat (1bedroom Apartment with pop ceiling ensuite) with all facilities in there LOCATION: Akoka , Yaba. Rent: N700 # Legal 100 # Agency 140 # Caution 50 ... Renovated. Security. All Room Ensuit. Parking Space. ...",yaba,1,1,1,1,yaba1,450000.0,600000.0,500000.0,4,8,2,600000
2457,  sabo yaba sabo yaba lagos,9,5,4,5,Brand New tastefully finished 4 Bedroom Terrace Duplex LOCATION: *in an Estate @ Sabo Yaba* PRICE: 2.5m per annum net ... New. Jacuzzi. Security. All Room Ensuit. Restaurants Nearby. Parking Space. Pop Ceiling. ...,yaba,0,0,0,0,yaba5,3000000.0,3260000.0,3200000.0,0,43,8,2500000
2458,  queen street alagomeji yaba lagos,2,1,1,1,Itâ€™s a newly built apartment of more than 10 Units of mini flat. (Room and Parlor with 2 Toilet and Kitchen) we are selling to does who desire to invest in real estate but donâ€™t have ... New. Furnished. All Room Ensuit. Big Compound. Security Doors. Parking Space. 24 Hours Electricity. Pop Ceiling. 24 Hours Security. Street Lights. ...,yaba,1,1,1,1,yaba1,450000.0,600000.0,500000.0,4,8,2,600000
2459, ozone sabo yaba lagos,6,3,3,3,"An Extra-large 2 Bedroom Flat with Dinning Area A Spacious Falt Ensuite and Fenced round with gates. Rent: 1.5m/ p.a For Inspection please call; Sunday;The Property Concession Company [redacted], [redacted] ... Old. Serviced. Furnished. Water Treatment. Security Doors. Security. Pop Ceiling. Street Lights. Big Compound. All Room Ensuit. Supermarket Nearby. Parking Space. 24 Hours Electricity. 24 Hours Security. Restaurants Nearby. ...",yaba,1,1,1,1,yaba3,1000000.0,1500000.0,1300000.0,4,27,5,1500000
2460, in an estate onike yaba lagos,7,4,3,4,"A Lovely Spacious 3 Bedroom Flat Ensuite Very Spacious Bedrooms 4 toilets 3bathrooms Rent: 1.5m per annum a year and half rent For Inspection please call; Sunday; The Property Concession Company 07051590841, 08024772756 ... Old. Renovated. Water Treatment. Security Doors. Security. Pop Ceiling. Street Lights. Big Compound. All Room Ensuit. Supermarket Nearby. Parking Space. 24 Hours Security. Restaurants Nearby. ...",yaba,0,0,0,1,yaba4,1500000.0,2000000.0,1800000.0,1,34,6,1500000
2461, off fola agoro abule ijesha yaba lagos,4,2,2,2,"A Lovely Spacious 2 Bedroom Flat 2 toilets and bathrooms Fenced round with gates Water, dinning, gated environment Easy access to the island Rent:700,000 For inspection cal: Sunday, The Property Concession Company ... Cheap. Renovated. Water Treatment. Security Doors. Security. Street Lights. Big Compound. All Room Ensuit. Supermarket Nearby. Parking Space. 24 Hours Security. ...",yaba,0,0,0,1,yaba2,700000.0,850000.0,800000.0,1,17,3,700000
2462, off chemist busstop akoka yaba lagos,7,4,3,4,"A Lovely Neat 3 Bedroom Flat Ensuite Ground Floor At Akoka. Ensuites with 4 toilets and 3 bathrooms. Wardrobes, Kitchen Cabinets, water, car park, Fenced round with gates. A gated environment with security. Rent: 1.2m For Inspection please ... Renovated. Security Doors. Security. Pop Ceiling. Street Lights. Big Compound. All Room Ensuit. Supermarket Nearby. Parking Space. 24 Hours Security. Restaurants Nearby. ...",yaba,0,0,0,0,yaba4,1500000.0,2000000.0,1800000.0,0,34,6,1200000
2463, onike onike yaba lagos,7,4,3,4,This is Two(2) unitz of three (3) bedroom flat on a very large compound at Onike. Each with it's on seprate entrance. Rent is 1.5m per annum. ... ...,yaba,0,0,0,1,yaba4,1500000.0,2000000.0,1800000.0,1,34,6,1500000
2464, off pako busstop akoka yaba lagos,2,1,1,1,"A Fantastic Spacious Miniflat at Off Pako Akoka. Pop, spacious, water, kitchen cabinets, fenced round with gates. Gated environment, car parks. Rent: 700,000 per annum. For inspection please call; Sunday The Property Concession Company ... Renovated. Furnished. Security Doors. Children Play Ground. Security. Pop Ceiling. Street Lights. Big Compound. All Room Ensuit. Supermarket Nearby. Parking Space. 24 Hours Security. Restaurants Nearby. ...",yaba,1,1,1,1,yaba1,450000.0,600000.0,500000.0,4,8,2,600000
2465, akoka yaba lagos,2,1,1,1,This property is located in yaba at Akoka it's consist of a selfcon 400k clean and spacious. Other charges follow suites. INSPECTION FEE IS 4K ... ...,yaba,0,0,0,0,yaba1,450000.0,600000.0,500000.0,0,8,2,400000
2466, off herbert macaulay ebute metta yaba lagos,2,1,1,1,"A brand new miniflat in a good environment. Easy access to the island and it's a very big apartment. Spacious, new, neat, water etc. Rent: 500k and 2yrs rent required For inspection call; Sunday ... Cheap. New. Security Doors. Security. Street Lights. Big Compound. 24 Hours Security. ...",yaba,1,0,0,1,yaba1,450000.0,600000.0,500000.0,2,8,2,500000
2467, sabo yaba lagos,2,1,1,1,Nice Roomself contain Location - SABO oyadiran extension. SABO YABA ... ...,yaba,0,0,0,0,yaba1,450000.0,600000.0,500000.0,0,8,2,300000
2468, fola agoro road fola agoro yaba lagos,11,6,5,6,"A fully renovated 5 Bedroom Duplex good for either residential or commercial use. A Spacious and Ensuite house. It has parking space and comes with 6 toilets and 5 bathrooms. pop, well finished, fenced round ... Renovated. Drainage System. Water Treatment. Security Doors. Security. Big Compound. All Room Ensuit. Supermarket Nearby. 24 Hours Security. ...",yaba,1,1,0,1,yaba6,3000000.0,3000000.0,3000000.0,3,43,8,3000000
2469, silvercrest estate onike yaba lagos,10,5,5,5,A Lovely 4 Bedroom Terraced Duplex in an Estate and it comes with Services Rent3.2m but 3m can fly. Service Charge: 30k per month except power. Covering security Cleaning etc. ... Old. Serviced. Security Doors. Child Care. Pop Ceiling. Street Lights. Big Compound. Cctv Cameras. All Room Ensuit. Supermarket Nearby. Parking Space. Children Play Ground. Security. Church Nearby. Jacuzzi. Restaurants Nearby. ...,yaba,1,0,0,1,yaba5,3000000.0,3260000.0,3200000.0,2,43,8,3200000
2470, off herbert macaulay way yaba lagos,7,4,3,4,"Newly Built 3 Bedroom Flat Ensuite To Let Ensuite Flat, Wardrobes, POP, Prepaid Metres Car parks, Fitted Kitchen Cabinets with Oven Microwaves and Washing Machine Rent: 1.8m Service Charge: 300k (Covers; Security,Cleaners,Waste disposals, Street Security, Pumping of water, Septic ... Serviced. Furnished. New. Water Treatment. Security Doors. Security. Pop Ceiling. Street Lights. Big Compound. All Room Ensuit. Supermarket Nearby. Parking Space. 24 Hours Security. Restaurants Nearby. ...",yaba,1,0,0,1,yaba4,1500000.0,2000000.0,1800000.0,2,34,6,1800000
2471, chemist area akoka yaba lagos,2,1,1,1,"A Fantastic Spacious Miniflat at Off chemist area Akoka. Pop, spacious, water, kitchen cabinets, fenced round with gates. Gated environment, car parks. Rent: 500,000 per annum. For inspection please call; Sunday The Property Concession Company ... Renovated. New. Boys Quater. Security Doors. Security. Pop Ceiling. Street Lights. Big Compound. All Room Ensuit. Supermarket Nearby. Parking Space. 24 Hours Security. Restaurants Nearby. ...",yaba,1,0,0,1,yaba1,450000.0,600000.0,500000.0,2,8,2,500000
2472, sabo yaba lagos,9,5,4,5,"4 Bedrooms duplex for rent at Sabo Yaba - Lagos Rent: N3,000,000 Donâ€™t miss this offer, call now; APRO GLOBAL REAL ESTATES Web:info@aproglobalestate. com.ng. Tel: 01-7620139 Mobile: 080-51-595-336,080-29-481-639 070-63-822-217, 070-82-974-088 ... Security. Supermarket Nearby. Parking Space. ...",yaba,0,0,0,1,yaba5,3000000.0,3260000.0,3200000.0,1,43,8,3000000
2473, bickersteth estate onike yaba lagos,9,5,4,5,"Lovely Superb Extra Spacious 4 Bedroom Flat Ensuite Spacious Sitting, Fitted Kitchen, Bq, Parking Space, Water Heater Prepaid Meter, Wardrobes Price: 2m For Inspection please call; Sunday, The Property Concession Company ... Cheap. Renovated. Security Doors. Security. Pop Ceiling. Street Lights. Big Compound. All Room Ensuit. Supermarket Nearby. Parking Space. 24 Hours Security. Restaurants Nearby. ...",yaba,0,0,0,0,yaba5,3000000.0,3260000.0,3200000.0,0,43,8,2000000
2474, tejuosho tejuosho yaba lagos,4,2,2,2,"A Very Spacious 2 Bedroom Flat with Car Park Spacious Sitting, Water, Well tiled Easy access to road and island. Rent: 700 per annum For inspection please call; Sunday The Property Concession Company ... Old. Security Doors. Security. Pop Ceiling. Printing Service. Big Compound. All Room Ensuit. Supermarket Nearby. Parking Space. 24 Hours Security. Restaurants Nearby. ...",yaba,0,0,0,1,yaba2,700000.0,850000.0,800000.0,1,17,3,700000
2475, akoka yaba lagos,4,2,2,2,This property is located at yaba In Akoka precisely it's consist of a newly renovated mini flat very spacious price tag is 700k a year rent. Other charges follow suites. INSPECTION FEE IS 5K ... ...,yaba,0,0,0,1,yaba2,700000.0,850000.0,800000.0,1,17,3,700000
2476, ebute metta yaba lagos,6,3,3,3,This property is a newly two bedrooms located in yaba ebute meta its consist of a two bedrooms aparment all rooms ensuites with water heaters .Price tag is 1.2m other charges follow suites NOTE : Terms ... ...,yaba,0,0,0,1,yaba3,1000000.0,1500000.0,1300000.0,1,27,5,1200000
2477, tejuosho yaba lagos,2,1,1,1,This property is located in yaba in a secured and serene environment .price tag is 400k a year rent and half that is 600k Other charges follow suites. INSPECTION FEE IS 5K ... ...,yaba,0,0,0,0,yaba1,450000.0,600000.0,500000.0,0,8,2,400000
2478, ozone environment sabo yaba lagos,7,4,3,4,"Office Space 3 Bedroom Brand New Spacious and serviced Good access road and easy accessibility. Strictly commercial use. Rent: 2m p.a Service Charge: 840,000 (Diesel, Power, 24 Hours Security, Waste disposal) For Inspection please call; Sunday, The Property ... Serviced. Furnished. New. Security Doors. Pop Ceiling. Street Lights. Office Supplies. Big Compound. All Room Ensuit. Supermarket Nearby. Parking Space. 24 Hours Electricity. 24 Hours Security. Water Treatment. Front Desk Service. Security. Restaurants Nearby. ...",yaba,1,1,1,1,yaba4,1500000.0,2000000.0,1800000.0,4,34,6,2000000
2479, heliconia court jibowu yaba lagos,7,4,3,4,A Lovely 3 Bedroom Semi-detached Duplex with bq Its in an Estate called Heliconia Estate off Herbert Macaulay Way. A secured residential estate in a secure environment It has parking space and comes with 4 toilets ... Serviced. Renovated. Drainage System. Security Doors. Pop Ceiling. Big Compound. Cctv Cameras. All Room Ensuit. Parking Space. 24 Hours Electricity. 24 Hours Security. Boys Quater. Water Treatment. Front Desk Service. Children Play Ground. Security. Swimming Pool. ...,yaba,1,1,1,1,yaba4,1500000.0,2000000.0,1800000.0,4,34,6,2500000
2480, .. adekunle yaba lagos,8,4,4,4,"A Newly Built 3 Bedroom Flat Ensuite To Let at Adekunle Yaba. Its off Herbert Macaulay Way Adekunle. A secured environment It has parking space and comes with 4 toilets and 3 bathrooms. pop, well finished, ... Serviced. New. Security Doors. Children Play Ground. Street Lights. Big Compound. All Room Ensuit. Parking Space. 24 Hours Security. ...",yaba,1,1,1,1,yaba4,1500000.0,2000000.0,1800000.0,4,34,6,2000000
2481, off onike roundabout onike yaba lagos,4,2,2,2,"Lovely Beautiful 2 Bedroom Flat Onike Really cute, spacious, water, security Car park.... Easy access to the island. Water, Rent: 850,000 p.a Please call; Sunday The Property Concession Company ... Old. Drainage System. Security Doors. Security. Pop Ceiling. Street Lights. Big Compound. All Room Ensuit. Supermarket Nearby. Parking Space. 24 Hours Security. Restaurants Nearby. ...",yaba,1,1,0,1,yaba2,700000.0,850000.0,800000.0,3,17,3,850000
2482, roundabout onike yaba lagos,2,1,1,1,"Good Standard Roomself Contain in Onike Yaba. toilet and bathroom, In a good and serene environment water, fenced round with gate,gated, security Rent: 300,000 p.a 1 yr rent For Inspection; Sunday; The Property Concession Company [redacted], [redacted] ... Cheap. New. Security Doors. Security. Street Lights. Mosques Nearby. Big Compound. Supermarket Nearby. Parking Space. 24 Hours Security. Restaurants Nearby. ...",yaba,0,0,0,0,yaba1,450000.0,600000.0,500000.0,0,8,2,300000
2483, monsuro abule oja yaba lagos,2,1,1,1,"A Newly Built Roomself Contained Its off Morris Street, A secured environment fenced round with gates. Rent: 380k p.a Service Charge: 84 thousand (7k per month) For Inspection please call; Sunday; The Property Concession Company [redacted], [redacted] ... Serviced. New. Water Treatment. Security Doors. Security. Pop Ceiling. Street Lights. All Room Ensuit. 24 Hours Security. ...",yaba,0,0,0,0,yaba1,450000.0,600000.0,500000.0,0,8,2,380000
2484, adekunle street adekunle yaba lagos,4,2,2,2,"A Good Miniflat with prepaid Meter. It's at Adekunle and has easy accessibility to the island. Rent: 500,000 A year and half Ror inspection please call; Sunday, The Property Concession Company ... Old. Cheap. Renovated. Water Treatment. Security Doors. Security. Street Lights. Big Compound. All Room Ensuit. Supermarket Nearby. 24 Hours Security. Restaurants Nearby. ...",yaba,0,0,0,0,yaba2,700000.0,850000.0,800000.0,0,17,3,500000
2485, close to costain ebute metta yaba lagos,6,3,3,3,"2 Bedroom Flat Ensuite Lovely and Newly Build Close to Costain and has easy access to the Island It comes with Kitchen Cabinets, Water, Security guards and has easy access to Island. Rent: 800,000 p.a 1year rent ... Cheap. New. Water Treatment. Security Doors. Security. Street Lights. Big Compound. All Room Ensuit. Supermarket Nearby. Parking Space. 24 Hours Security. Restaurants Nearby. ...",yaba,0,0,0,0,yaba3,1000000.0,1500000.0,1300000.0,0,27,5,800000
2486, off herbert macaulay way alagomeji yaba lagos,4,2,2,2,"A Newly Built Spacious Miniflat at Alagomeji Spacious Sitting, Water, Well tiled Easy access to road and island. Rent: 800 per annum For inspection please call; Sunday The Property Concession Company ... New. Security Doors. Security. Street Lights. Big Compound. All Room Ensuit. Parking Space. 24 Hours Security. Restaurants Nearby. ...",yaba,1,0,0,1,yaba2,700000.0,850000.0,800000.0,2,17,3,800000
2487, off queens street alagomeji yaba lagos,2,1,1,1,"A Newly Built Roomself Contained Its off herbert macaulay way in a secured environment fenced round with gates. Rent: 350k/p.a x 2yrs or 400k p.a x a yr 6months For Inspection please call; Sunday; The Property Concession Company [redacted], ... New. Security Doors. Security. Pop Ceiling. Street Lights. Big Compound. 24 Hours Security. ...",yaba,0,0,0,0,yaba1,450000.0,600000.0,500000.0,0,8,2,400000
2488, akoka yaba lagos,2,1,1,1,1 bedroom mini flat Mini flat Flat / Apartment for rent Akoka Yaba Lagos ... New. Big Compound. Supermarket Nearby. 24 Hours Security. Security Doors. Parking Space. Pop Ceiling. All Room Ensuit. Restaurants Nearby. Security. ...,yaba,1,1,1,1,yaba1,450000.0,600000.0,500000.0,4,8,2,600000
2489, onike yaba lagos,2,1,1,1,1 bedroom mini flat Mini flat Flat / Apartment for rent Onike Yaba Lagos ... New. Security. Security Doors. Parking Space. Supermarket Nearby. Restaurants Nearby. 24 Hours Security. All Room Ensuit. Pop Ceiling. Big Compound. ...,yaba,1,0,0,1,yaba1,450000.0,600000.0,500000.0,2,8,2,500000
2490, yaba adekunle yaba lagos,2,1,1,1,A lovely mini flat at adekunle yaba wit water and tiles gate compound ... Renovated. Security Doors. Security. Street Lights. Supermarket Nearby. Restaurants Nearby. Water Treatment. ...,yaba,0,0,0,0,yaba1,450000.0,600000.0,500000.0,0,8,2,350000
2491, off fola agoro road yaba lagos yaba lagos,7,3,4,3,5 bedroom Flat / Apartment for rent Off Fola agoro road yaba Lagos Yaba Lagos ... All Room Ensuit. Security Doors. 24 Hours Security. Street Lights. Restaurants Nearby. 24 Hours Electricity. Supermarket Nearby. Big Compound. Security. ...,yaba,0,0,0,1,yaba3,1000000.0,1500000.0,1300000.0,1,27,5,1000000
2492, akoka akoka yaba lagos,2,1,1,1,1 bedroom mini flat Mini flat Flat / Apartment for rent Akoka Akoka Yaba Lagos ... 24 Hours Security. Restaurants Nearby. Big Compound. Parking Space. Street Lights. Security. 24 Hours Electricity. Security Doors. Supermarket Nearby. ...,yaba,1,0,0,1,yaba1,450000.0,600000.0,500000.0,2,8,2,500000
2493, adekule adekunle yaba lagos,2,1,1,1,1 bedroom mini flat Mini flat Flat / Apartment for rent Adekule Adekunle Yaba Lagos ... Restaurants Nearby. Big Compound. Security. Street Lights. Security Doors. 24 Hours Security. 24 Hours Electricity. Supermarket Nearby. All Room Ensuit. Cctv Cameras. ...,yaba,0,0,0,0,yaba1,450000.0,600000.0,500000.0,0,8,2,350000
2494, onike yaba lagos,7,4,3,4,2 Nos Of Fantastic 3 bedroom en-suite with guest toilet up and down flats vacant in an estate at Onike Yaba... 1.5m per annum ... Parking Space. Street Lights. Supermarket Nearby. Security. Security Doors. All Room Ensuit. Pop Ceiling. Big Compound. Drainage System. ...,yaba,0,0,0,1,yaba4,1500000.0,2000000.0,1800000.0,1,34,6,1500000
2495, onike yaba lagos,7,4,3,4,"*Sharp Letting in Onike Yaba* 3 Bedroom En-suite With Guest Toilet, Fitted Kitchen Cabinets, Wardrobe, Spacious compound with car park at Onike Yaba ..Upstairs. 1.5m per annum 2yrs required - Working Class ... Parking Space. Supermarket Nearby. Security. Security Doors. All Room Ensuit. Pop Ceiling. Big Compound. Drainage System. ...",yaba,0,0,0,1,yaba4,1500000.0,2000000.0,1800000.0,1,34,6,1500000
2496, adekunle yaba lagos,7,4,3,4,"Brand new & Executive 3bedroom flat all rooms ensuite with guest toilet, park upstairs & downstairs Available 1.8m p.a At Adekunle Yaba Lagos Available for sales too @35m per flat might be slightly negotiable Rent: 1,800,000 Legal: 180,000 Agency: ... New. Parking Space. Street Lights. Security. Security Doors. All Room Ensuit. 24 Hours Security. Pop Ceiling. Big Compound. Drainage System. ...",yaba,1,0,0,1,yaba4,1500000.0,2000000.0,1800000.0,2,34,6,1800000
2497, akoka yaba lagos,4,2,2,2,"To Let: 3bedroom flat with 2toilets and 2baths. A Room En-suite, Tiled Living room, Borehole water, Wardrobes. Top most floor available. Rent: 700k per annum. Location: Community Road, Akoka, Yaba. Legal Fee: 70k Agency Fee: 140k ... Parking Space. Drainage System. ...",yaba,0,0,0,1,yaba2,700000.0,850000.0,800000.0,1,17,3,700000
2498, .. akoka yaba lagos,5,3,2,3,"NEWLY BUILT 2BEDROOM APARTMENT @ Olanrewaju Street Akoka.(serious work is going on), very calm and secured street, people have already started paying for their own choice of flats. It goes at N850k down, ... New. Parking Space. Supermarket Nearby. Security. Security Doors. All Room Ensuit. Big Compound. Drainage System. ...",yaba,0,0,0,0,yaba3,1000000.0,1500000.0,1300000.0,0,27,5,900000
2499, akoka yaba lagos,2,1,1,1,"*Newly renovated Miniflat with all facilities in Akoka* , *Yaba.* *Miniflat* : 700 Legal 140 Agency 140 Caution 50 *Room Self Contained* Rent: 400 Legal 80 Agency 80 Caution 50 ... Renovated. New. Parking Space. Security. Security Doors. Pop Ceiling. Big Compound. ...",yaba,1,1,1,1,yaba1,450000.0,600000.0,500000.0,4,8,2,600000
2500, onike yaba lagos,4,2,2,2, 2 bedroom flat @ Onike. Rent #850*y. Age #150 #com #150 con #50 ... ...,yaba,1,1,0,1,yaba2,700000.0,850000.0,800000.0,3,17,3,850000
2501, ebute meta east ebute metta yaba lagos,7,4,3,4,"Executive and recently built 3bedroom flat, all rooms ensuite + guest toilet, very Secured + Car Park off Abeokuta street, ebute meta east, upstairs, POP, Screeded walls, Yaba 1.2m per annum ... Parking Space. Supermarket Nearby. Security. Security Doors. All Room Ensuit. 24 Hours Security. Pop Ceiling. Restaurants Nearby. Big Compound. Drainage System. ...",yaba,0,0,0,0,yaba4,1500000.0,2000000.0,1800000.0,0,34,6,1200000
2502, morocco yaba lagos,6,3,3,3,3bedroom flat with master bedroom ensuite on ground floor front flat at Vincent Street off Morocco... 1m per annum ... Parking Space. Big Compound. ...,yaba,0,0,0,1,yaba3,1000000.0,1500000.0,1300000.0,1,27,5,1000000
2503, off cemetery road ebute metta yaba lagos,5,3,2,3,"3bed ground floor Rent 800k Agent160k /Agreement 80k Caution 50k Total package-1.90k Location ebute metta ,ibandan by bola Car park available Video and pictures available Serious client only. ... Children Play Ground. Parking Space. Street Lights. Security. Security Doors. Big Compound. ...",yaba,0,0,0,0,yaba3,1000000.0,1500000.0,1300000.0,0,27,5,800000
2504, morocco yaba lagos,6,3,3,3,"A Recently built Modern 3bd @ Morocco, with 3toilets and bath, in a block of 4flats, ground floor, with a fitted wardrobes and kitchen cabinets n cupboard, fenced round with gate and parking space, #1M ... Parking Space. Big Compound. Drainage System. ...",yaba,0,0,0,1,yaba3,1000000.0,1500000.0,1300000.0,1,27,5,1000000
2505, ebute meta east ebute metta yaba lagos,2,1,1,1,"Newly Built miniflat with balcony at ebute meta east close to Oyingbo 350k a yr & half rent required, Note: no car park Total package 745k ... New. ...",yaba,0,0,0,0,yaba1,450000.0,600000.0,500000.0,0,8,2,350000
2506, helliconia court yaba gra yaba lagos,9,5,4,5,"An Executive and Luxury 3bd Terrace Duplex @ Herliconia Estate, Yaba GRA, with all rooms ensuites, with Bq, swimming pool, Gym house, table tennis, etc, with a fitted wardrobes and kitchen cabinets n cupboard, with ... Serviced. Parking Space. Street Lights. Swimming Pool. Supermarket Nearby. Security. Security Doors. All Room Ensuit. 24 Hours Security. Pop Ceiling. Boys Quater. Big Compound. Drainage System. ...",yaba,1,0,0,1,yaba5,3000000.0,3260000.0,3200000.0,2,43,8,3200000
2507, ebute meta ebute metta yaba lagos,5,3,2,3,"2 bedroom @ ebute metta west, all rooms ensuite, with kitchen cabinet and car park. Rent 1m/1.2 respectively Agency fee 200k Agreement 100k Caution fee 100k. ... New. Parking Space. Street Lights. Security Doors. All Room Ensuit. Pop Ceiling. Big Compound. Drainage System. ...",yaba,0,0,0,1,yaba3,1000000.0,1500000.0,1300000.0,1,27,5,1000000
2508, ebute meta west ebute metta yaba lagos,5,3,2,3,"Brand new 2bedroom flat off apapa road ebute meta west, close to costain Rent: 1m & 900k respectively Breakdown Agreement 200k Agency fee 200k Caution fee 100k That is for the front flats. While the back flat is Rent: 900k Agency ... New. Parking Space. Street Lights. Supermarket Nearby. Security. Security Doors. All Room Ensuit. Pop Ceiling. Drainage System. ...",yaba,0,0,0,1,yaba3,1000000.0,1500000.0,1300000.0,1,27,5,1000000
2509, morocco yaba lagos,4,2,2,2,"2bed bungalow @morocco, Yaba 2toilet & bathroom together newly renovated with enough parking space. Price:700k a year rent Note: no ibo client working class accordingto landlord instructions. Breakdown Rent:700k Legal:150k Agency:150k Caution:50k Total package 1,050,000 Not negotiable... ... Parking Space. Security. Security Doors. Big Compound. Drainage System. ...",yaba,0,0,0,1,yaba2,700000.0,850000.0,800000.0,1,17,3,700000
2510, off herbert marcaulay way alagomeji yaba alagomeji yaba lagos,7,4,3,4,"Newly built and spacious 3bedroom flat all rooms ensuite, adequate electricity, security, located in a serene environment at Alagomeji, Yaba, Lagos.# 1.8m pa. Working class ... New. Parking Space. Street Lights. Security. Security Doors. All Room Ensuit. Pop Ceiling. Big Compound. Drainage System. ...",yaba,0,0,0,1,yaba4,1500000.0,2000000.0,1800000.0,1,34,6,1500000
2511, alagomeji alagomeji yaba lagos,7,4,3,4,"This is a lovely Newly Built 3 Bedroom Flat @ Alagomeji Yaba. It is well furnished with well made wardrobes and a nice kitchen cabinets with all the rooms ensuite with guest toilet, parking space, ... Serviced. Furnished. New. Parking Space. Security. Security Doors. All Room Ensuit. 24 Hours Security. Pop Ceiling. Big Compound. ...",yaba,1,1,1,1,yaba4,1500000.0,2000000.0,1800000.0,4,34,6,2000000
2512, old yaba road adekunle yaba lagos,3,2,1,2,"Newly Built Executive Miniflat @ Adekunle Yaba. Rent is 800k per annum and owner wants 2 years rent. It is fenced round with gate, underground parking space, borehole water, upstairs, 2 toilet and bathroom. It is located ... New. Parking Space. Security. Security Doors. All Room Ensuit. 24 Hours Security. Pop Ceiling. Big Compound. ...",yaba,1,0,0,1,yaba2,700000.0,850000.0,800000.0,2,17,3,800000
2513, - ebute metta yaba lagos,4,2,2,2,"2 bedroom flat @ Ebute metta east, 700k, a year rent, with car park. Agreement 125k Agency fee 125k Caution fee 50k. ... Parking Space. Supermarket Nearby. Security Doors. Drainage System. ...",yaba,0,0,0,1,yaba2,700000.0,850000.0,800000.0,1,17,3,700000
2514, behind yabatech yaba lagos,5,3,2,3,"A Lovely and well renovated 3bedroom apartment behind Yabatech, Yaba, Lagos, with 3toilets and 2bath, upstairs, just two in a compound fenced round with gate and parking space, situated in a cool and Calm environment, ... Renovated. New. Parking Space. Supermarket Nearby. Security. Security Doors. Big Compound. Drainage System. ...",yaba,0,0,0,1,yaba3,1000000.0,1500000.0,1300000.0,1,27,5,1200000
2515, adekunle yaba lagos,7,4,3,4,"Brand new 8 units of 3bedroom flats, all rooms ensuite with a visitors toilet.. Location: Adekunle Yaba Facility: 1) elevator 2) standby generator 3) Perimeter fencing 4) Fire extinguisher 5) Lawmer waste bin Service charge yet to be determined. Price: 1.8m ... Serviced. New. Children Play Ground. Parking Space. Street Lights. Supermarket Nearby. Security. Security Doors. All Room Ensuit. 24 Hours Security. Restaurants Nearby. Big Compound. Drainage System. ...",yaba,1,0,0,1,yaba4,1500000.0,2000000.0,1800000.0,2,34,6,1800000
2516, ... akoka yaba lagos,7,4,3,4,*just out* Just 2 remain Spacious 3 bedroom with car park and nice environment in Akoka. *Rent* 1.5m upstairs Downstairs 1.3m ... New. Parking Space. Security. Security Doors. All Room Ensuit. Pop Ceiling. Big Compound. Drainage System. ...,yaba,0,0,0,1,yaba4,1500000.0,2000000.0,1800000.0,1,34,6,1500000
2517, clegg yaba lagos,2,1,1,1,Just out Newly built mini flat at clegg close to yaba tejuosho fences with parking space for 400k two years rent a year and half can fly up stairs picture is available on request ... New. ...,yaba,0,0,0,0,yaba1,450000.0,600000.0,500000.0,0,8,2,400000
2518, .. adekunle yaba lagos,7,4,3,4,"Brand new & Executive 3bedroom flat all rooms ensuite with guest toilet, park upstairs & downstairs Available 2m p.a At Adekunle Yaba Lagos Available for sales too @35m per flat might be slightly negotiable ... New. Parking Space. Security. Security Doors. All Room Ensuit. Pop Ceiling. Big Compound. Drainage System. ...",yaba,1,1,1,1,yaba4,1500000.0,2000000.0,1800000.0,4,34,6,2000000
2519," off community road, akoka very close to bariga , akoka yaba lagos",6,3,3,3,"A decent 2 bedrooms flat all rooms ensuit, all round tiles, room has wardrobe, All modern finishing available, Spacious room and kitchen, ample parking space, in Decent area of Akoka, Close to Bariga, N550K ... Cheap. Renovated. Dry. Children Play Ground. Parking Space. Street Lights. Supermarket Nearby. Security. Security Doors. All Room Ensuit. 24 Hours Security. Fast Internet. Pop Ceiling. Big Compound. Drainage System. ...",yaba,0,0,0,0,yaba3,1000000.0,1500000.0,1300000.0,0,27,5,700000
2520, akoka yaba lagos,2,1,1,1,Tolet :miniflat @Akoka on tarred road in a quite &gated environment with 24hours security. 500k-1yrs. ... Serviced. Security. ...,yaba,1,0,0,1,yaba1,450000.0,600000.0,500000.0,2,8,2,500000
2521, onike akoka yaba lagos,2,1,1,1,"Brand new house, in Akoka yaba area , Mini flat #700k In the same building roomself #400k ... New. ...",yaba,0,0,0,0,yaba1,450000.0,600000.0,500000.0,0,8,2,400000
2522, onike akoka yaba lagos,2,1,1,1,"Brand new house, in Akoka yaba area , Mini flat #700k In the same building roomself #400k ... New. ...",yaba,1,1,1,1,yaba1,450000.0,600000.0,500000.0,4,8,2,600000
2523, akoka akoka yaba lagos,7,4,3,4,3bedroom at Akoka all room ensuit #850k 90% completed ... Furnished. Dry. New. All Room Ensuit. Big Compound. ...,yaba,0,0,0,0,yaba4,1500000.0,2000000.0,1800000.0,0,34,6,1000000
2524, fola agoro yaba lagos,5,3,2,3,3 bedroom Flat / Apartment for rent Fola Agoro Yaba Lagos ... New. Renovated. Security. Supermarket Nearby. 24 Hours Security. Street Lights. All Room Ensuit. Restaurants Nearby. Parking Space. Water Treatment. Security Doors. Pop Ceiling. ...,yaba,0,0,0,1,yaba3,1000000.0,1500000.0,1300000.0,1,27,5,1000000
2525, in a serene & gated estate sabo yaba lagos,4,2,2,2,"3 Bedroom Flat for rent in a very Serene & Gated Estate in Sabo, Yaba. It's a Block of 4 Flats. The available flat is Front Flat, groundfloor. Annual Rent: 850k 2 Years Rent Required by the ... ...",yaba,1,1,0,1,yaba2,700000.0,850000.0,800000.0,3,17,3,850000
2526, onike yaba lagos,7,4,3,4,"Newly built 3 bedroom flat in a estate at Onike, all rooms en-suite with a visitors toilet and 4 just in the compound for 1.3m a year rent ... New. ...",yaba,0,0,0,0,yaba4,1500000.0,2000000.0,1800000.0,0,34,6,1300000
2527, akoka yaba lagos,2,1,1,1,Neat and decent mini flat at Akoka for 500k a year rent ... ...,yaba,1,0,0,1,yaba1,450000.0,600000.0,500000.0,2,8,2,500000
2528," aderupoko street, iwaya iwaya yaba lagos",2,1,1,1,The house is fenced round with gate and it is in a good location. It's easily accessible to the highland. Owner prefer lady and working class. Contact us. ... Renovated. ...,yaba,0,0,0,0,yaba1,450000.0,600000.0,500000.0,0,8,2,300000
2529, sabo yaba lagos,8,4,4,4,"VERY TASTEFUL AND LOVELY 3BEDROOM APARTMENT WITH ULTRA MODERN FACILITIES USED,VERY ACCESSIBLE AND TIED ROAD NETWORK,IT HAS UNIT DEDICATED PREPAID METRE,IT IS SIMPLY ONE OF THE BEST APARTMENT AVAILABLE FOR NOW . For more information ... ...",yaba,0,0,0,1,yaba4,1500000.0,2000000.0,1800000.0,1,34,6,1600000
2530, yaba lagos,2,1,1,1,"Very clean, upstairs with wide balcony space, there's tiles all round + kitchen cabinet and a wardrobe space in the bedroom. .....One year rent only.... ... ...",yaba,0,0,0,0,yaba1,450000.0,600000.0,500000.0,0,8,2,350000
2531, akoka akoka yaba lagos,4,2,2,2,3 bedroom Flat / Apartment for rent Akoka Akoka Yaba Lagos ... Supermarket Nearby. Big Compound. 24 Hours Electricity. Restaurants Nearby. Street Lights. Security Doors. Security. 24 Hours Security. ...,yaba,0,0,0,0,yaba2,700000.0,850000.0,800000.0,0,17,3,650000
2532, akoka yaba akoka yaba lagos,6,3,3,3,Well finished and well maintained 3 bedroom flat in a serene and secured environment. Call today for your inspection as we are available. ... Parking Space. All Room Ensuit. Big Compound. Pop Ceiling. Street Lights. Drainage System. Security Doors. Security. 24 Hours Security. ...,yaba,0,0,0,1,yaba3,1000000.0,1500000.0,1300000.0,1,27,5,1200000
2533, abule ijesha yaba abule ijesha yaba lagos,6,3,3,3,Well maintained 3 bedroom flat in a secured environment ... Supermarket Nearby. Parking Space. Big Compound. Security Doors. Security. 24 Hours Security. ...,yaba,0,0,0,1,yaba3,1000000.0,1500000.0,1300000.0,1,27,5,1000000
2534, abule ijesha yaba abule ijesha yaba lagos,6,3,3,3,Nice 3 bedroom flat with a guest toilet in a secured neighborhood. Call today for inspection. ... Supermarket Nearby. Parking Space. Security Doors. ...,yaba,0,0,0,1,yaba3,1000000.0,1500000.0,1300000.0,1,27,5,1000000
2535, onike yaba onike yaba lagos,6,3,3,3,Well finished and well maintained 3 bedroom flat in a secured and serene environment with a gated compound. Call today for your inspection ... Supermarket Nearby. Big Compound. Drainage System. Security Doors. 24 Hours Security. ...,yaba,1,0,0,1,yaba3,1000000.0,1500000.0,1300000.0,2,27,5,1300000
2536, onike sabo yaba onike yaba lagos,6,3,3,3,"Well finished and well maintained 3 bedroom flat in a serene and secured environment, pop finishing, gated compound. Call today for your inspections. ... Supermarket Nearby. Parking Space. Big Compound. Pop Ceiling. Street Lights. Security Doors. Security. ...",yaba,1,0,0,1,yaba3,1000000.0,1500000.0,1300000.0,2,27,5,1300000
2537, onike sabo onike yaba lagos,6,3,3,3,"Well maintained 3 bedroom flat with in a serene and secured environment, gated compound, bore hole water. call today for inspection. ... Supermarket Nearby. Parking Space. Big Compound. Street Lights. Drainage System. Security Doors. 24 Hours Security. ...",yaba,1,0,0,1,yaba3,1000000.0,1500000.0,1300000.0,2,27,5,1300000
2538, yaba lagos,4,2,2,2,"A 6 nos of Newly built standard 2 bedroom Flat ,all ensuit toilet , fenced round with gate and parking space. Property Address : yaba, lagos. Price : N 2,000,000. Service charge :#200k Agency and legal fees 10% ... ...",yaba,1,1,1,1,yaba2,700000.0,850000.0,800000.0,4,17,3,1300000
2539, sabo yaba lagos,2,1,1,1,"A Nicely Built And Spacious Room Self Contain @ Sabo-Onike, Yaba, Lagos, with 1tkilet and bath, in a block of flats, fenced round with gate and parking space, #400k x a year n 2Months. Total ... ...",yaba,0,0,0,0,yaba1,450000.0,600000.0,500000.0,0,8,2,400000
2540, onike yaba lagos,2,1,1,1,1 bedroom mini flat Mini flat Flat / Apartment for rent Onike Yaba Lagos ... New. Parking Space. Restaurants Nearby. Supermarket Nearby. 24 Hours Security. Water Treatment. Pop Ceiling. Street Lights. Security. Security Doors. ...,yaba,1,0,0,1,yaba1,450000.0,600000.0,500000.0,2,8,2,500000
2541, onike yaba lagos,2,1,1,1,1 bedroom mini flat Mini flat Flat / Apartment for rent Onike Yaba Lagos ... New. Parking Space. Restaurants Nearby. Supermarket Nearby. 24 Hours Security. Water Treatment. Pop Ceiling. Street Lights. Security. Security Doors. ...,yaba,1,0,0,1,yaba1,450000.0,600000.0,500000.0,2,8,2,500000
2542, fola agoro yaba lagos,2,1,1,1,"A Brand Newly Built Mini flat at Shomolu, Lagos, with 1toilet and bath, in a block of flats, up n down flats are available, fenced round with gate and parking space, very close to Fola ... ...",yaba,0,0,0,1,yaba1,450000.0,600000.0,500000.0,1,8,2,450000
2543, akoka yaba lagos,3,2,1,2,"A Lovely fantastic and Extraordinary Spacious Mini flat @ Akoka, Yaba, Lagos, with 1toilet and bath, in a block of flats, with POP Ceiling, fitted kitchen cabinets n cupboard, fenced round with gate and parking ... ...",yaba,0,0,0,1,yaba2,700000.0,850000.0,800000.0,1,17,3,700000
2544, onike yaba lagos,2,1,1,1,"A very lovely newly built roomself@ onike yaba 500k annual rent In a block of flats Tiled interiorly with interlocking floor exteriorly In a serene environment With car park , wardrobes, kitchen cabinet, security and gated In a ... ...",yaba,1,0,0,1,yaba1,450000.0,600000.0,500000.0,2,8,2,500000
2545, onike yaba lagos,2,1,1,1,1 bedroom mini flat Self Contain Flat / Apartment for rent Onike Yaba Lagos ... New. Parking Space. Restaurants Nearby. Supermarket Nearby. 24 Hours Security. Printing Service. Water Treatment. Pop Ceiling. Street Lights. Security. Security Doors. ...,yaba,1,0,0,1,yaba1,450000.0,600000.0,500000.0,2,8,2,500000
2546, onike yaba lagos,2,1,1,1,1 bedroom mini flat Self Contain Flat / Apartment for rent Onike Yaba Lagos ... Serviced. New. Parking Space. Restaurants Nearby. Supermarket Nearby. All Room Ensuit. 24 Hours Electricity. 24 Hours Security. Printing Service. Water Treatment. Pop Ceiling. Street Lights. Security. Security Doors. ...,yaba,1,0,0,1,yaba1,450000.0,600000.0,500000.0,2,8,2,500000
2547, yaba alagomeji yaba lagos,2,1,1,1,Lovely Finished All Round Tiled Big and Spacious Wardrobe Kitchen Cabinet Interlocked Compound Ample Parking Space Easy Proximity Serene and Secured Location One Year Rent Accepted ... Renovated. Drainage System. Big Compound. Parking Space. All Room Ensuit. 24 Hours Security. Water Treatment. Street Lights. Security. Security Doors. ...,yaba,1,1,1,1,yaba1,450000.0,600000.0,500000.0,4,8,2,600000
2548, akoka yaba lagos,4,2,2,2,3 bedroom Flat / Apartment for rent Akoka Yaba Lagos ... Renovated. New. Security. Parking Space. 24 Hours Security. Supermarket Nearby. Security Doors. Water Treatment. Street Lights. Restaurants Nearby. ...,yaba,0,0,0,1,yaba2,700000.0,850000.0,800000.0,1,17,3,700000
2549, akoka yaba lagos,2,1,1,1,1 bedroom mini flat Mini flat Flat / Apartment for rent Akoka Yaba Lagos ... Renovated. New. Security. Parking Space. 24 Hours Security. Supermarket Nearby. Security Doors. Water Treatment. Street Lights. Restaurants Nearby. ...,yaba,1,0,0,1,yaba1,450000.0,600000.0,500000.0,2,8,2,500000
2550, abule nla ebute metta yaba lagos,5,3,2,3,"A lovely and nice well finished 2bedroom flat in costain with well fitted kitchen cabinet,well tiled,well fitted pop,well electrical fittings lighting,car park,balcony,running borehole water,gated compound,all rooms ensuit,spacious parlour,wardrobes in each rooms,prepaid meter and easy road ... Cheap. New. All Room Ensuit. 24 Hours Security. Security Doors. 24 Hours Electricity. Street Lights. Security. Big Compound. Pop Ceiling. ...",yaba,0,0,0,1,yaba3,1000000.0,1500000.0,1300000.0,1,27,5,1000000
2551, onike yaba lagos,4,2,2,2,A newly built 2 bedroom flat at onike yaba ... Renovated. New. Furnished. ...,yaba,1,1,0,1,yaba2,700000.0,850000.0,800000.0,3,17,3,850000
2552, sabo yaba lagos,9,5,4,5,4 bedroom Flat / Apartment for rent Sabo Yaba Lagos ... New. Renovated. Security. Water Treatment. 24 Hours Security. Printing Service. All Room Ensuit. Supermarket Nearby. Street Lights. Restaurants Nearby. Parking Space. Security Doors. Pop Ceiling. 24 Hours Electricity. ...,yaba,0,0,0,1,yaba5,3000000.0,3260000.0,3200000.0,1,43,8,3000000
2553, close to adekunle ebute metta yaba lagos,2,1,1,1,"Cleaner mini flat with tiles, wardrobe and kitchen cabinet,located in adekunle yaba, upstairs with wide balcony space 350k 1yr.... No car park ... ...",yaba,0,0,0,0,yaba1,450000.0,600000.0,500000.0,0,8,2,350000
2554, sabo sabo yaba lagos,9,5,4,5,Lovely ... Dry. Cheap. Renovated. Water Treatment. All Room Ensuit. Pop Ceiling. Parking Space. Big Compound. Drainage System. 24 Hours Security. Restaurants Nearby. Supermarket Nearby. Street Lights. Security. Security Doors. ...,yaba,1,1,0,1,yaba5,3000000.0,3260000.0,3200000.0,3,43,8,3500000
2555, yaba lagos,2,1,1,1,A decent self contain available for rent in YABA The house is located in a clean and secured environment. Its also very close to the main road. ... ...,yaba,0,0,0,0,yaba1,450000.0,600000.0,500000.0,0,8,2,300000
2556, fola agoro fola agoro yaba lagos,7,4,3,4,"Nice and massive 3bedroom Bedroom flat with all Rooms En-suite + Guest Convenient. POP, massive wardrobes, Water heater, Borehole Water, Lovely Balconyâ€™s/ View. Just 3 Occupants to share Compound. Up floor available. ... New. Security. All Room Ensuit. Big Compound. Supermarket Nearby. Restaurants Nearby. Security Doors. Parking Space. Pop Ceiling. 24 Hours Security. Drainage System. Street Lights. ...",yaba,1,0,0,1,yaba4,1500000.0,2000000.0,1800000.0,2,34,6,1800000
2557, akoka yaba lagos,2,1,1,1,1 bedroom mini flat Mini flat Flat / Apartment for rent Akoka Yaba Lagos ... New. Security. Supermarket Nearby. Restaurants Nearby. Security Doors. Parking Space. Street Lights. ...,yaba,1,1,1,1,yaba1,450000.0,600000.0,500000.0,4,8,2,600000
2558, fola agoro yaba lagos,4,2,2,2,"Itâ€™s a newly built apartment of more than 10 Units of Miniflat. (Standard Room,Parlor Toilet and Kitchen) It is 98% completed. Accessible to the road we are selling to does who desire to invest in real estate but ... New. Security. Big Compound. Parking Space. 24 Hours Electricity. 24 Hours Security. Street Lights. ...",yaba,1,1,1,1,yaba2,700000.0,850000.0,800000.0,4,17,3,1300000
2559, .. akoka yaba lagos,7,4,3,4,Just 2 remain Spacious 3 bedroom @ Akoka 1.5 upstairs Downstairs 1.3 Very lovely ... New. Security. All Room Ensuit. Supermarket Nearby. Restaurants Nearby. Security Doors. Parking Space. Pop Ceiling. 24 Hours Security. Street Lights. ...,yaba,0,0,0,1,yaba4,1500000.0,2000000.0,1800000.0,1,34,6,1500000
2560, akoka yaba lagos,2,1,1,1,Newly built mini flat fence round with gate security with carb park ... Security. All Room Ensuit. Big Compound. Supermarket Nearby. Restaurants Nearby. Security Doors. Parking Space. 24 Hours Security. Street Lights. ...,yaba,1,0,0,1,yaba1,450000.0,600000.0,500000.0,2,8,2,500000
2561, onike yaba lagos,2,1,1,1,Executive Female Hostel for rent pay and parking hostel fully furnished and serviced for students and Working Class Very Affordable Hostel One year rent accepted constant water and power supply good road network very accessible to the road 24hrs security 450k per annum contact backup property ... Serviced. New. Furnished. Security. Big Compound. Security Doors. Parking Space. 24 Hours Electricity. Pop Ceiling. 24 Hours Security. ...,yaba,0,0,0,1,yaba1,450000.0,600000.0,500000.0,1,8,2,450000
2562, iwaya yaba lagos,6,3,3,3,Renovated 3 bedroom flat at iwaya for 700k a year rent in a good environment and parking space. Up flat ... Cheap. Renovated. Parking Space. ...,yaba,0,0,0,0,yaba3,1000000.0,1500000.0,1300000.0,0,27,5,700000
2563, ebute metta yaba lagos,4,2,2,2,A very clean 3bedroom in a block of flats Tiled and in a decent environment Easily accessible to the island With car park Kitchen cabinet Wardrobes 800k rent 160k legal 160k agency 50k caution ... ...,yaba,1,0,0,1,yaba2,700000.0,850000.0,800000.0,2,17,3,800000
2564, fola agoro yaba lagos,2,1,1,1,"Itâ€™s a newly built apartment of more than 10 Units of roomself contain. (Standard Room, Toilet and Kitchen) It is 20% completed. Accessible to the road we are selling to does who desire to invest in real estate ... New. Security. Big Compound. Security Doors. 24 Hours Electricity. Pop Ceiling. 24 Hours Security. ...",yaba,1,1,1,1,yaba1,450000.0,600000.0,500000.0,4,8,2,600000
2565, off fola-agoro yaba lagos yaba lagos,2,1,1,1,1 bedroom mini flat House for rent Off fola-agoro yaba Lagos Yaba Lagos ... New. Security. Big Compound. Supermarket Nearby. Restaurants Nearby. Security Doors. 24 Hours Electricity. Pop Ceiling. 24 Hours Security. Street Lights. ...,yaba,0,0,0,1,yaba1,450000.0,600000.0,500000.0,1,8,2,450000
2566, close to pako bus stop akoka yaba lagos,7,4,3,4,"Newly built all rooms en-suite 3 bedroom flat , 5 tenant in the compound, pop finished , fitted with wardrobe and kitchen cabinet, properly gated and has car park space, located close to pako bus ... New. Security. All Room Ensuit. Big Compound. Supermarket Nearby. Restaurants Nearby. Security Doors. Parking Space. Pop Ceiling. 24 Hours Security. Drainage System. Street Lights. ...",yaba,0,0,0,1,yaba4,1500000.0,2000000.0,1800000.0,1,34,6,1500000
2567, morrocco axis jibowu yaba lagos,6,3,3,3,A very clean relatively new 3bedroom all rooms ensuite with guest toilet 1mill Easily accessible to Herbert Macaulay way Close to yabatech and waec The flat is upstairs In a gated and fenced serene environment ... ...,yaba,0,0,0,1,yaba3,1000000.0,1500000.0,1300000.0,1,27,5,1000000
2568, onike onike yaba lagos,2,1,1,1,1 bedroom mini flat House for rent Onike Onike Yaba Lagos ... Security. Supermarket Nearby. Restaurants Nearby. Security Doors. 24 Hours Electricity. 24 Hours Security. Street Lights. ...,yaba,0,0,0,0,yaba1,450000.0,600000.0,500000.0,0,8,2,400000
2569, sabo yaba lagos,5,3,2,3," Newly built and spacious 2bedroom flat all rooms ensuite, adequate electricity, security, located in a serene environment at Sabo Yaba, Lagos.# 1.5m pa. Working class Rent #1. 5m Legal 10 % Agency 20% Caution 10 % Service charge not ... ...",yaba,1,1,1,1,yaba3,1000000.0,1500000.0,1300000.0,4,27,5,1500000
2570, a very clean 2br apartment at akoka extension 2t2b good packing space 550k akoka yaba lagos,4,2,2,2,A very clean 2br apartment at AKOKA extension 2t2b good packing space 550k ... Furnished. Old. Dry. Big Compound. Water Treatment. ...,yaba,0,0,0,0,yaba2,700000.0,850000.0,800000.0,0,17,3,550000
2571, tejuosho yaba lagos,4,2,2,2,1 bedroom mini flat Mini flat Flat / Apartment for rent Tejuosho Yaba Lagos ... New. Renovated. Security. All Room Ensuit. Supermarket Nearby. Restaurants Nearby. Security Doors. Parking Space. 24 Hours Security. Street Lights. Water Treatment. ...,yaba,0,0,0,0,yaba2,700000.0,850000.0,800000.0,0,17,3,500000
2572, chemist akoka yaba lagos,2,1,1,1,Newly Built Roomself contain at Akoka Pay and parking apartment Good road network Constant water and power supply pop and Screeded wall One and half year required Accessibility to the island Spacious parking space Water Heater in the toilet Secured environment. ... New. Security. Big Compound. Security Doors. 24 Hours Electricity. Pop Ceiling. 24 Hours Security. Street Lights. ...,yaba,0,0,0,0,yaba1,450000.0,600000.0,500000.0,0,8,2,350000
2573, awofala street akoka yaba lagos,6,3,3,3,Renovated 3Bedroom for rent at Akoko Pay and parking apartment Good Road network Spacious Rooms Constant Power and Water Supply Secured Environment. ... Renovated. Big Compound. Security Doors. 24 Hours Electricity. Pop Ceiling. 24 Hours Security. Street Lights. ...,yaba,0,0,0,0,yaba3,1000000.0,1500000.0,1300000.0,0,27,5,700000
2574, off bornu way adekunle yaba lagos,6,3,3,3,Be a Landlord in the heartbeat of Lagos! Backup Property Consult offers affordable long lease apartments for people who desire to be landlords but donâ€™t have the funds to buy land and build houses. Our ... New. Security. All Room Ensuit. 24 Hours Electricity. 24 Hours Security. Street Lights. ...,yaba,1,1,1,1,yaba3,1000000.0,1500000.0,1300000.0,4,27,5,1800000
2575, close to pako bus stop akoka yaba lagos,2,1,1,1,"Decent and spacious executive mini flat Spacious room, toilet and kitchen, pop finished gated with car park space. ... Renovated. Security. All Room Ensuit. Big Compound. Supermarket Nearby. Restaurants Nearby. Security Doors. Parking Space. Pop Ceiling. 24 Hours Security. Drainage System. Street Lights. ...",yaba,0,0,0,0,yaba1,450000.0,600000.0,500000.0,0,8,2,400000
2576, off fola-agoro yaba lagos yaba lagos,2,1,1,1,1 bedroom mini flat House for rent Off fola-agoro yaba Lagos Yaba Lagos ... New. Security. Big Compound. Supermarket Nearby. Restaurants Nearby. Security Doors. 24 Hours Electricity. Pop Ceiling. 24 Hours Security. Street Lights. ...,yaba,0,0,0,1,yaba1,450000.0,600000.0,500000.0,1,8,2,450000
2577, fola agoro yaba lagos,2,1,1,1,1 bedroom mini flat Self Contain Flat / Apartment for rent Fola Agoro Yaba Lagos ... New. All Room Ensuit. Big Compound. Supermarket Nearby. Security Doors. Parking Space. 24 Hours Security. ...,yaba,0,0,0,0,yaba1,450000.0,600000.0,500000.0,0,8,2,300000
2578, - ebute metta yaba lagos,4,2,2,2,"2 bedroom flat @ ebute metta east. Rent 600k, a year rent. Agency fee 100k; Agreement 100k Caution fee 50k. Just 2 in compound. ... ...",yaba,0,0,0,0,yaba2,700000.0,850000.0,800000.0,0,17,3,600000
2579, alagomeji yaba lagos,6,3,3,3,"Newly built block of 3-bedroom apartments in a cool neighbourhood, with parking lot, compound and neighbourhood security and other specialties. ... Serviced. New. Cheap. Mosques Nearby. Security. All Room Ensuit. Big Compound. Restaurants Nearby. Parking Space. 24 Hours Security. Street Lights. Church Nearby. ...",yaba,1,1,1,1,yaba3,1000000.0,1500000.0,1300000.0,4,27,5,1800000
2580, .. onike yaba lagos,2,1,1,1,"Massively big and clean room self contain in a decent environment at onike Rent 400k per annum, 1yr and 3months Rent needed , total package 650k. ... Security. All Room Ensuit. Big Compound. Supermarket Nearby. Restaurants Nearby. Security Doors. 24 Hours Electricity. Drainage System. Street Lights. Printing Service. ...",yaba,0,0,0,0,yaba1,450000.0,600000.0,500000.0,0,8,2,400000
2581," ebute meta west,. lagos state ebute metta yaba lagos",6,3,3,3,"2 bedroom flat all room ensuite, @ ebute metta west, ground floor 900k, 1st floor and 2nd floor 1m each, a year rent. Features POP Fittings Kitchen cabinet Car park Wall screeding. Visitors toilet. ... ...",yaba,0,0,0,0,yaba3,1000000.0,1500000.0,1300000.0,0,27,5,900000
2582, akoka akoka yaba lagos,7,4,3,4,3 bedroom Flat / Apartment for rent Akoka Akoka Yaba Lagos ... Security. All Room Ensuit. Big Compound. Supermarket Nearby. Restaurants Nearby. Security Doors. 24 Hours Electricity. 24 Hours Security. Street Lights. ...,yaba,0,0,0,0,yaba4,1500000.0,2000000.0,1800000.0,0,34,6,1000000
2583, akoka yaba lagos,5,3,2,3,3 bedroom Flat / Apartment for rent Akoka Yaba Lagos ... New. Renovated. Security. Supermarket Nearby. Restaurants Nearby. Security Doors. Parking Space. 24 Hours Security. Street Lights. ...,yaba,0,0,0,0,yaba3,1000000.0,1500000.0,1300000.0,0,27,5,800000
2584, close to pako bus stop akoka yaba lagos,7,4,3,4," Newly built all rooms en-suite Spacious 3 bedroom flat , with guest Toilet, pop finished, fitted with wardrobe and kitchen cabinet, just 5 tenant in a compound, gated with car park space *Rent* 1.5m upstairs ... New. Security. All Room Ensuit. Big Compound. Supermarket Nearby. Restaurants Nearby. Security Doors. Parking Space. Pop Ceiling. 24 Hours Security. Drainage System. Street Lights. ...",yaba,0,0,0,1,yaba4,1500000.0,2000000.0,1800000.0,1,34,6,1500000
2585," ebute metta east, ebute metta yaba lagos",2,1,1,1,"A Brand newly built Room Self Contain @ Ebute Metta East, Yaba, Lagos, with 1toilet and bath, in a block of flats, fenced round with gate, #200k x 2years. ... ...",yaba,0,0,0,0,yaba1,450000.0,600000.0,500000.0,0,8,2,300000
2586, alagomeji yaba lagos,8,4,4,4,*Just out* 4 bedroom duplex available for rent with a spacious compound and parking space available in akinwumi Alagomeji yaba. *Rent* 2m . ... ...,yaba,1,1,1,1,yaba4,1500000.0,2000000.0,1800000.0,4,34,6,2000000
2587, close to adekunle ebute metta yaba lagos,6,3,3,3,"Still available!!! An executive 3bedroom flats with all rooms ensuite, upstairs just 3 tenants 1minute drive to connect third mainland, ebute meta east side of Yaba, 1.3m per annum strictly corporate tenant Legal 130,000 Agency 260,000 Caution 100000 ... ...",yaba,1,0,0,1,yaba3,1000000.0,1500000.0,1300000.0,2,27,5,1300000
2588, ebute metta yaba lagos,4,2,2,2,"Lovely 3 Bedroom Flat for rent at Ebute Metta Annual Rent: N 500,000 Legal Fee N 60,000 Agency Commission N 60,000 ... ...",yaba,0,0,0,0,yaba2,700000.0,850000.0,800000.0,0,17,3,500000
2589, abule oja yaba lagos,2,1,1,1,1 bedroom mini flat Self Contain Flat / Apartment for rent Abule-Oja Yaba Lagos ... Security. All Room Ensuit. Supermarket Nearby. Restaurants Nearby. Security Doors. Parking Space. 24 Hours Security. Drainage System. Street Lights. Church Nearby. ...,yaba,0,0,0,0,yaba1,450000.0,600000.0,500000.0,0,8,2,380000
2590, moore road sabo yaba lagos,2,1,1,1,"Video available on request. Agreement is 100 Agency is 100 Please call: 08124188878, 07051453240 or Whatsapp 07038116252 ... Cheap. Dry. Security. Parking Space. ...",yaba,0,0,0,0,yaba1,450000.0,600000.0,500000.0,0,8,2,400000
2591, isaac john jibowu yaba lagos,6,3,3,3,Executive 2bedroom at isaacjohn yaba Pay and parking apartment Good road network Constant water and power supply Prepaid meter available Accessibility to the island Spacious parking space All room en-suite Secured environment. ... New. Security. All Room Ensuit. Big Compound. Security Doors. Parking Space. 24 Hours Electricity. Pop Ceiling. 24 Hours Security. ...,yaba,0,0,0,1,yaba3,1000000.0,1500000.0,1300000.0,1,27,5,1250000
2592, davies abule oja yaba lagos,2,1,1,1,1 bedroom mini flat Mini flat Flat / Apartment for rent Davies Abule-Oja Yaba Lagos ... Security. All Room Ensuit. Supermarket Nearby. Restaurants Nearby. Security Doors. 24 Hours Security. Drainage System. Street Lights. ...,yaba,1,0,1,1,yaba1,450000.0,600000.0,500000.0,3,8,2,550000
2593, close to pako bus stop akoka yaba lagos,2,1,1,1,"Decent and spacious executive room self contain Spacious room, toilet and kitchen, pop finished gated with car park space. ... Renovated. Security. All Room Ensuit. Big Compound. Supermarket Nearby. Restaurants Nearby. Security Doors. Parking Space. Pop Ceiling. 24 Hours Security. Drainage System. Street Lights. ...",yaba,0,0,0,0,yaba1,450000.0,600000.0,500000.0,0,8,2,400000
2594, akoka yaba lagos,7,4,3,4,3 bedroom Flat / Apartment for rent Akoka Yaba Lagos ... Security. All Room Ensuit. Big Compound. Supermarket Nearby. Restaurants Nearby. Security Doors. Parking Space. Pop Ceiling. 24 Hours Security. ...,yaba,0,0,0,0,yaba4,1500000.0,2000000.0,1800000.0,0,34,6,1200000
2595, alagomeji alagomeji yaba lagos,7,4,3,4,"Tastefully finished and newly built spacious 3 bedroom flat with all the rooms ensuite and also a fitted kitchen. Pop finishings. Adequate parking space, cool and serene environment. Call today for your inspections as limited ... New. Dry. Security. All Room Ensuit. Big Compound. Supermarket Nearby. Restaurants Nearby. Security Doors. Parking Space. Pop Ceiling. 24 Hours Security. Street Lights. ...",yaba,1,1,1,1,yaba4,1500000.0,2000000.0,1800000.0,4,34,6,2000000
2596, abule ijesha yaba lagos,2,1,1,1,1 bedroom mini flat Mini flat Flat / Apartment for rent Abule-Ijesha Yaba Lagos.. Pls note- A year six month rent required ... New. Security. All Room Ensuit. Big Compound. Supermarket Nearby. Restaurants Nearby. Security Doors. Parking Space. 24 Hours Security. ...,yaba,0,0,0,0,yaba1,450000.0,600000.0,500000.0,0,8,2,400000
2597, onike yaba lagos,2,1,1,1,1 bedroom mini flat Mini flat Flat / Apartment for rent Onike Yaba Lagos ... Security. All Room Ensuit. Big Compound. Supermarket Nearby. Restaurants Nearby. Security Doors. Parking Space. 24 Hours Security. Drainage System. Street Lights. ...,yaba,0,0,0,1,yaba1,450000.0,600000.0,500000.0,1,8,2,450000
2598, moore road sabo yaba lagos,2,1,1,1,A very clean miniflat 400k at sabo Moore road axis Easily accessible to Domino pizza Herbert Macaulay way In a gated and fenced compound with car park In a serene environment Kitchen cabinet Legal 100k Agency 100k Caution 50k ... ...,yaba,0,0,0,0,yaba1,450000.0,600000.0,500000.0,0,8,2,400000
2599, off akoka akoka yaba lagos,2,1,1,1,Executive hostel for rent at off akoka pay and parking hostel fully furnished and serviced for students constant water and power supply good road network very accessible to the road 24hrs security 450k for single room 300k for double room contact backup property consult today ... Furnished. ...,yaba,0,0,0,0,yaba1,450000.0,600000.0,500000.0,0,8,2,300000
2600, abudu abule oja yaba lagos,2,1,1,1,Newly built roomself contain at abule oja pay and parking apartment Good road network constant water and power supply Very spacious room Well Finished Room Partly Furnished Apartment Wardrobe and kitchen cabinet in the apartment One year rent Accepted Suitable for working class and ... New. Furnished. 24 Hours Electricity. 24 Hours Security. ...,yaba,0,0,0,0,yaba1,450000.0,600000.0,500000.0,0,8,2,400000
2601, off akoka akoka yaba lagos,2,1,1,1,Executive Hostel for Rent at Off Akoka Pay and parking hostel Fully Furnished and Serviced For Students Constant water and Power Supply Good Road Network Very Accessible to the Road 24hrs Security 450k for single room 300k for double room Contact Backup Property Consult today ... Furnished. ...,yaba,0,0,0,0,yaba1,450000.0,600000.0,500000.0,0,8,2,300000
2602, .. sabo yaba lagos,7,4,3,4,3 bedroom Flat / Apartment for rent Sabo Yaba Lagos ... New. Renovated. Security. Supermarket Nearby. Restaurants Nearby. Security Doors. Parking Space. Pop Ceiling. Street Lights. ...,yaba,0,0,0,0,yaba4,1500000.0,2000000.0,1800000.0,0,34,6,1000000
2603, zanzi street onike yaba lagos,2,1,1,1,Executive Unisex Hostel for rent pay and parking hostel fully furnished and serviced for students and Working Class Very Affordable Hostel 6Months rent accepted constant water and power supply good road network very accessible to the road 24hrs security 200k for double room 170k for 4man ... New. Furnished. Security. Big Compound. Security Doors. Parking Space. Pop Ceiling. 24 Hours Security. Street Lights. ...,yaba,0,0,0,0,yaba1,450000.0,600000.0,500000.0,0,8,2,300000
2604, fola agoro yaba fola agoro yaba lagos,5,3,2,3,"Well renovated, well finished 2 bedroom flat with all the rooms ensuite and a guest toilet. Serene and secured neighborhood. Call today as it just limited space that is available. You can also reach us ... Renovated. Dry. Security. All Room Ensuit. Big Compound. Supermarket Nearby. Security Doors. Parking Space. Pop Ceiling. 24 Hours Security. Street Lights. ...",yaba,0,0,0,0,yaba3,1000000.0,1500000.0,1300000.0,0,27,5,900000
2605, - fola agoro yaba lagos,6,3,3,3,2 bedroom Flat / Apartment for rent Fola Agoro Yaba Lagos ... Security. All Room Ensuit. Supermarket Nearby. Restaurants Nearby. Security Doors. Parking Space. Pop Ceiling. 24 Hours Security. ...,yaba,0,0,0,1,yaba3,1000000.0,1500000.0,1300000.0,1,27,5,1000000
2606, jibowu yaba lagos,3,1,2,1,A very clean and decent 2bedroom in a very serene environment Ground floor With car park Kitchen cabinet Easily accessible to the island Borehole ... ...,yaba,1,1,1,1,yaba1,450000.0,600000.0,500000.0,4,8,2,600000
2607, akoka yaba lagos,2,1,1,1,2 bedroom Mini flat Flat / Apartment for rent Akoka Yaba Lagos ... New. Renovated. Security. All Room Ensuit. Cctv Cameras. Supermarket Nearby. Restaurants Nearby. Security Doors. Parking Space. Pop Ceiling. 24 Hours Security. Street Lights. Printing Service. Water Treatment. ...,yaba,1,1,1,1,yaba1,450000.0,600000.0,500000.0,4,8,2,600000
2608, yaba lagos,2,1,1,1,A room self-contain. A well-appointed apartment carefully built in a conducive and habitable environment ... ...,yaba,0,0,0,0,yaba1,450000.0,600000.0,500000.0,0,8,2,300000
2609, alara street onike yaba lagos,2,1,1,1,"Itâ€™s a newly built apartment of more than 10 Units of roomself contain. (Standard Room, Toilet and Kitchen) It is completed. Accessible to the road we are selling to does who desire to invest in real estate ... New. Security. Big Compound. Security Doors. 24 Hours Electricity. 24 Hours Security. Street Lights. ...",yaba,1,1,1,1,yaba1,450000.0,600000.0,500000.0,4,8,2,600000
2610, yaba lagos,6,3,3,3,A newly renovated 3bedroom flat with a BQ Location: yaba Rent: #4.5m Service charge: self service Power deposit: self service Caution: Agency and legal 5% each ... ...,yaba,1,1,1,1,yaba3,1000000.0,1500000.0,1300000.0,4,27,5,1800000
2611, onike yaba lagos,2,1,1,1,"Located close to onike round about,gated with car park space ... Dry. Security. All Room Ensuit. Big Compound. Supermarket Nearby. Security Doors. Parking Space. 24 Hours Security. Drainage System. Street Lights. ...",yaba,0,0,0,1,yaba1,450000.0,600000.0,500000.0,1,8,2,450000
2612, akoka yaba lagos,7,4,3,4,3 bedroom Flat / Apartment for rent Akoka Yaba Lagos ... New. Renovated. Security. All Room Ensuit. Supermarket Nearby. Restaurants Nearby. Security Doors. Parking Space. Pop Ceiling. 24 Hours Security. Street Lights. Water Treatment. ...,yaba,0,0,0,0,yaba4,1500000.0,2000000.0,1800000.0,0,34,6,1200000
2613, - onike yaba lagos,2,1,1,1,"Massively big and clean room self contain in a decent environment at onike Rent 400k per annum, 1yr and 3months Rent needed , total package 650k. ... Security. All Room Ensuit. Big Compound. Supermarket Nearby. Restaurants Nearby. Security Doors. Parking Space. 24 Hours Security. Street Lights. ...",yaba,0,0,0,0,yaba1,450000.0,600000.0,500000.0,0,8,2,400000
2614, yaba lagos,6,3,3,3,fully renovated two units of 3 bedroom flat on a large compound at yaba for 1.3 rent ... ...,yaba,1,0,0,1,yaba3,1000000.0,1500000.0,1300000.0,2,27,5,1300000
2615, moroko yaba lagos,2,1,1,1,1 bedroom mini flat House for rent Moroko Yaba Lagos ... New. Security. Big Compound. Supermarket Nearby. Restaurants Nearby. Security Doors. 24 Hours Electricity. 24 Hours Security. Street Lights. ...,yaba,0,0,0,0,yaba1,450000.0,600000.0,500000.0,0,8,2,350000
2616, yaba lagos,6,3,3,3,"Newly built and spacious 3bedroom flat 3t/2b,master ensuite, adequate electricity, security, located in a serene environment at Alagomeji, Yaba, Lagos.# 1.5m pa.SC: 300kpa Working class ... ...",yaba,1,1,1,1,yaba3,1000000.0,1500000.0,1300000.0,4,27,5,1500000
2617, fola agoro yaba lagos,2,1,1,1,Become a Landlord with Ease in highbrow areas on Lagos mainland by Investing in our long lease residential property project. Invest 1.5 Million Naira and you can become a landlord of a Studio Apartment for 15 ... New. Security. All Room Ensuit. Big Compound. Supermarket Nearby. Restaurants Nearby. Security Doors. Parking Space. 24 Hours Security. Drainage System. Street Lights. ...,yaba,1,1,1,1,yaba1,450000.0,600000.0,500000.0,4,8,2,600000
2618, onike yaba lagos,2,1,1,1,1 bedroom mini flat Mini flat Flat / Apartment for rent Onike Yaba Lagos ... New. Renovated. Security. Supermarket Nearby. Restaurants Nearby. Security Doors. Parking Space. 24 Hours Security. ...,yaba,0,0,0,1,yaba1,450000.0,600000.0,500000.0,1,8,2,450000
2619, ojuelegba axis tejuosho yaba lagos,2,1,1,1,A very clean miniflat @ yaba 400k a year and half rent required With car park Tiled easily accessible to the island in a good environment 400k annual rent 200k (half) 90k agency 90k legal 30k caution ... ...,yaba,0,0,0,0,yaba1,450000.0,600000.0,500000.0,0,8,2,400000
2620, .. fola agoro yaba lagos,6,3,3,3,"FOR SALE A Residential Block of flat on four floor comprising of 8nos of 3bedroom flat with 2nos of 2bedroom boys quarters on two floors and a gated house at Fola Agoro, yaba. Price :- 100Million Naira ... Security. All Room Ensuit. Big Compound. Supermarket Nearby. Restaurants Nearby. Security Doors. Parking Space. 24 Hours Security. Drainage System. Street Lights. ...",yaba,1,1,1,1,yaba3,1000000.0,1500000.0,1300000.0,4,27,5,1800000
2621, onike onike yaba lagos,3,1,2,1,1 bedroom mini flat Mini flat Flat / Apartment for rent Onike Onike Yaba Lagos ... Security. Supermarket Nearby. Restaurants Nearby. Security Doors. 24 Hours Electricity. 24 Hours Security. Street Lights. ...,yaba,1,1,1,1,yaba1,450000.0,600000.0,500000.0,4,8,2,600000
2622, akoka yaba lagos,4,2,2,2,"3bedroom ensuite with extra toilet and a visitor's toilet upstairs with a car space @ chemist, Akoka. #800k only. 1yr Easily accessible to the island In a gated and serene environment With car park Prepaid meter Upstairs ... ...",yaba,1,0,0,1,yaba2,700000.0,850000.0,800000.0,2,17,3,800000
2623, akoka /bariga area akoka yaba lagos,5,3,2,3,2 bedroom Flat / Apartment for rent Akoka /bariga area Akoka Yaba Lagos ... New. Renovated. Security. Supermarket Nearby. Restaurants Nearby. Security Doors. Parking Space. Pop Ceiling. 24 Hours Security. Street Lights. Water Treatment. ...,yaba,0,0,0,0,yaba3,1000000.0,1500000.0,1300000.0,0,27,5,700000
2624, close to pako bus stop akoka yaba lagos,2,1,1,1,"Pop finished , executive finishing , gated with car park space Room self contain available in same compound going for 400k per year ... Renovated. Security. All Room Ensuit. Big Compound. Supermarket Nearby. Restaurants Nearby. Parking Space. Pop Ceiling. 24 Hours Security. Drainage System. Street Lights. ...",yaba,1,1,1,1,yaba1,450000.0,600000.0,500000.0,4,8,2,600000
2625, fola agoro yaba lagos,4,2,2,2,3 bedroom Flat / Apartment for rent Fola Agoro Yaba Lagos ... New. Renovated. Security. Supermarket Nearby. Restaurants Nearby. Security Doors. Parking Space. 24 Hours Security. Street Lights. Water Treatment. ...,yaba,1,0,0,1,yaba2,700000.0,850000.0,800000.0,2,17,3,800000
2626, off akoka akoka yaba lagos,6,3,3,3,Splendid 2bedroom at Ilaje Pay and parking apartment Good road network Constant water and power supply Prepaid meter available Accessibility to the island Spacious parking space All room en-suite Secured environment. ... Security. All Room Ensuit. Security Doors. Parking Space. 24 Hours Electricity. 24 Hours Security. ...,yaba,0,0,0,0,yaba3,1000000.0,1500000.0,1300000.0,0,27,5,700000
2627, - iwaya yaba lagos,6,3,3,3,3 bedroom Flat / Apartment for rent Iwaya Yaba Lagos ... New. Renovated. Security. Supermarket Nearby. Restaurants Nearby. Security Doors. Parking Space. Street Lights. ...,yaba,0,0,0,0,yaba3,1000000.0,1500000.0,1300000.0,0,27,5,800000
2628, jibowu yaba lagos,4,2,2,2,5 bedroom Office Space Commercial Property for rent Jibowu Yaba Lagos ... Renovated. Security. Big Compound. Security Doors. Parking Space. Pop Ceiling. 24 Hours Security. Street Lights. ...,yaba,1,1,1,1,yaba2,700000.0,850000.0,800000.0,4,17,3,1300000
2629, harbert macaulay by jebba yaba lagos,2,1,1,1,1 bedroom mini flat Mini flat Flat / Apartment for rent Harbert Macaulay by jebba Yaba Lagos ... Security. Big Compound. Supermarket Nearby. Restaurants Nearby. Security Doors. Parking Space. 24 Hours Electricity. 24 Hours Security. Street Lights. ...,yaba,0,0,0,0,yaba1,450000.0,600000.0,500000.0,0,8,2,350000
2630, ebutte metta ebute metta yaba lagos,4,2,2,2,"2 bedroom @ ebute metta west, all rooms ensuite, with kitchen cabinet and car park. Rent 1m/1.2 respectively Agency fee 200k Agreement 100k Caution fee 100k ... ...",yaba,1,1,1,1,yaba2,700000.0,850000.0,800000.0,4,17,3,1000000
2631, akoka yaba lagos,6,3,3,3,Brand new 3 bedroom Obadiah off community road Akoka 1m yearly Agreement 10% Commission 20% Caution 50 Total #1350.000 Wardrobes in all rooms Painted Pop ceiling Kitchen cabinet All tiled with guest toilet ... ...,yaba,0,0,0,1,yaba3,1000000.0,1500000.0,1300000.0,1,27,5,1000000
2632, yaba ebute east side. ebute metta yaba lagos,7,4,3,4,"An executive 3bedroom flats with all rooms ensuite, upstairs just 3 tenants 1minute drive to connect third mainland, ebute meta east side of Yaba, 1.3m per annum strictly corporate tenant. (Agt Abass). ... Security. All Room Ensuit. Big Compound. Security Doors. 24 Hours Electricity. 24 Hours Security. Water Treatment. ...",yaba,0,0,0,0,yaba4,1500000.0,2000000.0,1800000.0,0,34,6,1300000
2633, akoka akoka yaba lagos,2,1,1,1,1 bedroom mini flat Mini flat Flat / Apartment for rent Akoka Akoka Yaba Lagos ... New. Security. Supermarket Nearby. Restaurants Nearby. Security Doors. 24 Hours Electricity. 24 Hours Security. Street Lights. ...,yaba,1,0,0,1,yaba1,450000.0,600000.0,500000.0,2,8,2,500000
2634, close to pako bus stop akoka yaba lagos,2,1,1,1,1 bedroom mini flat Mini flat Flat / Apartment for rent Close to pako bus stop Akoka Yaba Lagos ... Renovated. Security. All Room Ensuit. Big Compound. Supermarket Nearby. Restaurants Nearby. Security Doors. Parking Space. Pop Ceiling. 24 Hours Security. Drainage System. Street Lights. ...,yaba,1,1,1,1,yaba1,450000.0,600000.0,500000.0,4,8,2,600000
2635, onike yaba lagos,2,1,1,1,"Located close to onike round about,gated with car park space ... Security. All Room Ensuit. Big Compound. Supermarket Nearby. Security Doors. 24 Hours Security. Drainage System. Street Lights. ...",yaba,0,0,0,1,yaba1,450000.0,600000.0,500000.0,1,8,2,450000
2636, alagomeji yaba lagos,7,4,3,4,"Newly built all rooms en-suite 3 Bedroom Flat, pop finished , gated with car park space ... New. Security. All Room Ensuit. Big Compound. Supermarket Nearby. Restaurants Nearby. Security Doors. Parking Space. Pop Ceiling. 24 Hours Security. Drainage System. Street Lights. ...",yaba,0,0,0,1,yaba4,1500000.0,2000000.0,1800000.0,1,34,6,1500000
2637, .. ebute metta yaba lagos,5,3,2,3,2 bedroom Flat / Apartment for rent Ebute Metta Yaba Lagos ... New. Renovated. Security. Supermarket Nearby. Restaurants Nearby. Security Doors. Parking Space. Pop Ceiling. Street Lights. ...,yaba,0,0,0,0,yaba3,1000000.0,1500000.0,1300000.0,0,27,5,700000
2638," along unilag road, yaba lagos abule oja yaba lagos",2,1,1,1,"Newly built and well furnished serviced apartment with several amenities such as; 24hrs, adequate security, neat and serene environment, easily accessibility to the island and closer to Unilag. ... New. Furnished. All Room Ensuit. Big Compound. 24 Hours Electricity. Pop Ceiling. 24 Hours Security. ...",yaba,0,0,0,0,yaba1,450000.0,600000.0,500000.0,0,8,2,400000
2639, adekunle yaba lagos,2,1,1,1,1 bedroom mini flat Mini flat Flat / Apartment for rent Adekunle Yaba Lagos ... Renovated. Security. Supermarket Nearby. Restaurants Nearby. Security Doors. 24 Hours Electricity. Street Lights. ...,yaba,0,0,0,0,yaba1,450000.0,600000.0,500000.0,0,8,2,350000
2640, - onike yaba lagos,6,3,3,3,A very clean and Lovely 3bedroom @ onike yaba Close to sabo and easily accessible to the island Upstairs in a gated and secured environment 1.3mill rent With car park Kitchen cabinet Wardrobes Borehole Security Legal 260k( slightly negotiable) Agency 260k Caution ... ...,yaba,1,0,0,1,yaba3,1000000.0,1500000.0,1300000.0,2,27,5,1300000
2641, fola agoro yaba lagos,2,1,1,1,1 bedroom mini flat Self Contain Flat / Apartment for rent Fola Agoro Yaba Lagos ... New. Security. Supermarket Nearby. Restaurants Nearby. Security Doors. Pop Ceiling. 24 Hours Security. Street Lights. ...,yaba,0,0,0,1,yaba1,450000.0,600000.0,500000.0,1,8,2,450000
2642, old yaba road adekunle yaba lagos,7,4,3,4,"Tastedully finished 8 units of 3bedroom flats, all rooms ensuite with a visitors toilet in a serene and secured environment in Yaba. You can't afford to miss this. Call today for your inspections as limited ... New. Dry. Security. All Room Ensuit. Big Compound. Supermarket Nearby. Elevator. Security Doors. Parking Space. Pop Ceiling. 24 Hours Security. Street Lights. ...",yaba,1,0,0,1,yaba4,1500000.0,2000000.0,1800000.0,2,34,6,1800000
2643, onike yaba lagos,3,2,1,2,1 bedroom mini flat Mini flat Flat / Apartment for rent Onike Yaba Lagos ... New. Renovated. Security. Supermarket Nearby. Restaurants Nearby. Security Doors. Parking Space. Pop Ceiling. Street Lights. Printing Service. ...,yaba,0,0,0,0,yaba2,700000.0,850000.0,800000.0,0,17,3,600000
2644, akoka yaba lagos,4,2,2,2,1 bedroom mini flat Mini flat Flat / Apartment for rent Akoka Yaba Lagos ... New. Security. All Room Ensuit. Supermarket Nearby. Restaurants Nearby. Security Doors. Parking Space. Pop Ceiling. 24 Hours Security. Street Lights. Water Treatment. ...,yaba,0,0,0,0,yaba2,700000.0,850000.0,800000.0,0,17,3,600000
2645, yaba lagos,2,1,1,1," A well-appointed apartment carefully built in a conducive and habitable environment. A room self-contain service apartment, Price 300k rent. ... ...",yaba,0,0,0,0,yaba1,450000.0,600000.0,500000.0,0,8,2,300000
2646, alagomeji yaba lagos,4,2,2,2,Spacious and a newly built mini flat at Alagomeji for 800k a year and half rent with 2t and bath. Very accessible to the road with personal prepaid meter ... New. All Room Ensuit. Parking Space. Pop Ceiling. ...,yaba,1,0,0,1,yaba2,700000.0,850000.0,800000.0,2,17,3,800000
2647, onike yaba lagos,2,1,1,1,1 bedroom mini flat Mini flat Flat / Apartment for rent Onike Yaba Lagos ... All Room Ensuit. Big Compound. Supermarket Nearby. Restaurants Nearby. Security Doors. Parking Space. 24 Hours Security. ...,yaba,0,0,0,1,yaba1,450000.0,600000.0,500000.0,1,8,2,450000
2648, yaba lagos,2,1,1,1,"Mini-flat apartment, A baronial building carefully built in a conducive and habitable environment. With p.o.p ceiling, prepaid meter. Interlocking compound. Security door, nice kitchen shelf, ample parking. Security. Gated.one year required ... ...",yaba,1,0,0,1,yaba1,450000.0,600000.0,500000.0,2,8,2,500000
2649, akoka akoka yaba lagos,2,1,1,1,1 bedroom mini flat House for rent Akoka Akoka Yaba Lagos ... New. Security. Big Compound. Supermarket Nearby. Restaurants Nearby. Security Doors. 24 Hours Electricity. 24 Hours Security. Street Lights. ...,yaba,1,0,0,1,yaba1,450000.0,600000.0,500000.0,2,8,2,500000
2650, adekunle adekunle yaba lagos,6,3,3,3,"Own a unit of 2bedroom with 7million in this our ongoing project at adekunle yaba lagos for the next 20years and start to get your rent on a monthly or yearly basis, in ... Serviced. New. Cheap. Security. All Room Ensuit. Big Compound. Supermarket Nearby. Restaurants Nearby. Security Doors. Parking Space. 24 Hours Security. Street Lights. C Of O. ...",yaba,1,1,1,1,yaba3,1000000.0,1500000.0,1300000.0,4,27,5,1800000
2651, akoka akoka yaba lagos,2,1,1,1,1 bedroom mini flat Mini flat Flat / Apartment for rent Akoka Akoka Yaba Lagos ... New. Security. Big Compound. Supermarket Nearby. Restaurants Nearby. Security Doors. 24 Hours Electricity. 24 Hours Security. Street Lights. ...,yaba,1,0,0,1,yaba1,450000.0,600000.0,500000.0,2,8,2,500000
2652, beside ilaje police station akoka yaba lagos,2,1,1,1,Executive Hostel for Rent at Akoka Pay and parking hostel Fully Furnished and Serviced Constant water and Power Supply Good Road Network Very Accessible to the Road 24hrs Security 3man room is 300k person 4man room is 250k person Contact Backup Property Consult ... New. Furnished. Security. Security Doors. Parking Space. 24 Hours Electricity. Pop Ceiling. 24 Hours Security. Street Lights. ...,yaba,0,0,0,0,yaba1,450000.0,600000.0,500000.0,0,8,2,300000
2653, - akoka yaba lagos,3,2,1,2,2 bedroom Mini flat Flat / Apartment for rent Akoka Yaba Lagos ... Renovated. Security. Supermarket Nearby. Restaurants Nearby. Security Doors. Parking Space. Street Lights. ...,yaba,0,0,0,0,yaba2,700000.0,850000.0,800000.0,0,17,3,500000
2654, akoka yaba lagos,5,3,2,3,2 bedroom Flat / Apartment for rent Akoka Yaba Lagos ... New. Renovated. Security. All Room Ensuit. Supermarket Nearby. Restaurants Nearby. Security Doors. Parking Space. Pop Ceiling. 24 Hours Security. Street Lights. ...,yaba,0,0,0,0,yaba3,1000000.0,1500000.0,1300000.0,0,27,5,700000
2655, yaba lagos,4,2,2,2,"standard and lovely newly built 2 bedroom flat at akoka all rooms ensuite 900k a year. 3 bedroom flat for 1.4m in the same house with all room ensuite, kitchen cabinet, guest toilet, fitted wardrobe, ... ...",yaba,1,1,1,1,yaba2,700000.0,850000.0,800000.0,4,17,3,900000
2656," royal estate connal road, alagomeji yaba lagos",8,4,4,4,"4 bed Room terris Duplex @ Royal Estate Connal Road, Yaba Rent: 3.5 Million. Legal: 10% Agency: 10% Refundable: 10% Service Charge: N708,000. Annually, but u are allowed to Pay N59k Monthly is Optional, This includes Diesel, Cleaning, ... Serviced. All Room Ensuit. Big Compound. 24 Hours Electricity. 24 Hours Security. ...",yaba,1,1,1,1,yaba4,1500000.0,2000000.0,1800000.0,4,34,6,2500000
2657, onike yaba lagos,2,1,1,1,"Itâ€™s a newly built apartment of more than 10 Units of roomself contain. (Standard Room, Toilet and Kitchen) It is 98% completed. Accessible to the road we are selling to does who desire to invest in real estate ... New. Security. Security Doors. Parking Space. 24 Hours Electricity. Pop Ceiling. 24 Hours Security. Street Lights. ...",yaba,1,1,1,1,yaba1,450000.0,600000.0,500000.0,4,8,2,600000
2658, - sabo yaba lagos,4,2,2,2,"Newly built and spacious 2bedroom flat all rooms ensuite, adequate electricity, security, located in a serene environment at Sabo Yaba, Lagos.# 1.5m pa. Working class ... ...",yaba,1,1,1,1,yaba2,700000.0,850000.0,800000.0,4,17,3,1300000
2659, adekunle yaba adekunle yaba lagos,7,4,3,4,"Tastefully finished 3 bedroom flat with a guest toilet, all rooms ensuite, pop finishings, fitted wardrobe in all the rooms, fitted kitchen. Adequate parking space and 24 hours security and guards. Call us today for ... New. Dry. Security. All Room Ensuit. Big Compound. Supermarket Nearby. Security Doors. Parking Space. Pop Ceiling. 24 Hours Security. Drainage System. Street Lights. ...",yaba,1,0,0,1,yaba4,1500000.0,2000000.0,1800000.0,2,34,6,1800000
2660, close to pako bus stop akoka yaba lagos,2,1,1,1,"Pop finished , spacious , gated with car park space ... Renovated. Security. All Room Ensuit. Big Compound. Supermarket Nearby. Restaurants Nearby. Security Doors. Parking Space. Pop Ceiling. Drainage System. Street Lights. ...",yaba,0,0,0,0,yaba1,450000.0,600000.0,500000.0,0,8,2,400000
2661, brown street akoka yaba lagos,6,3,3,3,"Newly finished 2 bedroom flat with all rooms ensuite, plus guest convenience, in a serene neighbourhood. Furnished kitchen, dinning room, potable water, car park, and prepaid meter. Contact me for a short video detailing the interior specs, ... Serviced. New. Furnished. Cheap. Security. All Room Ensuit. Big Compound. Parking Space. Drainage System. ...",yaba,0,0,0,1,yaba3,1000000.0,1500000.0,1300000.0,1,27,5,1200000
2662, adekunle yaba lagos,6,3,3,3,Newly Built 2bedroom for rent Pay an parking apartment Very Spacious rooms Good road network All rooms ensuite Condusive environment Spacious parking space ... ...,yaba,0,0,0,1,yaba3,1000000.0,1500000.0,1300000.0,1,27,5,1000000
2663, akoka yaba lagos,5,3,2,3,2 bedroom Flat / Apartment for rent Akoka Yaba Lagos ... New. Security. All Room Ensuit. Supermarket Nearby. Restaurants Nearby. Security Doors. Parking Space. Pop Ceiling. 24 Hours Security. Street Lights. Water Treatment. ...,yaba,0,0,0,0,yaba3,1000000.0,1500000.0,1300000.0,0,27,5,900000
2664, - alagomeji yaba lagos,5,3,2,3,2 bedroom Flat / Apartment for rent Alagomeji Yaba Lagos ... New. Security. Supermarket Nearby. Restaurants Nearby. Security Doors. Parking Space. Pop Ceiling. Street Lights. ...,yaba,0,0,0,0,yaba3,1000000.0,1500000.0,1300000.0,0,27,5,800000
2665, fola agoro fola agoro yaba lagos,7,4,3,4,"Nice and massive 3bedroom Bedroom flat with all Rooms En-suite + Guest Convenient. POP, massive wardrobes, Water heater, Borehole Water, Lovely Balconyâ€™s/ View. Just 3 Occupants to share Compound. Up floor available. ... New. Security. All Room Ensuit. Big Compound. Supermarket Nearby. Restaurants Nearby. Security Doors. Parking Space. Pop Ceiling. 24 Hours Security. Drainage System. Street Lights. ...",yaba,1,0,0,1,yaba4,1500000.0,2000000.0,1800000.0,2,34,6,1800000
2666, adekunle yaba lagos,7,4,3,4,"Brandnew 8 units of 3bedroom flats, all rooms ensuite with a visitors toilet.. Location: Adekunle Yaba Facility: 1) elevator 2) standby generator 3) Perimeter fencing 4) Fire extinguisher 5) Lawmer waste bin Service charge yet to be determined. Price: 1.8m ... New. Security. All Room Ensuit. Elevator. ...",yaba,1,0,0,1,yaba4,1500000.0,2000000.0,1800000.0,2,34,6,1800000
2667, onike yaba lagos,2,1,1,1,1 bedroom mini flat Self Contain Flat / Apartment for rent Onike Yaba Lagos ... Renovated. Security. Supermarket Nearby. Restaurants Nearby. Security Doors. Parking Space. 24 Hours Security. Street Lights. ...,yaba,0,0,0,0,yaba1,450000.0,600000.0,500000.0,0,8,2,400000
2668, akoka yaba lagos,4,2,2,2,1 bedroom mini flat Mini flat Flat / Apartment for rent Akoka Yaba Lagos ... New. Renovated. Security. All Room Ensuit. Supermarket Nearby. Restaurants Nearby. Security Doors. Parking Space. Pop Ceiling. 24 Hours Security. Street Lights. Printing Service. Water Treatment. ...,yaba,0,0,0,1,yaba2,700000.0,850000.0,800000.0,1,17,3,700000
2669, yaba lagos,2,1,1,1,"Big and Serviced Selfcontain Apartment. 3D Wall, Tiles, Borehole Water, Water Heater, Kitchen Cabinet, Car Park. Up Floor with very good View. Location: yaba. Rent: N300,000.00 Service Charge: N382,210.00 Caution Fee: N50,000.00 Legal Fee: N70,000.00 Agency Fee: N70,000.00 Total= N872,210.00 *But You Can Spread Your ... ...",yaba,1,1,1,1,yaba1,450000.0,600000.0,500000.0,4,8,2,600000
2670, yaba lagos,2,1,1,1,Decent mini flat for sale in a good location of Yaba. ... ...,yaba,1,1,1,1,yaba1,450000.0,600000.0,500000.0,4,8,2,600000
2671, yaba lagos,8,4,4,4,"A 4 bedroom terrace duplex for office use measuring 108sqm Location: yaba Rent: #3,500,000 Service charge: #2,500,000 Power deposit:#300,000 Caution:#200k Agency and legal 5% each ... ...",yaba,1,1,1,1,yaba4,1500000.0,2000000.0,1800000.0,4,34,6,2500000
2672, yaba lagos,2,1,1,1,"Nice Mini flat with Prepaid Meter, Borehole Water, POP, Car Park,Security. Rent: 500k Legal: 10% Agency.: 10% Refundable Caution: 100k Maintenance: 120k per annum. ... ...",yaba,1,0,0,1,yaba1,450000.0,600000.0,500000.0,2,8,2,500000
2673, sabo yaba lagos,4,2,2,2,A very clean 2bedroom @ sabo 700k in a block of flats Upstairs easily accessible to the island through With car park Kitchen cabinet ... ...,yaba,0,0,0,1,yaba2,700000.0,850000.0,800000.0,1,17,3,700000
2674, johnson onike yaba lagos,4,2,2,2,Newly built 2bedroom at Onike Pay and parking apartment Good road network Constant water and power supply Prepaid meter available Accessibility to the island Spacious parking space All room en-suite Secured environment. ... New. Furnished. Security. All Room Ensuit. Big Compound. Security Doors. Parking Space. 24 Hours Electricity. 24 Hours Security. ...,yaba,1,0,0,1,yaba2,700000.0,850000.0,800000.0,2,17,3,800000
2675, - jibowu yaba lagos,3,2,1,2,1 bedroom mini flat Mini flat Flat / Apartment for rent Jibowu Yaba Lagos ... New. Renovated. Security. Supermarket Nearby. Restaurants Nearby. Security Doors. Parking Space. Street Lights. ...,yaba,0,0,0,0,yaba2,700000.0,850000.0,800000.0,0,17,3,500000
2676, akoka yaba lagos,2,1,1,1,"Newly built mini flat fence round with gate security wise car park Akoka, 550k per year but 500k can fly Bungalow In a calm environment All tiled Easily accessible to the island from oworosoki or through ... ...",yaba,1,0,0,1,yaba1,450000.0,600000.0,500000.0,2,8,2,500000
2677, fola agoro yaba lagos,3,2,1,2,"*JUST OUT!!!* *MINI FLAT TO LET IN AROWOJOBE* A very neat and spacious mini flat *@Awopetu Street, off Modupe* (2 toilets, 1 bath, a big kitchen, 2 exit doors and a courtyard) *600k P.A* ... ...",yaba,0,0,0,0,yaba2,700000.0,850000.0,800000.0,0,17,3,600000
2678, onike yaba lagos,2,1,1,1,1 bedroom mini flat Mini flat Flat / Apartment for rent Onike Yaba Lagos ... New. Renovated. Security. Supermarket Nearby. Restaurants Nearby. Security Doors. Parking Space. Street Lights. ...,yaba,0,0,0,1,yaba1,450000.0,600000.0,500000.0,1,8,2,450000
2679, fola agoro yaba lagos,5,3,2,3,Newly built 2bedroom flat at Folagoro for 900k a year rent with both rooms en-suite and a visitorâ€™s toilet and parking space in a decent environment ... New. ...,yaba,0,0,0,0,yaba3,1000000.0,1500000.0,1300000.0,0,27,5,900000
2680, jibowu yaba lagos,4,2,2,2,"A decent 3bed room flat at Morocco shomolu for 800k but 750k can fly with wardrobe in all rooms and has two toilet and bath, parking space, could be suitable for office use too Note: some ... ...",yaba,1,0,0,1,yaba2,700000.0,850000.0,800000.0,2,17,3,800000
2681, akoka akoka yaba lagos,4,2,2,2,Rent is 700k Agreement 10% Commission 20% Caution 50k ... Cheap. Renovated. New. All Room Ensuit. 24 Hours Electricity. Big Compound. Parking Space. Supermarket Nearby. 24 Hours Security. Security Doors. Pop Ceiling. Security. Street Lights. ...,yaba,0,0,0,1,yaba2,700000.0,850000.0,800000.0,1,17,3,700000
2682, em akoka yaba lagos,2,1,1,1,Lovely room self-contained at Akoka 400k agency 100k agreement 80k (refundable deposit 50k ) ... Furnished. Renovated. Cheap. Pop Ceiling. All Room Ensuit. Security. Security Doors. Big Compound. Parking Space. 24 Hours Security. Fast Internet. ...,yaba,0,0,0,0,yaba1,450000.0,600000.0,500000.0,0,8,2,400000
2683, emily akoka yaba lagos,2,1,1,1,Just out mini flat at Akoka 700k one year rent and Roomself 400k one year rent same house with pop ... Renovated. Furnished. Cheap. All Room Ensuit. Big Compound. Security Doors. Pop Ceiling. Parking Space. Security. ...,yaba,1,1,1,1,yaba1,450000.0,600000.0,500000.0,4,8,2,600000
2684," adjacent unilag,not far from hebert macaulay expressway akoka yaba lagos",4,2,2,2,"A SPACIOUS,newly renovated,well ventilated and well put together Room and Parlour Mini-Flat, in a neat,fenced round with gate with car park building.Situated in one of the prime,safe by GOD Permission areas within Yaba(Akoka),with good proximity ... Renovated. Parking Space. ...",yaba,0,0,0,0,yaba2,700000.0,850000.0,800000.0,0,17,3,500000
2685, off tejuosho road tejuosho yaba lagos,2,1,1,1,Newly Built Fully Serviced Mini flat in a serene area off Tejuosho road . ... New. 24 Hours Security. Big Compound. ...,yaba,1,0,0,1,yaba1,450000.0,600000.0,500000.0,2,8,2,500000
2686, adjacent unilag akoka yaba lagos,2,1,1,1,"A Spacious, well put together, Neat and affordable 3 Bedroom Flat (Partitioned) OFFICE SPACE, well ventilated, in a neat Storey building(s) fenced round with gates. Located in a peaceful/quiet and commercial/business part of Akoka, Yaba ... C Of O. Security Doors. ...",yaba,1,1,1,1,yaba1,450000.0,600000.0,500000.0,4,8,2,600000
2687," grace court estate, off herbert macaulay way, adekunle yaba lagos",9,5,4,5,"An Executive Modern Ensuites Serviced 4bd Duplex + Bq @ Grace Court Estate, Semi-Detached Duplex, @ Adekunle, Yaba, Lagos, very close to 3rd mainland bridge, fenced round with gate and ample parking space, with a ... ...",yaba,1,1,0,1,yaba5,3000000.0,3260000.0,3200000.0,3,43,8,3500000
2688, makoko adekunle yaba lagos,2,1,1,1,"Easy access in from sabo and Adekunle, very close to the road, market and third mainland bridge 2years rent required ... New. Dry. Fast Internet. Pop Ceiling. Drainage System. ...",yaba,0,0,0,0,yaba1,450000.0,600000.0,500000.0,0,8,2,380000
2689, akoka yaba lagos,2,1,1,1, A sharp and Newly built mini flat fence round with gate and a car park in Akoka ... Renovated. New. Security. Parking Space. All Room Ensuit. ...,yaba,1,0,1,1,yaba1,450000.0,600000.0,500000.0,3,8,2,550000
2690, onike yaba lagos,2,1,1,1,Decent mini flat at off Onike for 600k a year rent only ... ...,yaba,1,1,1,1,yaba1,450000.0,600000.0,500000.0,4,8,2,600000
2691, fola agoro fola agoro yaba lagos,2,1,1,1,A well-appointed apartment carefully built in a conducive and habitable environment.modest home luxurious interior. Call and whatsapp. One year required ... ...,yaba,0,0,0,0,yaba1,450000.0,600000.0,500000.0,0,8,2,350000
2692," akoka, akoka, akoka yaba lagos",2,1,1,1,"A well-appointed apartment carefully built in a conducive and habitable environment. Pleasant to spend time in, call and whatsapp. One year required. Preferably lady only. ... ...",yaba,0,0,0,0,yaba1,450000.0,600000.0,500000.0,0,8,2,300000
2693, western avenue by surulere jibowu yaba lagos,2,1,1,1,"A lovely luxury Mini flat @ yaba by western avenue by surulere yaba Lagos. furnished with pop fitting an kitchen cabinet good road network constant electricity secure environment proximity to vi Cms ikoyi marina ikeja apapa warf, sabo ... ...",yaba,0,0,0,1,yaba1,450000.0,600000.0,500000.0,1,8,2,450000
2694, off iwaya road iwaya yaba lagos,4,2,2,2,"This are newly renovated penthouse 3 bedroom flats on the 4th floor in a gated compound with round view balcony, large parlor and spacious bedrooms, kitchen and store and spacious compound for your car to ... ...",yaba,1,0,0,1,yaba2,700000.0,850000.0,800000.0,2,17,3,800000
2695, akoka yaba lagos,7,4,3,4,"Newly built pop finished 3 bedroom flat located close to pako bus stop in Akoka , yaba. Up flat 1.5m Down flat 1.3m ... Dry. New. All Room Ensuit. Big Compound. Security. Drainage System. Restaurants Nearby. Supermarket Nearby. Security Doors. Parking Space. Pop Ceiling. ...",yaba,0,0,0,0,yaba4,1500000.0,2000000.0,1800000.0,0,34,6,1300000
2696, akoka yaba lagos,7,4,3,4,"Newly built pop finished 3 bedroom flat located close to pako bus stop in Akoka , yaba. Up flat 1.5m Down flat 1.3m ... Dry. New. All Room Ensuit. Street Lights. Big Compound. Security. Drainage System. Restaurants Nearby. Supermarket Nearby. Security Doors. Parking Space. Pop Ceiling. ...",yaba,0,0,0,1,yaba4,1500000.0,2000000.0,1800000.0,1,34,6,1500000
2697,  millenuim ups gbagada lagos,7,4,3,4,Just 3 units in a massive compound Goodkitchenette with cabinet Serene environment and secured estate Good parking lot Good access road Modern structure ... Dry. New. Big Compound. All Room Ensuit. Parking Space. Fast Internet. Drainage System. 24 Hours Security. Children Play Ground. Security. Child Care. Street Lights. Pop Ceiling. Cctv Cameras. Security Doors. Water Treatment. ...,gbagada,0,0,0,1,gbagada4,1700000.0,2500000.0,2500000.0,1,37,7,2300000
2698,  phase 2 gbagada lagos,9,5,4,5,Strategically located for best commercial use Serene environment with security Spacious rooms and living room Good kitchenette with cabinet and store Good parking lot Access road to the express Well built ... Dry. New. Big Compound. Supermarket Nearby. All Room Ensuit. Parking Space. Fast Internet. Drainage System. 24 Hours Security. Office Supplies. Children Play Ground. Restaurants Nearby. Security. Child Care. Street Lights. Printing Service. Pop Ceiling. Church Nearby. Security Doors. Water Treatment. ...,gbagada,1,1,0,1,gbagada5,3000000.0,3000000.0,3000000.0,3,43,8,3000000
2699, ... millenuim ups gbagada lagos,7,4,3,4,"Newly built lovely 3 bedroom en suit flat. New, All Room En suit, CCTV Camera, Water Treatment, Good Access Road, Self- Serviced, Within an Estate ... New. Big Compound. All Room Ensuit. Parking Space. Pop Ceiling. Cctv Cameras. Water Treatment. ...",gbagada,1,1,0,1,gbagada4,1700000.0,2500000.0,2500000.0,3,37,7,2500000
2700,  millenuim ups gbagada lagos,7,4,3,4,Spacious rooms and living room Good kitchenette with cabinet and store Serene environment and secured estate Good parking lot Just 3 tenant to share compound Upstairs flat Good access road ... Dry. New. Big Compound. Supermarket Nearby. All Room Ensuit. Parking Space. Fast Internet. Drainage System. 24 Hours Security. Office Supplies. Children Play Ground. Security. Child Care. Street Lights. Pop Ceiling. Security Doors. Water Treatment. ...,gbagada,0,0,0,1,gbagada4,1700000.0,2500000.0,2500000.0,1,37,7,2300000
2701, ... millenuim ups gbagada lagos,7,4,3,4,"Newly built lovely 3 bedroom Terrace. New, All Room Ensuit, CCTV Camera, Water Treatment, Good Access Road, Self- Serviced, Within an Estate. ... New. Big Compound. All Room Ensuit. Parking Space. Pop Ceiling. C Of O. Cctv Cameras. Water Treatment. ...",gbagada,1,1,0,1,gbagada4,1700000.0,2500000.0,2500000.0,3,37,7,2500000
2702,  ifako gbagada gbagada lagos,6,3,3,3,"Up and down flat available, Serene environment and security, Specious living room and rooms, Good kitchenette with cabinet, Good parking lot, Accessible road network. ... Dry. Renovated. Cheap. Street Lights. Big Compound. Supermarket Nearby. Parking Space. Fast Internet. Pop Ceiling. Drainage System. 24 Hours Security. Children Play Ground. Security Doors. Security. ...",gbagada,1,1,1,1,gbagada3,1000000.0,1300000.0,1200000.0,4,27,5,1400000
2703,  millenuim ups gbagada lagos,7,4,3,4,Newly Built luxury flat. Upstairs and ground floor available for 2.5/2.7m per flat. Spacious rooms and living room Good kitchenette with cabinet and store Just 4 tenant in a compound Very secured and serene estate Good access ... Dry. New. Big Compound. Supermarket Nearby. All Room Ensuit. Parking Space. Fast Internet. Drainage System. 24 Hours Security. Office Supplies. Children Play Ground. Restaurants Nearby. Security. Child Care. Street Lights. Pop Ceiling. Cctv Cameras. Security Doors. Water Treatment. ...,gbagada,1,1,0,1,gbagada4,1700000.0,2500000.0,2500000.0,3,37,7,2500000
2704,  ... millenuim ups gbagada lagos,5,3,2,3,"Lovely Serviced 2 Bedroom En suit Flat. Newly Renovated, All Room En suit, 24 Hours Electricity, CCTV Camera, Water Treatment, Good Access Road, Serviced with 24 hours light, Within an Estate, Service Charge fee: 500k/Yr ... Renovated. Serviced. 24 Hours Electricity. All Room Ensuit. Parking Space. Pop Ceiling. Cctv Cameras. Water Treatment. ...",gbagada,1,1,1,1,gbagada3,1000000.0,1300000.0,1200000.0,4,27,5,1800000
2705,  glory estate ifako gbagada gbagada lagos,7,4,3,4,*TO LET* Newly built 3Bedroom Duplex with A Room Bq in glory estate gbagada in a secured and serene environment *2living room & guest toilet.* *All rooms Ensuites* *Furnished kitchen* *Boys quarter* *Enough parking space* *Personal prepaid Meter* *Remote control ... Cheap. Dry. New. Street Lights. Parking Space. Jacuzzi. Water Treatment. Boys Quater. 24 Hours Security. Big Compound. Pop Ceiling. Security. All Room Ensuit. 24 Hours Electricity. Supermarket Nearby. Security Doors. ...,gbagada,1,1,0,1,gbagada4,1700000.0,2500000.0,2500000.0,3,37,7,2500000
2706, off ifako ifako gbagada gbagada lagos,4,2,2,2,2 bedroom ground floor off ifako gbagada ... ...,gbagada,0,0,0,0,gbagada2,725000.0,1000000.0,829999.9999999998,0,18,3,700000
2707,  power line soluyi gbagada lagos,6,3,3,3,3 bedroom Flat / Apartment for rent Power Line Soluyi Gbagada Lagos ... Renovated. Security. Parking Space. ...,gbagada,0,0,0,0,gbagada3,1000000.0,1300000.0,1200000.0,0,27,5,850000
2708,  ifako josland area ifako gbagada gbagada lagos,5,3,2,3,2 bedroom Flat / Apartment for rent Ifako josland area Ifako-gbagada Gbagada Lagos ... Renovated. Old. Pop Ceiling. Security. Parking Space. Security Doors. Survey. ...,gbagada,0,0,0,0,gbagada3,1000000.0,1300000.0,1200000.0,0,27,5,750000
2709,  sosanya soluyi gbagada lagos,5,3,2,3,3 bedroom Flat / Apartment for rent Sosanya Soluyi Gbagada Lagos ... Renovated. Old. Big Compound. Pop Ceiling. Security. All Room Ensuit. Parking Space. Security Doors. ...,gbagada,0,0,0,0,gbagada3,1000000.0,1300000.0,1200000.0,0,27,5,850000
2710,  millenuim ups gbagada lagos,2,1,1,1,1 bedroom mini flat Mini flat Flat / Apartment for rent Millenuim/UPS Gbagada Lagos ... ...,gbagada,1,1,1,1,gbagada1,450000.0,500000.0,500000.0,4,8,2,650000
2711,  medina gbagada lagos,7,4,3,4,3 bedroom Flat / Apartment for rent Medina Gbagada Lagos ... ...,gbagada,0,0,0,0,gbagada4,1700000.0,2500000.0,2500000.0,0,37,7,1500000
2712,  alapere gbagada lagos,4,2,2,2,"2bed at Alapere, all rooms ensuit ... ...",gbagada,0,0,0,0,gbagada2,725000.0,1000000.0,829999.9999999998,0,18,3,600000
2713,  phase 2 gbagada lagos,7,4,3,4,3 bedroom flat upstairs apartment ... ...,gbagada,0,0,0,0,gbagada4,1700000.0,2500000.0,2500000.0,0,37,7,1500000
2714,  ifako ifako gbagada gbagada lagos,5,3,2,3,"2 bedroom apartment in a block of 4, upstairs flat ... Pop Ceiling. Security. All Room Ensuit. Parking Space. Drainage System. ...",gbagada,0,0,0,1,gbagada3,1000000.0,1300000.0,1200000.0,1,27,5,1000000
2715,  ifako gbagada gbagada lagos,4,2,2,2,"Decent 2 bedrooms ground flat in a block of 4, 2toilet , 2 bathroom and all rooms are ensuite ... Pop Ceiling. Security. All Room Ensuit. Parking Space. ...",gbagada,0,0,0,1,gbagada2,725000.0,1000000.0,829999.9999999998,1,18,3,800000
2716,  millenuim ups gbagada lagos,7,4,3,4,two tenants in the compound ... Security. Parking Space. ...,gbagada,0,0,0,1,gbagada4,1700000.0,2500000.0,2500000.0,1,37,7,1800000
2717,  soluyi gbagada lagos,2,1,1,1,"Mini flat with kitchen and prepaid metre plus parking space by Deeper Life axis Gbagada - Lagos Rent: N450,000 Kindly call the phone numbers below for more info; APRO GLOBAL REAL ESTATES Web:info@aproglobalestate. com.ng. Tel: 01-7620139 Mobile: 080-51-595-336,080-29-481-639 070-63-822-217, 070-82-974-088 ... Security. Supermarket Nearby. Parking Space. ...",gbagada,0,0,0,1,gbagada1,450000.0,500000.0,500000.0,1,8,2,450000
2718,  pedro-gbagada area gbagada lagos,5,3,2,3,"Serviced 2 Bedroom all rooms en-suite flat with Prepaid Meter & Car Park. The Parlour & 2 bedrooms are furnished with Airconditioning System each, Water Heater, Gas Cooker, Kitchen Cabinets, Kitchen Storage Area, Wardrobes in all ... ...",gbagada,1,1,0,1,gbagada3,1000000.0,1300000.0,1200000.0,3,27,5,1300000
2719,  odo-eran iyana orowo gbagada oworonshoki gbagada lagos,5,3,2,3," Newly built two bedroom flat with all rooms ensuit, visitors toilet, prepaid meter LOCATION:community street, odo-eran,iyana oworo, gbagada, Lagos. Rent:N500k SC:N30K Caution: N20K ... New. Parking Space. All Room Ensuit. Pop Ceiling. Security. ...",gbagada,0,0,0,0,gbagada3,1000000.0,1300000.0,1200000.0,0,27,5,700000
2720,  after deperlife church gbagada lagos,2,1,1,1," Mini flat (1bedroom Apartment with kitchen toilet and bathroom) LOCATION :popoola banjoko street, after deeper life church gbagada. *Rent: 450k.* *Agency: 60. Agreement: 60k. Caution:50. Total package:620k ... Security. Parking Space. Pop Ceiling. ...",gbagada,0,0,0,1,gbagada1,450000.0,500000.0,500000.0,1,8,2,450000
2721,  sawmill gbagada gbagada lagos,5,3,2,3,"Tastefully finished 2brm flat with all rooms ensuite and guest toilet, relatively new, upstairs flat at LOCATION:, Sawmill, Gbagada. Price: 900k, 1yr rent. ... Security. All Room Ensuit. Big Compound. Parking Space. Pop Ceiling. ...",gbagada,0,0,0,0,gbagada3,1000000.0,1300000.0,1200000.0,0,27,5,900000
2722,  off pedro gbagada ifako gbagada gbagada lagos,5,3,2,3,"Spacious and newly Built 2bedroom with modern finishing all rooms ensuite, with pop finishing, prepaid meter etc LOCATION: olaniyi street of pedro road by Gbagada PHASE 2 Price: 1m per annum ... New. Jacuzzi. Security. All Room Ensuit. Big Compound. Parking Space. Pop Ceiling. ...",gbagada,0,0,0,1,gbagada3,1000000.0,1300000.0,1200000.0,1,27,5,1000000
2723,"  community street ,odo eran,iyana oworo gbagada lagos",2,1,1,1,"For lease: Newly built mini flat with kitchen,toilet, balcony, prepaid meter at community street,odo-eran,iyana oworo, gbagada,Lagos. Rent:N400k SC: N30K Caution:N20k ... New. Security. Parking Space. Pop Ceiling. ...",gbagada,0,0,0,0,gbagada1,450000.0,500000.0,500000.0,0,8,2,400000
2724,  gb millenuim ups gbagada lagos,7,4,3,4,"*TO LET* *MILLENIUM ESTATE, OKE ALO* 6 nos brand new, tastefully finished and very spacious 3b/r flats *. (All rooms ensuite, ample parking). *2.5M P.A* ... Cheap. New. Furnished. Security. 24 Hours Security. Big Compound. All Room Ensuit. Security Doors. Parking Space. Pop Ceiling. ...",gbagada,1,1,0,1,gbagada4,1700000.0,2500000.0,2500000.0,3,37,7,2500000
2725, pedro phase 1 gbagada lagos,6,3,3,3,This property is located at gbagada in a serene and secured environment it's consist of a decent clean two bedrooms all ensuites .price tag is 850k other charges follow suites. INSPECTION FEE IS 5K ... ...,gbagada,0,0,0,0,gbagada3,1000000.0,1300000.0,1200000.0,0,27,5,850000
2726, ifako gbagada gbagada lagos,5,3,2,3,Upstairs Spacious rooms and living room Good kitchenette with cabinet Good parking lot Accessible road Neat and serene environment ... Dry. Renovated. Cheap. Old. Big Compound. Supermarket Nearby. Parking Space. Drainage System. 24 Hours Security. Security Doors. ...,gbagada,0,0,0,1,gbagada3,1000000.0,1300000.0,1200000.0,1,27,5,1000000
2727, ifako gbagada gbagada lagos,7,4,3,4,Upstairs Exclusive staircase Good kitchenette with cabinet Good access road network Spacious rooms and living room Serene environment and security Good parking lot ... Dry. Renovated. Street Lights. Big Compound. All Room Ensuit. Parking Space. Fast Internet. Pop Ceiling. Drainage System. 24 Hours Security. Security Doors. Water Treatment. Security. ...,gbagada,0,0,0,0,gbagada4,1700000.0,2500000.0,2500000.0,0,37,7,1300000
2728, atunrase medina gbagada lagos,7,4,3,4,Just 3 tenant to share compound Top notch quality finishes Spacious rooms and living room Serene environment and secured estate Good access road network Parking lot ... Dry. New. Street Lights. Big Compound. All Room Ensuit. Parking Space. Fast Internet. Pop Ceiling. Drainage System. 24 Hours Security. Security Doors. Water Treatment. Restaurants Nearby. Security. ...,gbagada,0,0,0,1,gbagada4,1700000.0,2500000.0,2500000.0,1,37,7,2000000
2729, ifako gbagada gbagada lagos,5,3,2,3,3 bedroom Flat / Apartment for rent Harmony estate Ifako-gbagada Gbagada Lagos ... Dry. Renovated. Cheap. Big Compound. Supermarket Nearby. Parking Space. Drainage System. 24 Hours Security. Office Supplies. Children Play Ground. Security. Child Care. Street Lights. Printing Service. Security Doors. Water Treatment. ...,gbagada,1,1,1,1,gbagada3,1000000.0,1300000.0,1200000.0,4,27,5,1500000
2730, millenuim ups gbagada lagos,7,4,3,4,Just 4 to share compound Spacious compound Spacious rooms and living room Good kitchenette with cabinet Good parking lot Serene and secured estate Good accessible road ... Dry. New. Street Lights. Big Compound. All Room Ensuit. Parking Space. Pop Ceiling. Drainage System. 24 Hours Security. Children Play Ground. Security Doors. Security. Child Care. ...,gbagada,0,0,0,0,gbagada4,1700000.0,2500000.0,2500000.0,0,37,7,1600000
2731, millenuim ups gbagada lagos,7,4,3,4,Upstairs 6 units Fully serviced expect PHCN Spacious rooms and living room Good kitchenette with cabinet Good parking lot Good access road network Service include diesel and payment estate dues Serene environment and secured estate ... Dry. New. Serviced. Big Compound. Supermarket Nearby. All Room Ensuit. Parking Space. Fast Internet. Drainage System. 24 Hours Security. Children Play Ground. Security. Street Lights. Pop Ceiling. Jacuzzi. Security Doors. Water Treatment. ...,gbagada,0,0,0,1,gbagada4,1700000.0,2500000.0,2500000.0,1,37,7,2000000
2732, ifako ifako gbagada gbagada lagos,7,4,3,4,"TO LET. *Newly built executive Spacious luxury 3bedrooms with a room BQ, all ensuite upstairs with modern facilities*. . *Price: 2m* ... Cheap. New. Swimming Pool. Big Compound. Pop Ceiling. Security. All Room Ensuit. Parking Space. 24 Hours Electricity. Jacuzzi. Water Treatment. Security Doors. Boys Quater. 24 Hours Security. ...",gbagada,0,0,0,1,gbagada4,1700000.0,2500000.0,2500000.0,1,37,7,2000000
2733, ferano court ifako gbagada gbagada lagos,11,6,5,6,"*Fresh Gbagada Lettings:* Lovely 5brm Detached duplex with 1rm BQ, all rooms ensuite and guest toilet at Ferrano Court, Glory Estate, Ifako, Gbagada. 2m, 1yr rent ... Renovated. Cheap. Swampy. New. Parking Space. Jacuzzi. Gym. Water Treatment. Boys Quater. Governor's Consent. Child Care. 24 Hours Security. Big Compound. Pop Ceiling. Restaurants Nearby. Security. Cctv Cameras. 24 Hours Electricity. Supermarket Nearby. Security Doors. ...",gbagada,1,1,0,1,gbagada6,3000000.0,3000000.0,3000000.0,3,43,8,3000000
2734, millennium estate millenuim ups gbagada lagos,7,4,3,4,New built 4nos of 3bedroom flat at Okealo millennium estate Gbagada Rent: Down 2.5million up 2.7million Nb: prefers a corporate tenant that can take all four or individuals that have a good corporate job. ... Cheap. New. Street Lights. Big Compound. Pop Ceiling. Security. All Room Ensuit. Parking Space. 24 Hours Electricity. Supermarket Nearby. Jacuzzi. Water Treatment. Security Doors. 24 Hours Security. ...,gbagada,1,1,0,1,gbagada4,1700000.0,2500000.0,2500000.0,3,37,7,2500000
2735, millennium estate millenuim ups gbagada lagos,9,5,4,5,Good Lovely And Tastefully Finished 4Bedroom Detached Duplex In Millennium Estate Gbagada Features: Marble Finishing All Room Ensuite Guest Toilet Dinning Area Fitted Kitchen Family Lounge Screeded Walls Balcony Fitted Wardrobes Nice Ambiance Serene And Well Secured Estate Well Accessible Good ... Cheap. Dry. New. Street Lights. Big Compound. Pop Ceiling. Restaurants Nearby. Security. All Room Ensuit. Parking Space. 24 Hours Electricity. Water Treatment. Security Doors. 24 Hours Security. ...,gbagada,1,1,1,1,gbagada5,3000000.0,3000000.0,3000000.0,4,43,8,3500000
2736, josodat estate soluyi gbagada lagos,7,4,3,4,"Very Spacious 3bedroom flat all rooms ensuite with guest toilet, wardrobe, kitchen cabinet in a block of 4 flat. Ground floor vacant ... Security Doors. Street Lights. Big Compound. All Room Ensuit. 24 Hours Security. ...",gbagada,0,0,0,0,gbagada4,1700000.0,2500000.0,2500000.0,0,37,7,1500000
2737, ifako gbagada gbagada lagos,6,3,3,3,Just out 2bedrm flat 2t2b 1 room ensuits with water heater down flat 3 people to share compound at shadia estate gbagada Price _1m 1 year ... ...,gbagada,0,0,0,1,gbagada3,1000000.0,1300000.0,1200000.0,1,27,5,1000000
2738, medina gbagada lagos,5,2,3,2, Spacious 3bedrm flat 3t2b upstairs at alhaja toibat street Medina estate gbagada lagos state ... ...,gbagada,1,1,1,1,gbagada2,725000.0,1000000.0,829999.9999999998,4,18,3,1300000
2739, soluyi gbagada lagos,6,3,3,3,This property is located at gbagada it's consist of a three bedroom in a decent and secured environment. Price tag is 700k a year rent other charges follow suites. INSPECTION FEE IS 5k ... ...,gbagada,0,0,0,0,gbagada3,1000000.0,1300000.0,1200000.0,0,27,5,700000
2740, ifako gbagada gbagada lagos,6,3,3,3,This property is located at gbagada in a serene and secured area it's consist of a newly built two bedrooms all ensuites upstairs is 1.2m downstairs is 900k a year rent other charges follow suites. INSPECTION ... ...,gbagada,0,0,0,0,gbagada3,1000000.0,1300000.0,1200000.0,0,27,5,900000
2741, akinwunmi ifako gbagada gbagada lagos,4,2,2,2,"2bedroom flat, master ensuite fence round with carpark. Ground floor vacant ... ...",gbagada,0,0,0,0,gbagada2,725000.0,1000000.0,829999.9999999998,0,18,3,700000
2742, ifako gbagada gbagada lagos,6,3,3,3,"This property is located at gbagada at ifako,it consists of a newly built two bedroom flat all rooms en suites. Ample parking space,well finished interiors, nice kitchen cabinets. Price tag is 1.3m non negotiable other ... New. ...",gbagada,1,1,0,1,gbagada3,1000000.0,1300000.0,1200000.0,3,27,5,1300000
2743, .. ifako gbagada gbagada lagos,6,3,3,3,This property is located in gbagada in a serene and secured estate it's consist of a two bedroom all ensuites price tag is 800k other charges follow suites. INSPECTION FEE IS 5K ... ...,gbagada,0,0,0,0,gbagada3,1000000.0,1300000.0,1200000.0,0,27,5,800000
2744, soluyi gbagada lagos,6,3,3,3,This property is located as soluyi is a decent neighbourhood. consist of three bedroom with three toilets and bathroom. just four in the compound. price tag is 700k other charges follow suites.. INSPECTION FEE IS 5K ... ...,gbagada,0,0,0,0,gbagada3,1000000.0,1300000.0,1200000.0,0,27,5,700000
2745, gbagada road phase 2 gbagada lagos,2,1,1,1,Relatively new Mini flat fence round with gate ... New. ...,gbagada,1,1,0,1,gbagada1,450000.0,500000.0,500000.0,3,8,2,500000
2746, popoola soluyi gbagada lagos,6,3,3,3,"Spacious 3bedroom flat all rooms ensuite, upstairs fence round with carpark. ... Security Doors. Pop Ceiling. Big Compound. All Room Ensuit. Parking Space. ...",gbagada,1,0,0,1,gbagada3,1000000.0,1300000.0,1200000.0,2,27,5,1200000
2747, yetunde brown ifako gbagada gbagada lagos,4,2,2,2,"This property is located in gbagada, massively spacious well built apartment. its a mini flat upstairs. relatively new apartment. price tag is 800k. other charges follow suites. NOTE : INSPECTION FEE IS 5K ... ...",gbagada,0,0,0,1,gbagada2,725000.0,1000000.0,829999.9999999998,1,18,3,800000
2748, medina gbagada lagos,6,3,3,3,"This property is located in gbagada in medina estate. its a portable cute two bedrooms all ensuites. fitted kitchen cabinets,wadrobes, p.o.p well finished rooms.with ample parking space. Just two in the compound. in a serene ... ...",gbagada,1,1,0,1,gbagada3,1000000.0,1300000.0,1200000.0,3,27,5,1300000
2749, sawmill ifako gbagada gbagada lagos,7,4,3,4,"Spacious 3 bedrooms up n ground flats all rooms ensuite with guest toilet, water heater, kitchen cabinets, wardrobes n prepaid meter @ Sawmill Gbagada 1.1M and 1.2M respectively ... Renovated. Security Doors. Security. Big Compound. All Room Ensuit. Parking Space. 24 Hours Security. ...",gbagada,0,0,0,0,gbagada4,1700000.0,2500000.0,2500000.0,0,37,7,1100000
2750, gbagada lagos,4,2,2,2,2bedroom flat all rooms ensuite guest toilet fitted kitchen pop wardrobe prepaid meter ground floor at powerline sholuyi gbagada#700 ... ...,gbagada,0,0,0,0,gbagada2,725000.0,1000000.0,829999.9999999998,0,18,3,700000
2751, soluyi gbagada lagos,6,3,3,3, Good 3bed room flat 3t2b upstairs off ayodele okeowo close to deeper life church gbagada 1m a year rent 900 can fly ... ...,gbagada,0,0,0,0,gbagada3,1000000.0,1300000.0,1200000.0,0,27,5,900000
2752, ifako gbagada gbagada lagos,6,3,3,3,This property is located in gbagada in a serene and secured environment it's consist of a spacious two bedroom apartment price tag is 1m other charges follow suites. It's a very spacious apartment INSPECTION FEE IS ... ...,gbagada,0,0,0,1,gbagada3,1000000.0,1300000.0,1200000.0,1,27,5,1000000
2753, millennium estate millenuim ups gbagada lagos,7,4,3,4,"Exquisitely finished and luxurious 3bedroom flat, built to modern innovation. 4 unit available Price: up 2.7M down 2.5M Location: Millennium Estate UPS Gbagada. Very serene and secure with uniform Men Note: need a cooperate tenant ... New. Security Doors. Security. Pop Ceiling. Street Lights. Big Compound. All Room Ensuit. Parking Space. 24 Hours Electricity. 24 Hours Security. ...",gbagada,1,1,0,1,gbagada4,1700000.0,2500000.0,2500000.0,3,37,7,2500000
2754, medina gbagada lagos,5,3,2,3,Just out Good 2 bedrooms flat both rooms ensuite with guest toilet @ Medina estate Gbagada 800k 1yr ... ...,gbagada,0,0,0,0,gbagada3,1000000.0,1300000.0,1200000.0,0,27,5,800000
2755, pedro phase 1 gbagada lagos,8,4,4,4,"This property is located at gbagada at pedro in a serene enviroment, decent modernly built house. just four in the compound, very spacious rooms,well fitted kitchen cabinet,enough parking space,wadrobes, water heaters. price is 2m net. ... ...",gbagada,0,0,0,1,gbagada4,1700000.0,2500000.0,2500000.0,1,37,7,2000000
2756, gbagada extension ifako gbagada gbagada lagos,2,1,1,1,This property is located at gbagada in a decent and secured neighbourhood it's consist of a mini flat for 500k a year rent other charges follow suites. INSPECTION FEE IS 5 K ... ...,gbagada,1,1,0,1,gbagada1,450000.0,500000.0,500000.0,3,8,2,500000
2757, soluyi gbagada lagos,2,1,1,1,This property is located in gbagada in soluyi it's consist of a two bedroom with a toilet and bath. Price tag is 450k maybe 400k can fly. For a year rent other charges follow suites INSPECTION ... ...,gbagada,0,0,0,1,gbagada1,450000.0,500000.0,500000.0,1,8,2,450000
2758, around mobil phase 2 gbagada lagos,3,2,1,2,"Brand New Standard Roomself in a secured environment For office use/commercial only. Spacious, Ensuite, Secured Fenced round with gate, water Security Rent: 650 per annum For Inspection call; Sunday, The Property Concession Company ... Serviced. Furnished. Security Doors. Front Desk Service. Security. Street Lights. Office Supplies. Printing Service. Big Compound. All Room Ensuit. Supermarket Nearby. Parking Space. 24 Hours Security. Restaurants Nearby. ...",gbagada,0,0,0,0,gbagada2,725000.0,1000000.0,829999.9999999998,0,18,3,650000
2759, soluyi gbagada lagos,2,1,1,1,This property is located in gbagada Ina secured an serene environment it's consist of a mini flat spacious in a decent environment. Price tag is 450k a year rent other charges follow suites. INSPECTION FEE IS ... ...,gbagada,0,0,0,1,gbagada1,450000.0,500000.0,500000.0,1,8,2,450000
2760, medina gbagada lagos,4,2,2,2,This property is located in gbagada in an estate secured and serene it's consist of a two bedroom flat price tag is 800k a year rent. Other charges follow suites INSPECTION FEE IS 5K ... ...,gbagada,0,0,0,1,gbagada2,725000.0,1000000.0,829999.9999999998,1,18,3,800000
2761, millenuim ups gbagada lagos,8,4,4,4,This property is located in gbagada in a serene and secured environment it's consist of three bedrooms terrace duplex built to taste just four in the compound. It's so porch!. Price tag is 2.5m per ... ...,gbagada,1,1,0,1,gbagada4,1700000.0,2500000.0,2500000.0,3,37,7,2500000
2762, millennium estate ups gbagada millenuim ups gbagada lagos,7,4,3,4,"Relatively new 3bedroom flat all rooms ensuite with guest toilet, fitted kitchen cabinet, ground floor vacant in a block of 4 flat ... New. Water Treatment. Security Doors. Security. Pop Ceiling. Street Lights. Big Compound. All Room Ensuit. Supermarket Nearby. Parking Space. 24 Hours Electricity. 24 Hours Security. ...",gbagada,0,0,0,0,gbagada4,1700000.0,2500000.0,2500000.0,0,37,7,1500000
2763, soluyi gbagada lagos,6,3,3,3,"This property is located in gbagada at soluyi in a very serene estate with all ensuites rooms,fitted kitchen cabinet.wadrobes,water hearters, ample parking space.Price tag is 1.3m other charges follow suites. Nice apartment ! NOTE : INSPECTION ... ...",gbagada,1,0,0,1,gbagada3,1000000.0,1300000.0,1200000.0,2,27,5,1200000
2764, - ifako gbagada gbagada lagos,4,2,2,2, Relatively new 2bedrm flat upstairs 2t2b a room ensuits pop finishing with prepaid meter at taodak estate ifako gbagada 800k 1 year rent Picture available on request ... ...,gbagada,1,0,0,1,gbagada2,725000.0,1000000.0,829999.9999999998,2,18,3,900000
2765, off ajayi aina in a close ifako gbagada gbagada lagos,7,4,3,4,"Spacious 3 bedrooms duplex common compound, all rooms ensuite with guest toilet, family lounge n POP @ off Ajayi Aina ifako Gbagada 1.5m 1yr ... Security Doors. Security. Pop Ceiling. Street Lights. Big Compound. All Room Ensuit. Supermarket Nearby. 24 Hours Security. ...",gbagada,0,0,0,0,gbagada4,1700000.0,2500000.0,2500000.0,0,37,7,1500000
2766, soluyi gbagada lagos,5,3,2,3,This property is located in gbagada in a secured and Serene environment it's consist of a spacious three bedrooms apartment in a gated fenced compound with enough parking space ... ...,gbagada,0,0,0,0,gbagada3,1000000.0,1300000.0,1200000.0,0,27,5,900000
2767, ifako gbagada gbagada lagos,2,1,1,1,This property is located at gbagada in a serene and secured environment it's consist of a mini flat price 450k per year other charges follow suites INSPECTION FEE IS 5K ... ...,gbagada,0,0,0,1,gbagada1,450000.0,500000.0,500000.0,1,8,2,450000
2768, oke alo millenuim ups gbagada lagos,7,4,3,4,"Brand New 3 Bedroom Duplex in an Estate at Oke Alo Millennium Estate Gbagada. Spacious, Ensuite, Pop, Secured Fenced round with gate, water Security Rent: 3m per unit Corporate Organisation For Inspection call; Sunday, The Property Concession Company ... Serviced. Furnished. New. Boys Quater. Water Treatment. Security Doors. Security. Pop Ceiling. Street Lights. Big Compound. All Room Ensuit. Parking Space. 24 Hours Electricity. 24 Hours Security. ...",gbagada,1,1,0,1,gbagada4,1700000.0,2500000.0,2500000.0,3,37,7,2500000
2769, soluyi gbagada lagos,2,1,1,1,This property is located in gbagada in an estate secured and serene price tag is 500k a year rent other charges follow suites. Just behind a duplex. INSPECTION FEE IS 5 K ... ...,gbagada,1,1,0,1,gbagada1,450000.0,500000.0,500000.0,3,8,2,500000
2770, millenuim ups gbagada lagos,7,4,3,4,Tastefully finished all rooms ensuite 3 Bedroom flat situated at millennium estate gbagada.Rent 2.5m per annum ... New. Security Doors. Restaurants Nearby. Big Compound. Pop Ceiling. Parking Space. Security. Street Lights. Drainage System. Supermarket Nearby. 24 Hours Security. All Room Ensuit. ...,gbagada,1,1,0,1,gbagada4,1700000.0,2500000.0,2500000.0,3,37,7,2500000
2771, millenuim ups gbagada lagos,7,4,3,4,Tastefully finished all rooms ensuite 3 Bedroom flat situated at millennium estate gbagada.Rent 2.5m per annum ... New. Restaurants Nearby. Parking Space. All Room Ensuit. Supermarket Nearby. Pop Ceiling. Drainage System. Security. Security Doors. Street Lights. 24 Hours Security. Big Compound. ...,gbagada,1,1,0,1,gbagada4,1700000.0,2500000.0,2500000.0,3,37,7,2500000
2772, millenuim ups gbagada lagos,8,4,4,4,3 bedroom Flat / Apartment for rent Millenuim/UPS Gbagada Lagos ... Furnished. New. Supermarket Nearby. Street Lights. 24 Hours Security. Security Doors. All Room Ensuit. Security. Big Compound. Parking Space. Pop Ceiling. Restaurants Nearby. ...,gbagada,1,1,0,1,gbagada4,1700000.0,2500000.0,2500000.0,3,37,7,2500000
2773, ifako gbagada gbagada lagos,6,3,3,3,"Renovated 2 bedrooms ground flat 3t 2b with dinning area, water heater n prepaid meter @ OnÃ sanya Ifako Gbagada 1M 1yr ... Renovated. All Room Ensuit. Pop Ceiling. Parking Space. 24 Hours Security. Security Doors. Supermarket Nearby. Restaurants Nearby. ...",gbagada,0,0,0,1,gbagada3,1000000.0,1300000.0,1200000.0,1,27,5,1000000
2774, ifako gbagada gbagada lagos,6,3,3,3,"Renovated 2 bedrooms ground flat 3t 2b with dinning area, water heater n prepaid meter @ OnÃ sanya Ifako Gbagada 1M 1yr ... Renovated. 24 Hours Security. Parking Space. All Room Ensuit. Water Treatment. Big Compound. Pop Ceiling. Restaurants Nearby. Security Doors. Supermarket Nearby. Security. ...",gbagada,0,0,0,1,gbagada3,1000000.0,1300000.0,1200000.0,1,27,5,1000000
2775, millennium estate gbagada millenuim ups gbagada lagos,7,4,3,4,Well finish 3bd flat wth all rm ensuite @ millennium estate gbagada 2.5m ... New. Parking Space. Street Lights. Security Doors. Drainage System. Big Compound. Security. All Room Ensuit. Pop Ceiling. Supermarket Nearby. ...,gbagada,1,1,0,1,gbagada4,1700000.0,2500000.0,2500000.0,3,37,7,2500000
2776, power line soluyi gbagada lagos,5,3,2,3,A very clean 2bedroom @ gbagada soluyi In a gated and fenced compound with car park Wardrobes Kitchen cabinet Prepaid meter In a serene environment ... ...,gbagada,0,0,0,0,gbagada3,1000000.0,1300000.0,1200000.0,0,27,5,700000
2777," off labake street, mayaki oworo, gbagada oworonshoki gbagada lagos",2,1,1,1,"A decent roomself contain, all round tiles, ample parking space, well painted, and newly renovated, in a decent area of Oworo Gbagada, N200K 1yr ... Cheap. Renovated. Dry. Children Play Ground. Parking Space. Street Lights. Supermarket Nearby. Security. Security Doors. All Room Ensuit. 24 Hours Security. Fast Internet. Big Compound. Drainage System. ...",gbagada,0,0,0,0,gbagada1,450000.0,500000.0,500000.0,0,8,2,300000
2778, off dehinde estate ifako gbagada ifako gbagada gbagada lagos,4,2,2,2,"A decent, clean 2bedroom flat, all round tiles,fitted kitchen cabinet, ample parking parking, spacious rooms with wardrobe, clean and borehole water, constant light supply, in a decent area of Gbagaga N500k ... Renovated. Dry. Parking Space. Street Lights. Supermarket Nearby. Security. Security Doors. All Room Ensuit. 24 Hours Security. Big Compound. Drainage System. ...",gbagada,0,0,0,0,gbagada2,725000.0,1000000.0,829999.9999999998,0,18,3,500000
2779," off secretariat street, oworosoki, gbagada oworonshoki gbagada lagos",4,2,2,2,"A decent well finished, miniflat with 2toilets/bath, pop finished, All round tiles, spacious kitchen with big barconey, fitted cabinets, Fence and gated compound, in a decent area of Oworo Gbagada N400K 1yr ... Cheap. Renovated. Dry. Children Play Ground. Parking Space. Street Lights. Supermarket Nearby. Security. Security Doors. All Room Ensuit. 24 Hours Security. Fast Internet. Pop Ceiling. Big Compound. Drainage System. ...",gbagada,0,0,0,0,gbagada2,725000.0,1000000.0,829999.9999999998,0,18,3,500000
2780," off labake street, oworosoki, gbagada, lagos oworonshoki gbagada lagos",2,1,1,1,"A decent clean and spacious Roomself contain, all round tiles, well painted, Spacious Bar coney, big Lobby area, Spacious kitchen with fitted kitchen cabinet, Ample parking space, in a very Quiet and Serene Neighborhood ... Cheap. Renovated. Dry. Parking Space. Street Lights. Security. Security Doors. All Room Ensuit. 24 Hours Security. Fast Internet. Big Compound. Drainage System. ...",gbagada,0,0,0,0,gbagada1,450000.0,500000.0,500000.0,0,8,2,300000
2781, oke alo millenuim ups gbagada lagos,7,4,3,4,Nice 3bd flat @ oke alo all ensuite 1.5m ... Parking Space. All Room Ensuit. Pop Ceiling. Big Compound. ...,gbagada,0,0,0,0,gbagada4,1700000.0,2500000.0,2500000.0,0,37,7,1500000
2782, oworonshoki gbagada lagos,7,4,3,4,"*Just now!!!* *An executive standard & spacious onwer standard 3bedroom flat behind a duplex , studed security doors, pop, cabinets & wardrobe, upstairs, all rooms ensuite + guest toilet with car park 1million per annum* *Location: Oworo, ... Parking Space. Supermarket Nearby. Security. Security Doors. All Room Ensuit. Pop Ceiling. Big Compound. Drainage System. ...",gbagada,0,0,0,0,gbagada4,1700000.0,2500000.0,2500000.0,0,37,7,1000000
2783, ifako gbagada ifako gbagada gbagada lagos,7,4,3,4,"FRESH LETTING: THREE BEDROOM FIRST FLOOR FLAT IN A QUIET CLOSE IN IFAKO GBAGADA LAGOS. FEATURES: SPACIOUS LIVING ROOM, MASTER BEDROOM ENSUITE, TOILET AND BATH ASKING RENT :N1.3m buh 1.2m can fly yoruba client ... Parking Space. All Room Ensuit. Big Compound. Drainage System. ...",gbagada,0,0,0,0,gbagada4,1700000.0,2500000.0,2500000.0,0,37,7,1300000
2784, gbagada phase one extension phase 1 gbagada lagos,5,3,2,3,"An Executive Super Standard Luxury Serviced 2bd Flat @ Gbagada Phs1 Extension, Lagos, with a fitted wardrobes and kitchen cabinets n cupboard, it also comes with an Inverter and two solid batteries, and standard sound ... Serviced. Parking Space. Street Lights. Supermarket Nearby. Security. Security Doors. All Room Ensuit. Pop Ceiling. Big Compound. Drainage System. ...",gbagada,0,0,0,1,gbagada3,1000000.0,1300000.0,1200000.0,1,27,5,1000000
2785, chevron soluyi gbagada lagos,7,4,3,4,Decent 3 bedrooms ground flat all rooms ensuite with guest toilet in a decent close by Chevron Sholuyi Gbagada 1.2m 1 yr *Stay safe* ???? ?????????? ... All Room Ensuit. Pop Ceiling. Big Compound. ...,gbagada,0,0,0,0,gbagada4,1700000.0,2500000.0,2500000.0,0,37,7,1200000
2786, - gbagada lagos,2,1,1,1,"Mini flat bungalow separated with store and wardrobes @ Adekunle Oshomo by Chevron staff club and clinic, Gbagada 700k per year rent ... Renovated. Parking Space. Water Treatment. Security. Security Doors. Drainage System. ...",gbagada,1,1,1,1,gbagada1,450000.0,500000.0,500000.0,4,8,2,700000
2787, glory estate ifako gbagada gbagada lagos,7,4,3,4,*TO LET* Newly built 3Bedroom Duplex with A Room Bq in glory estate gbagada in a secured and serene environment *2living room & guest toilet.* *All rooms Ensuites* *Furnished kitchen* *Boys quarter* *Enough parking space* *Personal prepaid Meter* *Remote control gate with separate ... Parking Space. Security Doors. All Room Ensuit. Pop Ceiling. Boys Quater. Big Compound. ...,gbagada,1,1,0,1,gbagada4,1700000.0,2500000.0,2500000.0,3,37,7,2500000
2788, - gbagada lagos,3,2,1,2,Very lovely and spacious miniflat in Gbagada N800k for a year N750k for a year and half N700k for 2 years ... Renovated. Dry. Parking Space. Water Treatment. Supermarket Nearby. Security. Security Doors. All Room Ensuit. Pop Ceiling. Restaurants Nearby. Big Compound. Drainage System. ...,gbagada,0,0,0,1,gbagada2,725000.0,1000000.0,829999.9999999998,1,18,3,800000
2789, medina gbagada lagos,5,3,2,3,Just out To Let 2bedroom flat at medina estate gbagada all rooms ensuite with visitors toilet 800k ... Parking Space. Security. Security Doors. All Room Ensuit. Big Compound. Drainage System. ...,gbagada,0,0,0,0,gbagada3,1000000.0,1300000.0,1200000.0,0,27,5,800000
2790, medina estate gbagada medina gbagada lagos,9,5,4,5,"*Just Out 4bedroom terraced duplex with 1 room boys quarter, all room ensuite plus guest toilet, only 2 people to share compound, located on a tarred Street at Medina Estate, Gbagada. *Rent:* 2.5m asking (slightly ... Parking Space. Street Lights. Security. Security Doors. All Room Ensuit. Pop Ceiling. Boys Quater. Big Compound. ...",gbagada,0,0,0,0,gbagada5,3000000.0,3000000.0,3000000.0,0,43,8,2500000
2791, oke alo millennium estate gbagada millenuim ups gbagada lagos,7,4,3,4,"*TO LET* *MILLENIUM ESTATE, OKE ALO* 6 nos brand new, tastefully finished and very spacious 3b/r flats *@Adeyeye Street*. (All rooms ensuite, ample parking). *2.5M P.A* ... New. Children Play Ground. Parking Space. Security. Security Doors. All Room Ensuit. Pop Ceiling. Big Compound. Drainage System. ...",gbagada,1,1,0,1,gbagada4,1700000.0,2500000.0,2500000.0,3,37,7,2500000
2792, shadia estate soluyi gbagada lagos,4,2,2,2,"Decent 2 bedrooms bungalow BQ, 2t 2b, a room ensuite all tiled with water heater wardrobes kitchen cabinets n prepaid meter, 3 occupants to share compound @ Shadia, by Chevron Sholuyi Gbagada. 1M PA Working class ... Parking Space. Security. Security Doors. Big Compound. ...",gbagada,1,1,1,1,gbagada2,725000.0,1000000.0,829999.9999999998,4,18,3,1000000
2793, medina gbagada lagos,5,3,2,3,"Decent serviced 2 bedrooms up flat all rooms ensuite with guest toilet, fitted with air conditioners n 100kv Generator @ Medina Estate, Gbagada. Rent: 1m Service charge: 250k per annum. Excluding diesel. Refundable Deposit: 200k. ... Serviced. Children Play Ground. Parking Space. Security. Security Doors. All Room Ensuit. Pop Ceiling. Big Compound. ...",gbagada,0,0,0,1,gbagada3,1000000.0,1300000.0,1200000.0,1,27,5,1000000
2794," off williams street, gbagada ifako gbagada gbagada lagos",6,3,3,3,"A Relatively Lovely and Luxurious 2bedroom flat, with all round Spanish tiles, Pop finishing, Fitted kitchen Cabinets, All bathroom has water heater, and kitchen has water heater, Chanderlayer lighting, fitted, all modern interior fitting available, ... Furnished. Dry. Cctv Cameras. Children Play Ground. Parking Space. Street Lights. Supermarket Nearby. Security. Security Doors. All Room Ensuit. 24 Hours Security. Pop Ceiling. Big Compound. Drainage System. ...",gbagada,0,0,0,0,gbagada3,1000000.0,1300000.0,1200000.0,0,27,5,900000
2795, atunrase atunrase medina gbagada lagos,5,3,2,3,"*FRESH* Relatively new 2 bedrooms ground flat 3t 2b, 4 tenants to share compound with, kitchen cabs, wardrobes n prepaid meter @ Atunrase estate Gbagada 1m PA ... Parking Space. Street Lights. Supermarket Nearby. Security. Security Doors. All Room Ensuit. Pop Ceiling. Big Compound. Drainage System. ...",gbagada,0,0,0,1,gbagada3,1000000.0,1300000.0,1200000.0,1,27,5,1000000
2796, sawmill ifako gbagada gbagada lagos,7,4,3,4,"*Just now* Spacious 3 bedrooms up n ground flats all rooms ensuite with guest toilet, water heater, kitchen cabinets, wardrobes n prepaid meter @ Sawmill Gbagada 1.2 n 1.1m respectively *Pix on request* ... Parking Space. Security. Security Doors. All Room Ensuit. Big Compound. Drainage System. ...",gbagada,0,0,0,0,gbagada4,1700000.0,2500000.0,2500000.0,0,37,7,1200000
2797, pefro gbagada lagos,6,4,2,4,Nice 2bd off pedro rd in a gated close wth 2t 2b upstairs 1.2m asking ... Parking Space. Street Lights. Security. Security Doors. All Room Ensuit. Pop Ceiling. Big Compound. Drainage System. ...,gbagada,0,0,0,0,gbagada4,1700000.0,2500000.0,2500000.0,0,37,7,1200000
2798, millenuim ups gbagada lagos,7,4,3,4,6 nos of brand new 3bd @ oke alo gbagada 2.5m 1yr ... New. Parking Space. Supermarket Nearby. Security. Security Doors. All Room Ensuit. Pop Ceiling. Big Compound. Drainage System. ...,gbagada,1,1,0,1,gbagada4,1700000.0,2500000.0,2500000.0,3,37,7,2500000
2799, josadat estate soluyi gbagada lagos,7,4,3,4,"Very Spacious 3 bedrooms ground flat, all rooms ensuite with guest toilet, block of 4 @ JOSODAT Sholuyi Gbagada 1.5m 1yr Slightly negotiable *Pix available* ... Parking Space. Security Doors. All Room Ensuit. Big Compound. Drainage System. ...",gbagada,0,0,0,0,gbagada4,1700000.0,2500000.0,2500000.0,0,37,7,1500000
2800, gbagada lagos,6,4,2,4,3 bedroom Flat for rent in Millenium Estate Gbagada (Oke Alo) N2.5m per year Very lovely. Pay and pack in ... Renovated. Furnished. Dry. Parking Space. Jacuzzi. Water Treatment. Security. Security Doors. All Room Ensuit. 24 Hours Security. Pop Ceiling. Restaurants Nearby. Drainage System. ...,gbagada,1,1,0,1,gbagada4,1700000.0,2500000.0,2500000.0,3,37,7,2500000
2801, phase 2 gbagada lagos,9,5,4,5,"*FRESH* Newly built 2 nos 4 bedrooms terraced duplex all ensuite with guest toilet, wardrobes n kitchen cabinets , water heater n cubicle shower @ Gbagada phase 2 estate 3M PA *Pics on request* Residential or ... Children Play Ground. Parking Space. Street Lights. Supermarket Nearby. Security. Security Doors. All Room Ensuit. Pop Ceiling. Big Compound. Drainage System. ...",gbagada,1,1,0,1,gbagada5,3000000.0,3000000.0,3000000.0,3,43,8,3000000
2802," off secretariat, street, oworosoki, gbagada oworonshoki gbagada lagos",4,2,2,2,"A decent miniflat, with 2toilets/bath, all round tiles, pop finishing, fitted kitchen cabinet, And kitchen has Store, and kitchen is very big, Ample Parking Space, well renovated with good painting, in a serene neighborhood at ... Cheap. Renovated. Dry. Parking Space. Street Lights. Supermarket Nearby. Security. Security Doors. All Room Ensuit. 24 Hours Security. Fast Internet. Pop Ceiling. Big Compound. Drainage System. ...",gbagada,0,0,0,0,gbagada2,725000.0,1000000.0,829999.9999999998,0,18,3,500000
2803, peace estate soluyi gbagada lagos,2,1,1,1,Just out; spacious mini flat all tiled fitted kitchen prepaid meter very clean self-compound at peace estate sholuyi gbagada#400 pics available by request ... ...,gbagada,0,0,0,0,gbagada1,450000.0,500000.0,500000.0,0,8,2,400000
2804," off zainab crescent, medina estate gbagada atunrase medina gbagada lagos",7,4,3,4,"A Luxurious well finished 3bedroom flat, JUST 2TENANTS IN D COMPOUND all rooms ensuite, Pop finished, lovely fitted kitchen cabinets, separate dining section, Ample parking space, all modern interior fitting available in a serene estate ... Renovated. Children Play Ground. Parking Space. Supermarket Nearby. Security. Security Doors. All Room Ensuit. 24 Hours Security. Pop Ceiling. Big Compound. ...",gbagada,0,0,0,0,gbagada4,1700000.0,2500000.0,2500000.0,0,37,7,1600000
2805, millennium estate gbagada millenuim ups gbagada lagos,8,5,3,5,New built 4nos of 3bedroom flat at Okealo millennium estate Gbagada Rent: Down 2.5million up 2.7million Nb: prefers a corporate tenant that can take all four or individuals that have a good corporate job. ... New. Parking Space. Security. Security Doors. All Room Ensuit. 24 Hours Security. Pop Ceiling. Big Compound. Drainage System. ...,gbagada,0,0,0,0,gbagada5,3000000.0,3000000.0,3000000.0,0,43,8,2700000
2806, glory estate ifako gbagada gbagada lagos,7,4,3,4,"*Newly built 3bedrooms terrace duplex in glory estate gbagada in a secured and serene environment, 2living room & guest toilet. All rooms Ensuites, Furnished kitchen, Boys quarter, Enough parking space, Remote control gate with ... New. Parking Space. Street Lights. Supermarket Nearby. Security. Security Doors. All Room Ensuit. Pop Ceiling. Restaurants Nearby. Big Compound. Drainage System. ...",gbagada,0,0,0,1,gbagada4,1700000.0,2500000.0,2500000.0,1,37,7,2000000
2807, powerline soluyi gbagada soluyi gbagada lagos,5,3,2,3,Portable 2bedroom flat all rooms ensuite with guest toilet and wardrobe fitted kitchen and cabinet all tiled prepaid meter treated water upstairs and downstairs available@ powerline sholuyi gbagada #700 pics available by request ... Parking Space. Security. Security Doors. All Room Ensuit. ...,gbagada,0,0,0,0,gbagada3,1000000.0,1300000.0,1200000.0,0,27,5,700000
2808," off adio street, gbagada, newgarage, gbagada lagos new garage gbagada lagos",7,4,3,4,"A clean well refurbished 3bedroom flat, all rooms ensuite, with visitors toilet, All round tiles, separate dining section, well painted, and fitted kitchen cabinet, Ample parking space, all rooms have wardrobes, and all bathroom has ... Renovated. Dry. Parking Space. Street Lights. Security Doors. All Room Ensuit. 24 Hours Security. Big Compound. Drainage System. ...",gbagada,0,0,0,0,gbagada4,1700000.0,2500000.0,2500000.0,0,37,7,1000000
2809, ifako gbagada gbagada lagos,5,3,2,3,"Renovated 2 bedrooms ground flat 3t 2b with dinning area, water heater n prepaid meter @ OnÃ sanya Ifako Gbagada 1M 1yr *Pics available* ... Renovated. Parking Space. Drainage System. Children Play Ground. Security. Security Doors. Big Compound. All Room Ensuit. Pop Ceiling. ...",gbagada,0,0,0,1,gbagada3,1000000.0,1300000.0,1200000.0,1,27,5,1000000
2810, soluyi gbagada lagos,5,3,2,3,3 bedroom Flat / Apartment for rent Soluyi Gbagada Lagos ... New. Renovated. Parking Space. Water Treatment. Supermarket Nearby. Street Lights. Security. Restaurants Nearby. Security Doors. All Room Ensuit. Pop Ceiling. 24 Hours Security. ...,gbagada,0,0,0,1,gbagada3,1000000.0,1300000.0,1200000.0,1,27,5,1000000
2811, ifako gbagada gbagada lagos,5,3,2,3,"Renovated 2 bedrooms ground flat 3t 2b with dinning area, water heater n prepaid meter @ OnÃ sanya Ifako Gbagada 1M 1yr ... ...",gbagada,0,0,0,1,gbagada3,1000000.0,1300000.0,1200000.0,1,27,5,1000000
2812, soluyi gbagada lagos,7,4,3,4,3 bedroom Flat / Apartment for rent Soluyi Gbagada Lagos ... New. Renovated. Security. Supermarket Nearby. 24 Hours Security. Street Lights. All Room Ensuit. Restaurants Nearby. Parking Space. Water Treatment. Security Doors. Pop Ceiling. ...,gbagada,0,0,0,0,gbagada4,1700000.0,2500000.0,2500000.0,0,37,7,1200000
2813, medina medina gbagada lagos,6,3,3,3,Duplex for rent at Medina having a room down stairs and a visitors toilet down and kitchen upstairs and also large rooms and wardrobe ... Renovated. Old. ...,gbagada,1,1,1,1,gbagada3,1000000.0,1300000.0,1200000.0,4,27,5,1500000
2814, sholuyi soluyi gbagada lagos,4,2,2,2,Just out; 3bedroom flat with 2t2b one room ensuite spacious rooms wardrobe prepaid meter ground floor fenced with car park at powerline sholuyi gbagada #700 pics on request ... Renovated. ...,gbagada,0,0,0,0,gbagada2,725000.0,1000000.0,829999.9999999998,0,18,3,700000
2815, gbagada road phase 2 gbagada lagos,2,1,1,1,Nice miniflat @ gbagada rd 500k 1yr ... New. ...,gbagada,1,1,0,1,gbagada1,450000.0,500000.0,500000.0,3,8,2,500000
2816, poopola soluyi gbagada lagos,2,1,1,1,mini flat for rent at sholuyi a bq fenced and gated with car park all tiles and it has prepaid ... Old. Renovated. Security. Street Lights. Parking Space. Water Treatment. ...,gbagada,0,0,0,1,gbagada1,450000.0,500000.0,500000.0,1,8,2,450000
2817, millenuim ups gbagada lagos,5,3,2,3,A serviced 2 bed room flat with fitted ac and gas cooker 1.8m and service charge 435k at Millenium Estate gbagada Picture available ... Serviced. ...,gbagada,1,1,1,1,gbagada3,1000000.0,1300000.0,1200000.0,4,27,5,1800000
2818, soluyi gbagada lagos,5,3,2,3,Portable 2bedroom flat all rooms ensuite with guest toilet and wardrobe fitted kitchen and cabinet all tiled prepaid meter treated water upstairs and downstairs available@ powerline sholuyi gbagada #700 ... ...,gbagada,0,0,0,0,gbagada3,1000000.0,1300000.0,1200000.0,0,27,5,700000
2819, phase 2 gbagada lagos,2,1,1,1,Decent and clean mini flat at gbagada phase 2 extension for 500k a year rent ... ...,gbagada,1,1,0,1,gbagada1,450000.0,500000.0,500000.0,3,8,2,500000
2820, soluyi gbagada lagos,5,3,2,3,2 bedroom Flat / Apartment for rent Soluyi Gbagada Lagos ... New. Renovated. Security. Supermarket Nearby. 24 Hours Security. Street Lights. All Room Ensuit. Restaurants Nearby. Parking Space. Water Treatment. Security Doors. Pop Ceiling. ...,gbagada,0,0,0,0,gbagada3,1000000.0,1300000.0,1200000.0,0,27,5,700000
2821, gbagada lagos,8,4,4,4,"ewly built 3bedrooms @gbagada 1.5m in a senere environment dealing wit d mandate 4 more lift Very tasteful, gated, round with fence, security incline area, clean environment, enormous car park, good tap water and borehole, ... New. Supermarket Nearby. 24 Hours Electricity. 24 Hours Security. Big Compound. ...",gbagada,0,0,0,0,gbagada4,1700000.0,2500000.0,2500000.0,0,37,7,1500000
2822," millennium estate, millenuim ups gbagada lagos",7,4,3,4,A well finished Relatively newly built 3 bedroom flat with all rooms en-suite - guest toilet - POP ceilings - kitchen cabinet - water heaters - wardrobes - interlocking pavement - spacious rooms and living room - big compound - borehole - parking space - good ... ...,gbagada,0,0,0,0,gbagada4,1700000.0,2500000.0,2500000.0,0,37,7,1500000
2823, gbagada lagos,6,3,3,3,To let 3 bedrooms all ensuit close to Ifako Gbagada near d express for just 600k per annum. ... ...,gbagada,0,0,0,0,gbagada3,1000000.0,1300000.0,1200000.0,0,27,5,700000
2824, gbagada lagos,2,1,1,1,"miniflat at gbagada for rent. 450k, agency 60k, agreement 60k, caution 50k ... ...",gbagada,0,0,0,1,gbagada1,450000.0,500000.0,500000.0,1,8,2,450000
2825, gbagada lagos,6,3,3,3,A decent 3 bedroom flat for rent in Gbagada ... ...,gbagada,1,1,1,1,gbagada3,1000000.0,1300000.0,1200000.0,4,27,5,1500000
2826, charlie boy axis gbagada lagos,2,1,1,1,A very clean miniflat @ gbagada Charlie boy axis 500k annual rent Easily accessible to the island ... ...,gbagada,1,1,0,1,gbagada1,450000.0,500000.0,500000.0,3,8,2,500000
2827, gbagada lagos,6,3,3,3,"3 bedrooms up flat, 3 toilet 3 bathrooms, ensuite POP, 3 tenants to share compound in Gbagada 1.2m 1yr ... ...",gbagada,1,0,0,1,gbagada3,1000000.0,1300000.0,1200000.0,2,27,5,1200000
2828, soluyi gbagada lagos,4,2,2,2,Just out; 3bedroom flat with 2t2b one room ensuite spacious rooms wardrobe prepaid meter ground floor fenced with car park at powerline sholuyi gbagada #700 pics on request ... ...,gbagada,0,0,0,0,gbagada2,725000.0,1000000.0,829999.9999999998,0,18,3,700000
2829, medina gbagada lagos,5,3,2,3,2 bedroom Flat / Apartment for rent Medina Gbagada Lagos ... New. Renovated. Water Treatment. Security. All Room Ensuit. Parking Space. Pop Ceiling. 24 Hours Security. Street Lights. Restaurants Nearby. Printing Service. Security Doors. Supermarket Nearby. ...,gbagada,0,0,0,0,gbagada3,1000000.0,1300000.0,1200000.0,0,27,5,800000
2830, gbagada phase 2 phase 2 gbagada lagos,2,1,1,1,To let Brand new miniflat in Gbagada phase2 Rent :500k Service charge:50k ... New. Water Treatment. Security. All Room Ensuit. Parking Space. 24 Hours Security. Drainage System. Street Lights. Big Compound. Security Doors. ...,gbagada,1,1,0,1,gbagada1,450000.0,500000.0,500000.0,3,8,2,500000
2831, yetunde brown ifako gbagada gbagada lagos,2,1,1,1,A big room self I have the video and is all tiles and has water heater big size kitchen and pop ... New. ...,gbagada,1,1,0,1,gbagada1,450000.0,500000.0,500000.0,3,8,2,500000
2832, ifako gbagada gbagada lagos,2,1,1,1,"A Very Cute And Compact Mini Flat @ Ifako-Gbagada, Lagos, with 1toilet and bath, in a block of flats, ground floor, with Pre-Paid Metre, fenced round with gate and parking space, situated in a ... ...",gbagada,0,0,0,1,gbagada1,450000.0,500000.0,500000.0,1,8,2,450000
2833, phase 2 gbagada lagos,7,4,3,4,"A Decent and spacious 3bd flat @ Gbagada phase 2 extension, all rooms en-suite with a visitors toilet, upstairs, fenced round with gate and parking space, #900k x a year. ... ...",gbagada,0,0,0,0,gbagada4,1700000.0,2500000.0,2500000.0,0,37,7,1000000
2834, estaport avenue soluyi gbagada lagos,2,1,1,1,A spacious and Decent mini flat In a strategic area of sholuyi gbagada tiled road serene environment and good proximity for more info call or Whatsapp me ... Dry. Renovated. Furnished. Big Compound. Parking Space. Security. ...,gbagada,1,1,0,1,gbagada1,450000.0,500000.0,500000.0,3,8,2,500000
2835, josodat estate soluyi gbagada lagos,10,5,5,5,A well maintained 3 bedroom duplex with roomself bq at josodat estate sholuyi gbagada with all rooms tiles pop fitted kitchen self compound secure estate for more info call or Whatsapp me ... Dry. Renovated. Big Compound. Pop Ceiling. All Room Ensuit. Parking Space. Security Doors. Security. ...,gbagada,0,0,0,0,gbagada5,3000000.0,3000000.0,3000000.0,0,43,8,2500000
2836, soluyi gbagada lagos,8,4,4,4,4 bedroom Flat / Apartment for rent Soluyi Gbagada Lagos ... Renovated. New. Printing Service. Security. Parking Space. 24 Hours Security. Pop Ceiling. All Room Ensuit. Supermarket Nearby. Security Doors. Water Treatment. Street Lights. Restaurants Nearby. ...,gbagada,0,0,0,0,gbagada4,1700000.0,2500000.0,2500000.0,0,37,7,1500000
2837, soluyi gbagada lagos,6,3,3,3,"3 bedrooms up flat, 3t 3b, ensuite POP, 3 tenants to share compound @ Sholuyi Gbagada 1.2m 1yr ... ...",gbagada,1,0,0,1,gbagada3,1000000.0,1300000.0,1200000.0,2,27,5,1200000
2838, jimoh bajulaye ifako gbagada gbagada lagos,6,3,3,3,3bedroom flat at ifako gbagada big size room just three tenant in the compound fenced and gated with security ... Renovated. Big Compound. ...,gbagada,1,0,0,1,gbagada3,1000000.0,1300000.0,1200000.0,2,27,5,1200000
2839, phase 2 gbagada lagos,9,5,4,5,"*FRESH* Newly built 2 nos 4 bedrooms terraced duplex all ensuite with guest toilet, wardrobes n kitchen cabinets , water heater n cubicle shower @ Gbagada phase 2 estate 3M PA Residential or commercial ... ...",gbagada,1,1,0,1,gbagada5,3000000.0,3000000.0,3000000.0,3,43,8,3000000
2840, akinwunmi street ifako gbagada gbagada lagos,3,2,1,2,"Mini flat at ifako gbagada Lagos fenced and gated,all tiles ... Renovated. ...",gbagada,0,0,0,0,gbagada2,725000.0,1000000.0,829999.9999999998,0,18,3,500000
2841, ester port avenue soluyi gbagada lagos,2,1,1,1,A big size mini flat upstairs and well designed and accessible to the road with car park ... Furnished. Cheap. Old. Renovated. Dry. Big Compound. Parking Space. ...,gbagada,1,1,0,1,gbagada1,450000.0,500000.0,500000.0,3,8,2,500000
2842, soluyi gbagada lagos,5,3,2,3,"Portable 2bedroom flat all rooms ensuite with guest toilet and wardrobe fitted kitchen and cabinet, all tiled, prepaid meter, treated water @ powerline sholuyi gbagada Rent: #700,000 p/a ... Renovated. Security. All Room Ensuit. Supermarket Nearby. Restaurants Nearby. Security Doors. Parking Space. 24 Hours Security. Drainage System. Water Treatment. ...",gbagada,0,0,0,0,gbagada3,1000000.0,1300000.0,1200000.0,0,27,5,700000
2843, millenuim ups gbagada lagos,6,3,3,3,Located at @ oke alo all ensuite 1.5m ... Security. All Room Ensuit. Big Compound. Supermarket Nearby. Restaurants Nearby. Security Doors. Parking Space. Pop Ceiling. 24 Hours Security. Drainage System. Street Lights. ...,gbagada,1,1,1,1,gbagada3,1000000.0,1300000.0,1200000.0,4,27,5,1500000
2844, gbagada ifako gbagada gbagada lagos,2,1,1,1,"Itâ€™s a newly built apartment of more than 10 Units of roomself contain. (Standard Room, Toilet and Kitchen) It is 98% completed. Accessible to the road we are selling to does who desire to invest in real estate ... New. Big Compound. Security Doors. 24 Hours Electricity. 24 Hours Security. Street Lights. ...",gbagada,1,1,1,1,gbagada1,450000.0,500000.0,500000.0,4,8,2,700000
2845, soluyi gbagada lagos,6,3,3,3, A Portable 2bedroom flat all rooms ensuite with guest toilet and wardrobe fitted kitchen and cabinet all tiled prepaid meter treated water upstairs and downstairs available@ powerline sholuyi gbagada #700 ... Security. All Room Ensuit. Big Compound. Supermarket Nearby. Restaurants Nearby. Security Doors. Parking Space. 24 Hours Security. ...,gbagada,0,0,0,0,gbagada3,1000000.0,1300000.0,1200000.0,0,27,5,700000
2846, .. soluyi gbagada lagos,2,1,1,1,1 bedroom mini flat Self Contain Flat / Apartment for rent Soluyi Gbagada Lagos ... New. Renovated. Security. Supermarket Nearby. Restaurants Nearby. Security Doors. Parking Space. Pop Ceiling. 24 Hours Security. Street Lights. ...,gbagada,0,0,0,0,gbagada1,450000.0,500000.0,500000.0,0,8,2,400000
2847, phase 1 gbagada lagos,4,2,2,2,Nice 2bd off pedro rd in a gated close wth 2t 2b upstairs 1.2m askn ... ...,gbagada,1,1,1,1,gbagada2,725000.0,1000000.0,829999.9999999998,4,18,3,1200000
2848, .. phase 2 gbagada lagos,5,3,2,3,2 bedroom Flat / Apartment for rent Phase 2 Gbagada Lagos ... New. Security. All Room Ensuit. Supermarket Nearby. Restaurants Nearby. Security Doors. Parking Space. Pop Ceiling. 24 Hours Security. Street Lights. ...,gbagada,0,0,0,1,gbagada3,1000000.0,1300000.0,1200000.0,1,27,5,1000000
2849, soluyi soluyi gbagada lagos,5,3,2,3,2 bedroom Flat / Apartment for rent Soluyi Soluyi Gbagada Lagos ... Security. All Room Ensuit. Big Compound. Supermarket Nearby. Restaurants Nearby. Security Doors. Parking Space. 24 Hours Electricity. 24 Hours Security. Street Lights. ...,gbagada,0,0,0,0,gbagada3,1000000.0,1300000.0,1200000.0,0,27,5,700000
2850, .. ifako gbagada gbagada lagos,6,3,3,3,*FRESH* Relatively new 2 bedrooms up flat both rooms ensuite with guest toilet @ Sawmill 900k 1yr Caution deposit 100k ... Security. All Room Ensuit. Big Compound. Supermarket Nearby. Security Doors. Parking Space. Pop Ceiling. 24 Hours Security. ...,gbagada,0,0,0,0,gbagada3,1000000.0,1300000.0,1200000.0,0,27,5,900000
2851, new garage gbagada lagos,4,2,2,2,2bedroom flat for rent at New Garage Gbagada for N750k x 1year payment ... ...,gbagada,0,0,0,1,gbagada2,725000.0,1000000.0,829999.9999999998,1,18,3,750000
2852, millennium estate gbagada millenuim ups gbagada lagos,7,4,3,4,Tastefully finished ensuite 4nos 3bedeoom flat. New built 4nos of 3bedroom flat at Okealo millennium estate Gbagada.Property is located in a Serene neighborhood with 24hrs security with good road network to any part of Lagos metropolis. ... New. Security. All Room Ensuit. Big Compound. Security Doors. Parking Space. Pop Ceiling. 24 Hours Security. Drainage System. Street Lights. ...,gbagada,1,1,0,1,gbagada4,1700000.0,2500000.0,2500000.0,3,37,7,2500000
2853, - phase 1 gbagada lagos,7,4,3,4,*FRESH* Renovated 3 bedrooms ground flat 4t 3b 2/rooms ensuite off Oguntona Gbagada phase 1 estate 1M 1 yr ... ...,gbagada,0,0,0,0,gbagada4,1700000.0,2500000.0,2500000.0,0,37,7,1000000
2854, estate medina gbagada lagos,2,1,1,1,Roomself at Medina estate upstairs neat and hot renting now why stock last ... Renovated. Big Compound. ...,gbagada,0,0,0,0,gbagada1,450000.0,500000.0,500000.0,0,8,2,300000
2855, millenuim ups gbagada lagos,7,4,3,4,"Newly built tastefully finished very spacious all rooms en-suite 3Bedroom flat located at Millennium Estate, Gbadaga has car park space. * ... New. Security. All Room Ensuit. Big Compound. Supermarket Nearby. Restaurants Nearby. Security Doors. Pop Ceiling. 24 Hours Security. Drainage System. Street Lights. ...",gbagada,1,1,0,1,gbagada4,1700000.0,2500000.0,2500000.0,3,37,7,2500000
2856, gbagada oke alo lagos. ifako gbagada gbagada lagos,6,3,3,3,"Standard brand new 3bedrooms flat at Gbagada oke alo, having all rooms ensuite, pop ceiling, wardrobes, kitchen cabinet with a very big compound. (Agt Abass). ... New. Security. All Room Ensuit. Big Compound. Supermarket Nearby. Security Doors. Parking Space. 24 Hours Electricity. Pop Ceiling. 24 Hours Security. Street Lights. Water Treatment. ...",gbagada,1,1,1,1,gbagada3,1000000.0,1300000.0,1200000.0,4,27,5,1800000
2857, atiku street soluyi gbagada lagos,4,2,2,2,A master room all tiles and pop and standard kitchen with good facilities just three and a compound ... New. Furnished. Security. Printing Service. ...,gbagada,0,0,0,0,gbagada2,725000.0,1000000.0,829999.9999999998,0,18,3,650000
2858, medina gbagada lagos,5,3,2,3,"Decent serviced 2 bedrooms up flat all rooms ensuite with guest toilet, fitted with air conditioners n 100kv Generator @ Medina Estate, Gbagada. Rent: 1m Service charge: 250k per annum. Excluding diesel. Refundable Deposit: 200k. ... Serviced. ...",gbagada,0,0,0,1,gbagada3,1000000.0,1300000.0,1200000.0,1,27,5,1000000
2859, yetunde brown ifako gbagada gbagada lagos,5,3,2,3,a newly built 2bedroom flat all ensuite all tiles with car park block of four ... New. Furnished. All Room Ensuit. ...,gbagada,0,0,0,1,gbagada3,1000000.0,1300000.0,1200000.0,1,27,5,1100000
2860, deeper life axis ifako gbagada gbagada lagos,4,2,2,2,1 bedroom mini flat Mini flat Flat / Apartment for rent Deeper life axis Ifako-gbagada Gbagada Lagos ... Renovated. Security. All Room Ensuit. Supermarket Nearby. 24 Hours Security. Street Lights. ...,gbagada,0,0,0,0,gbagada2,725000.0,1000000.0,829999.9999999998,0,18,3,550000
2861, millenuim ups gbagada lagos,7,4,3,4,Decent 3 bedrooms ground flat all rooms ensuite with guest toilet @ Millennium estate Gbagada 1.5m 1yr and just 4 in the compound ... All Room Ensuit. ...,gbagada,0,0,0,0,gbagada4,1700000.0,2500000.0,2500000.0,0,37,7,1500000
2862, new garage new garage gbagada lagos,5,3,2,3,2 bedroom Flat / Apartment for rent New garage New garage Gbagada Lagos ... New. Security. All Room Ensuit. Big Compound. Supermarket Nearby. Restaurants Nearby. Security Doors. 24 Hours Electricity. 24 Hours Security. Street Lights. ...,gbagada,0,0,0,0,gbagada3,1000000.0,1300000.0,1200000.0,0,27,5,750000
2863, soluyi gbagada lagos,5,3,2,3,2 bedroom Flat / Apartment for rent Soluyi Gbagada Lagos ... New. Renovated. Security. All Room Ensuit. Supermarket Nearby. Restaurants Nearby. Security Doors. Parking Space. Pop Ceiling. 24 Hours Security. Street Lights. Water Treatment. ...,gbagada,0,0,0,0,gbagada3,1000000.0,1300000.0,1200000.0,0,27,5,700000
2864, after powerline bus stop soluyi gbagada lagos,5,3,2,3,"Six in a compound. The flat is situated upstairs. Agreement is 100, agency is 100 and caution is 50. To inspect, please call: [redacted], [redacted] or Whatsapp [redacted] ... Furnished. Dry. Security. All Room Ensuit. Big Compound. Parking Space. Pop Ceiling. ...",gbagada,0,0,0,0,gbagada3,1000000.0,1300000.0,1200000.0,0,27,5,700000
2865, atunrase medina gbagada lagos,4,2,2,2,"A very clean 2bedroom @ medina estate Decent serviced 2 bedrooms up flat all rooms ensuite with guest toilet, fitted with air conditioners n 100kv Generator @ Medina Estate, Gbagada. Rent: 1m Service charge: 250k per annum. ... ...",gbagada,1,1,1,1,gbagada2,725000.0,1000000.0,829999.9999999998,4,18,3,1000000
2866, millenuim ups gbagada lagos,6,3,3,3,"Decent and spacious 3 bedroom Flat located in millennium Estate , Gbadaga. Rent 1.5m per annum. ... Security. All Room Ensuit. Big Compound. Supermarket Nearby. Restaurants Nearby. Security Doors. Parking Space. Pop Ceiling. 24 Hours Security. Drainage System. Street Lights. Church Nearby. ...",gbagada,1,1,1,1,gbagada3,1000000.0,1300000.0,1200000.0,4,27,5,1500000
2867, millennium estate millenuim ups gbagada lagos,7,4,3,4,3bedroom flat at millennium estate gbagada Lagos all room ensuite ... New. Furnished. All Room Ensuit. Big Compound. ...,gbagada,0,0,0,0,gbagada4,1700000.0,2500000.0,2500000.0,0,37,7,1500000
2868, phase 1 gbagada lagos,6,3,3,3,"An Executive Super Standard Luxury Serviced 2bd Flat @ Gbagada Phs1 Extension, Lagos, with a fitted wardrobes and kitchen cabinets n cupboard, it also comes with an Inverter and two solid batteries, and standard sound ... Security. All Room Ensuit. Big Compound. Supermarket Nearby. Restaurants Nearby. Security Doors. Parking Space. Pop Ceiling. ...",gbagada,0,0,0,1,gbagada3,1000000.0,1300000.0,1200000.0,1,27,5,1000000
2869, millenuim ups gbagada lagos,6,3,3,3,"VERY DECENT 3 BEDROOMS FLAT, ALL ROOMS ENSUITE, FULLY TILED WITH WARDROBES, POP CEILING, WATER HEATER, GRD FLOOR, BLOCK OF 4 FLATS, PREPAID METER @ MILLENNIUM ESTATE, OKE ALO, GBAGADA RENT: #1,500,000 P/A ... New. Renovated. Security. All Room Ensuit. Big Compound. Supermarket Nearby. Restaurants Nearby. Security Doors. Parking Space. Pop Ceiling. 24 Hours Security. Drainage System. ...",gbagada,1,1,1,1,gbagada3,1000000.0,1300000.0,1200000.0,4,27,5,1500000
2870, gbagada phase 1 gbagada lagos,2,1,1,1,Newly Built Miniflat at Gbagada Pay and parking apartment Good Road Network All room ensuite Spacious Rooms Constant water and Power supply. Fitted Kitchen Cabinet and wardrobe very accessible to the road 24hrs security One year rent required. contact backup property consult today ... New. Security. All Room Ensuit. Security Doors. Parking Space. 24 Hours Electricity. 24 Hours Security. Street Lights. ...,gbagada,1,1,1,1,gbagada1,450000.0,500000.0,500000.0,4,8,2,600000
2871, phase 2 gbagada lagos,5,3,2,3,"New built 2 bedrooms ground flat, 2 tenants to share compound @ Gbagada phase 2 extension 1.3m 1yr ... New. ...",gbagada,1,1,0,1,gbagada3,1000000.0,1300000.0,1200000.0,3,27,5,1300000
2872, phase 2 gbagada lagos,8,4,4,4,"Newly built nicely finished 4 bedrooms duplex with private gate n driveway @ Gbagada GRA phase 2, 2.5M ... New. Boys Quater. All Room Ensuit. Big Compound. 24 Hours Electricity. 24 Hours Security. ...",gbagada,1,1,0,1,gbagada4,1700000.0,2500000.0,2500000.0,3,37,7,2500000
2873, ifako ifako gbagada gbagada lagos,8,4,4,4,*Just out now* Decent 5 bedroom duplex with mini flat bq at josodat estate sholuyi gbagada self compound Rent: 2.5m per annum 1 yr rent only. ... Old. Renovated. ...,gbagada,1,1,0,1,gbagada4,1700000.0,2500000.0,2500000.0,3,37,7,2500000
2874, harmony estate ifako gbagada gbagada lagos,7,4,3,4,Large compound and all tiles with modern facilities with car park and also in a tarred road ... Cheap. Renovated. Security. All Room Ensuit. Big Compound. Security Doors. Pop Ceiling. Street Lights. ...,gbagada,0,0,0,0,gbagada4,1700000.0,2500000.0,2500000.0,0,37,7,1300000
2875, ogundele street ifako gbagada gbagada lagos,7,4,3,4,All room ensuite with tikes and and wardrobe with security and water heater and store ... New. Furnished. Cheap. Renovated. Dry. Security. All Room Ensuit. Big Compound. Security Doors. Parking Space. Street Lights. ...,gbagada,0,0,0,0,gbagada4,1700000.0,2500000.0,2500000.0,0,37,7,1200000
2876, odo eran iyana oworo gbagada oworonshoki gbagada lagos,2,1,1,1,"For lease: Newly built mini flat with kitchen,toilet, balcony, prepaid meter at community street,odo-eran,iyana oworo, gbagada,Lagos. Rent:N400k SC: N30K Caution:N20k ... Serviced. New. Furnished. Cheap. Dry. Governor's Consent. Big Compound. 24 Hours Security. Drainage System. Street Lights. Survey. Security. All Room Ensuit. Supermarket Nearby. Parking Space. 24 Hours Electricity. Pop Ceiling. Water Treatment. ...",gbagada,0,0,0,0,gbagada1,450000.0,500000.0,500000.0,0,8,2,400000
2877, phase 1 gbagada lagos,5,3,2,3,"An Executive Super Standard Luxury Serviced 2bd Flat @ Gbagada Phs1 Extension, Lagos, with a fitted wardrobes and kitchen cabinets n cupboard, it also comes with an Inverter and two solid batteries, and standard sound ... ...",gbagada,0,0,0,1,gbagada3,1000000.0,1300000.0,1200000.0,1,27,5,1000000
2878, new garage gbagada lagos,5,3,2,3,2 bedroom Flat / Apartment for rent New garage Gbagada Lagos ... New. Security. Supermarket Nearby. Restaurants Nearby. Security Doors. Parking Space. Pop Ceiling. 24 Hours Security. Street Lights. ...,gbagada,0,0,0,0,gbagada3,1000000.0,1300000.0,1200000.0,0,27,5,850000
2879, extension phase 2 gbagada lagos,6,3,3,3,2 bedroom Flat / Apartment for rent Extension Phase 2 Gbagada Lagos ... New. Security. All Room Ensuit. Big Compound. Supermarket Nearby. Restaurants Nearby. Security Doors. Parking Space. Pop Ceiling. 24 Hours Security. Street Lights. ...,gbagada,1,0,0,1,gbagada3,1000000.0,1300000.0,1200000.0,2,27,5,1200000
2880, millenuim ups gbagada lagos,7,4,3,4,"All rooms en-suite, fitted with wardrobe and kitchen cabinet, spacious rooms , has ample car park space, located in a calm and serene estate ... New. Security. All Room Ensuit. Big Compound. Supermarket Nearby. Restaurants Nearby. Security Doors. Parking Space. Pop Ceiling. 24 Hours Security. Drainage System. Street Lights. ...",gbagada,1,1,0,1,gbagada4,1700000.0,2500000.0,2500000.0,3,37,7,2500000
2881, sholuyi gbagada soluyi gbagada lagos,6,3,3,3,"A clean ensuite 3bedroom flat upstairs at Sholuyi estate, Gbagada.property is located in a serene neighborhood with good access road to any part of Lagos metropolis. Property rate is 1.2m (one million two hundred thousand ... Dry. Security. All Room Ensuit. Big Compound. Security Doors. Parking Space. Pop Ceiling. 24 Hours Security. Drainage System. ...",gbagada,1,0,0,1,gbagada3,1000000.0,1300000.0,1200000.0,2,27,5,1200000
2882, phase 2 gbagada lagos,4,2,2,2, Mini 2bedroom flat office space at beside Mobil Gbagada Phase 2. 650k a year rent. ... ...,gbagada,0,0,0,0,gbagada2,725000.0,1000000.0,829999.9999999998,0,18,3,650000
2883, millenuim ups gbagada lagos,6,3,3,3,"Millennium Estate UPS Gbagada A well finished, relatively new 3bedroom flat ( all rooms ensuite). N1.5m per annum ... ...",gbagada,1,1,1,1,gbagada3,1000000.0,1300000.0,1200000.0,4,27,5,1500000
2884, millenuim ups gbagada lagos,7,4,3,4,"Newly built 4nos of 3bedroom flat at Millennium estate Gbagada Rent: 2.5m down, 2.7m up Note: prefers a cooperate client to take all four or individual client with good Corporate job ... New. ...",gbagada,1,1,0,1,gbagada4,1700000.0,2500000.0,2500000.0,3,37,7,2500000
2885, medina gbagada lagos,2,1,1,1,1 bedroom mini flat Self Contain Flat / Apartment for rent Medina Gbagada Lagos ... New. Renovated. Security. Supermarket Nearby. Restaurants Nearby. Security Doors. Parking Space. 24 Hours Security. Street Lights. Water Treatment. ...,gbagada,0,0,0,0,gbagada1,450000.0,500000.0,500000.0,0,8,2,300000
2886, new garage gbagada lagos,2,1,1,1,2 bedroom Flat / Apartment for rent New garage Gbagada Lagos ... New. Renovated. Security. Supermarket Nearby. Restaurants Nearby. Security Doors. Parking Space. 24 Hours Electricity. Street Lights. ...,gbagada,1,1,1,1,gbagada1,450000.0,500000.0,500000.0,4,8,2,550000
2887, sawmill gbagada lagos,4,2,2,2,Relatively New build 2bedroom flat en-suite @ Sawmill Gbagada. Price- 900k 1yr Caution fee- 100k Agreement - 10% Commission- 180k ... ...,gbagada,1,0,0,1,gbagada2,725000.0,1000000.0,829999.9999999998,2,18,3,900000
2888, chevron road soluyi gbagada lagos,5,3,2,3,two bedroom flat along chevron road well ventilated and all tiles and secured ... New. Renovated. ...,gbagada,0,0,0,1,gbagada3,1000000.0,1300000.0,1200000.0,1,27,5,1000000
2889, yetunde brown ifako gbagada gbagada lagos,7,4,3,4,Tolet Decent 3bedroom flat all room ensuit at yetunde brown ifako gbagada house rent 1million ... Furnished. Cheap. Renovated. Security. All Room Ensuit. Security Doors. Parking Space. Survey. Water Treatment. ...,gbagada,0,0,0,0,gbagada4,1700000.0,2500000.0,2500000.0,0,37,7,1000000
2890, soluyi gbagada lagos,2,1,1,1,2 bedroom Flat / Apartment for rent Soluyi Gbagada Lagos ... Renovated. Security. Supermarket Nearby. Restaurants Nearby. Security Doors. Parking Space. 24 Hours Security. Street Lights. ...,gbagada,0,0,0,0,gbagada1,450000.0,500000.0,500000.0,0,8,2,300000
2891, jesus street ifako gbagada gbagada lagos,7,4,3,4,A Large compound 3bed room flat all tiles well ventilated with water heater ... Renovated. Dry. Security. All Room Ensuit. Big Compound. Children Play Ground. ...,gbagada,0,0,0,0,gbagada4,1700000.0,2500000.0,2500000.0,0,37,7,1200000
2892, soluyi gbagada lagos,7,4,3,4,3 bedroom Flat / Apartment for rent Soluyi Gbagada Lagos ... New. Renovated. Security. All Room Ensuit. Supermarket Nearby. Restaurants Nearby. Security Doors. Parking Space. Pop Ceiling. 24 Hours Security. Street Lights. Water Treatment. ...,gbagada,0,0,0,0,gbagada4,1700000.0,2500000.0,2500000.0,0,37,7,1200000
2893, soluyi soluyi gbagada lagos,5,3,2,3,2 bedroom Flat / Apartment for rent Soluyi Soluyi Gbagada Lagos ... New. Security. All Room Ensuit. Big Compound. Supermarket Nearby. Restaurants Nearby. Security Doors. 24 Hours Electricity. 24 Hours Security. Street Lights. ...,gbagada,0,0,0,0,gbagada3,1000000.0,1300000.0,1200000.0,0,27,5,700000
2894, gbagada lagos,6,3,3,3,"Spacious 3 bedrooms up n ground flats all rooms ensuite with guest toilet, water heater, kitchen cabinets, wardrobes n prepaid meter ... ...",gbagada,1,0,0,1,gbagada3,1000000.0,1300000.0,1200000.0,2,27,5,1200000
2895, taodak estate ifako gbagada gbagada lagos,5,3,2,3,"Executive 2bedroom flat all rooms ensuite just 3 in the compound LOCATION: Taodak Estate, Ifako Gbagada Rent: 800k per annum ... Security. All Room Ensuit. Big Compound. Parking Space. Pop Ceiling. ...",gbagada,0,0,0,0,gbagada3,1000000.0,1300000.0,1200000.0,0,27,5,800000
2896, williams street gbagada ifako gbagada gbagada lagos,5,3,2,3,a 3 bedroom flat along williams road just two in a compound the apartment is upstairs with wardrobes and tiles toilet fenced and gated with car park full security big size kitchen big rooms ... Old. Renovated. Big Compound. Parking Space. ...,gbagada,0,0,0,0,gbagada3,1000000.0,1300000.0,1200000.0,0,27,5,700000
2897, gbagada ph2 estate. phase 2 gbagada lagos,9,5,4,5,"Newly built 2 nos 4 bedrooms terraced duplex all ensuite with guest toilet, wardrobes n kitchen cabinets , water heater n cubicle shower @ Gbagada phase 2 estate 3M PA Residential or commercial. (Agt Abass). ... New. Security. All Room Ensuit. Big Compound. Supermarket Nearby. Security Doors. Parking Space. 24 Hours Electricity. Pop Ceiling. 24 Hours Security. Street Lights. Water Treatment. ...",gbagada,1,1,0,1,gbagada5,3000000.0,3000000.0,3000000.0,3,43,8,3000000
2898, ifako gbagada ifako gbagada gbagada lagos,11,5,6,5,"Lovely 5brm Detached duplex with 1rm BQ, all rooms ensuite and guest toilet at Ferrano Court, Glory Estate, Ifako, Gbagada. 2m, 1yr rent ... ...",gbagada,0,0,0,0,gbagada5,3000000.0,3000000.0,3000000.0,0,43,8,2500000
2899, sawmill ifako ifako gbagada gbagada lagos,2,1,1,1,"Still available........ A room self at sawmill #250k per annum fence round with gate, pay n packing. ... Renovated. ...",gbagada,0,0,0,0,gbagada1,450000.0,500000.0,500000.0,0,8,2,300000
2900, ifako gbagada gbagada lagos,5,3,2,3,2 bedroom Flat / Apartment for rent Ifako-gbagada Gbagada Lagos ... New. Security. All Room Ensuit. Supermarket Nearby. Restaurants Nearby. Security Doors. Parking Space. Pop Ceiling. 24 Hours Security. Street Lights. Water Treatment. ...,gbagada,0,0,0,1,gbagada3,1000000.0,1300000.0,1200000.0,1,27,5,1000000
2901, peace estate soluyi gbagada lagos,5,3,2,3,"It is situated upstairs. Please call: [redacted], [redacted] or Whatsapp [redacted] ... Furnished. Dry. Security. All Room Ensuit. Pop Ceiling. ...",gbagada,0,0,0,0,gbagada3,1000000.0,1300000.0,1200000.0,0,27,5,850000
2902, gbagada lagos,5,2,3,2,3 Bedroom Duplex for Rent in Gbagada ... ...,gbagada,1,1,1,1,gbagada2,725000.0,1000000.0,829999.9999999998,4,18,3,1500000
2903, deeper life church road soluyi gbagada lagos,2,1,1,1,A roomself at the back of a hotel conversion and it doesn't have kitchen strictly for ladies and is upstairs ... Furnished. Cheap. Renovated. ...,gbagada,0,0,0,0,gbagada1,450000.0,500000.0,500000.0,0,8,2,300000
2904, extension phase 2 gbagada lagos,4,2,2,2,A very clean 3 bedroom at gbagada phase 2 in a very serene environment 1mill but 900k can fly Upstairs 3rd floor Wardrobes Kitchen Balcony Prepaid meter Car Park Legal 100k Agency 200k Caution 50k ... ...,gbagada,1,1,1,1,gbagada2,725000.0,1000000.0,829999.9999999998,4,18,3,1000000
2905, new garage new garage gbagada lagos,5,3,2,3,2 bedroom Flat / Apartment for rent New garage New garage Gbagada Lagos ... New. Security. All Room Ensuit. Big Compound. Supermarket Nearby. Restaurants Nearby. Security Doors. 24 Hours Electricity. 24 Hours Security. Street Lights. ...,gbagada,0,0,0,0,gbagada3,1000000.0,1300000.0,1200000.0,0,27,5,750000
2906, ... soluyi gbagada lagos,5,3,2,3,"Descent 3 bedrooms upstairs toilet 2bath with prepaid meter @ shadia estate, behind chevron staff club and clinic sholuyi gbagada. Rent: 1.3m, 1year rent. ... ...",gbagada,1,1,0,1,gbagada3,1000000.0,1300000.0,1200000.0,3,27,5,1300000
2907, millenuim ups gbagada lagos,6,3,3,3,3 bedroom Blocks of Flats House for rent Millenuim/UPS Gbagada Lagos ... Security. All Room Ensuit. Big Compound. Supermarket Nearby. Restaurants Nearby. Security Doors. Parking Space. Pop Ceiling. 24 Hours Security. Drainage System. Street Lights. ...,gbagada,1,1,1,1,gbagada3,1000000.0,1300000.0,1200000.0,4,27,5,1500000
2908, close to uba in ifako gbagada ifako gbagada gbagada lagos,6,3,3,3,"FRESH LETTING: THREE BEDROOM FIRST FLOOR FLAT IN A QUIET CLOSE IN IFAKO GBAGADA LAGOS. FEATURES: SPACIOUS LIVING ROOM, MASTER BEDROOM ENSUITE, TOILET AND BATH ASKING RENT :N1.3m buh 1.2m can fly ... Renovated. Big Compound. ...",gbagada,1,1,0,1,gbagada3,1000000.0,1300000.0,1200000.0,3,27,5,1300000
2909, yetunde brown ifako gbagada gbagada lagos,7,4,3,4,all rooms ensuite with all tiles sizeable family size rooms with water heater and kitchen stores just a block of four with a standby security new house ... New. Furnished. Dry. All Room Ensuit. Big Compound. Parking Space. ...,gbagada,0,0,0,0,gbagada4,1700000.0,2500000.0,2500000.0,0,37,7,1100000
2910, gbagada lagos,6,3,3,3, decent 3 bedroom flat available for rent in Gbagada. The house is located in a clean and secured environment. Its also very close to the main road. ... ...,gbagada,1,1,1,1,gbagada3,1000000.0,1300000.0,1200000.0,4,27,5,1500000
2911, gbagada lagos,6,3,3,3, Brand new 3 bedroom flat for rent in Gbagada 2.5M asking. Just 2 in a compound ... ...,gbagada,1,1,1,1,gbagada3,1000000.0,1300000.0,1200000.0,4,27,5,1800000
2912, ifako gbagada gbagada lagos,6,3,3,3,3 bedroom Flat / Apartment for rent Ifako-gbagada Gbagada Lagos ... New. Renovated. Security. All Room Ensuit. Supermarket Nearby. Restaurants Nearby. Security Doors. Parking Space. 24 Hours Security. Street Lights. Water Treatment. ...,gbagada,0,0,0,0,gbagada3,1000000.0,1300000.0,1200000.0,0,27,5,900000
2913, sawmill ifako gbagada gbagada lagos,7,4,3,4,All room ensuite upstairs with all tiles and wardrobe and car park with security ... Renovated. All Room Ensuit. Big Compound. ...,gbagada,0,0,0,0,gbagada4,1700000.0,2500000.0,2500000.0,0,37,7,1000000
2914, ajayi aina ifako gbagada gbagada lagos,6,3,3,3,"*Fresh* Spacious 3 bedrooms duplex common compound, all rooms ensuite with guest toilet, family lounge n POP @ off Ajayi Aina ifako Gbagada 1.5m 1yr ... Furnished. Cheap. Old. Renovated. ...",gbagada,1,1,1,1,gbagada3,1000000.0,1300000.0,1200000.0,4,27,5,1500000
2915, atunrase medina gbagada lagos,5,3,2,3,"*Just Now:* Relatively new 2bedroom flat with all room ensuite, ground flat vacant with prepaid meter,, only 4 tenants to share compound, at Atunrase Estate, Gbagada. Rent: 1.1m per annum. ... ...",gbagada,0,0,0,1,gbagada3,1000000.0,1300000.0,1200000.0,1,27,5,1100000
2916, jimoh bajulaye ifako gbagada gbagada lagos,6,3,3,3,3bedroom flat at ifako gbagada big size room just three tenant in the compound fenced and gated with security ... Renovated. Big Compound. ...,gbagada,1,0,0,1,gbagada3,1000000.0,1300000.0,1200000.0,2,27,5,1200000
2917, phase 2 gbagada lagos,7,4,3,4,Still available Newly built 3 bedroom Bungalow 1.5 yearly Agreement 150k. Commission 150k Total package 1.8mill @ Off Pedro road just two in compound Yoruba Muslim required ... ...,gbagada,0,0,0,0,gbagada4,1700000.0,2500000.0,2500000.0,0,37,7,1500000
2918, soluyi gbagada lagos,7,4,3,4,3 bedroom Flat / Apartment for rent Soluyi Gbagada Lagos ... New. Renovated. Security. All Room Ensuit. Supermarket Nearby. Restaurants Nearby. Security Doors. Parking Space. Pop Ceiling. 24 Hours Security. Street Lights. Water Treatment. ...,gbagada,0,0,0,0,gbagada4,1700000.0,2500000.0,2500000.0,0,37,7,1200000
2919, millenuim ups gbagada lagos,8,4,4,4,3 bedroom Flat / Apartment for rent Millenuim/UPS Gbagada Lagos ... New. Boys Quater. Security. All Room Ensuit. Supermarket Nearby. Security Doors. Parking Space. Pop Ceiling. 24 Hours Security. ...,gbagada,1,1,0,1,gbagada4,1700000.0,2500000.0,2500000.0,3,37,7,2500000
2920, sawmill gbagada ifako gbagada gbagada lagos,4,2,2,2,a master two bedroom flat at yetunde brown ifako gbagadneat compound enough car par with a well secured with security and tiles with prepaid meter and street light in an estate ... Furnished. Big Compound. ...,gbagada,0,0,0,1,gbagada2,725000.0,1000000.0,829999.9999999998,1,18,3,800000
2921, .. ifako gbagada gbagada lagos,7,4,3,4,*TO LET* Newly built 3Bedroom Duplex with A Room Bq in glory estate gbagada in a secured and serene environment *2living room & guest toilet.* *All rooms Ensuites* *Furnished kitchen* *Boys quarter* *Enough parking space* *Personal prepaid Meter* *Remote control ... Serviced. New. Security. All Room Ensuit. Big Compound. Supermarket Nearby. Restaurants Nearby. Security Doors. Parking Space. Pop Ceiling. 24 Hours Security. Drainage System. ...,gbagada,1,1,0,1,gbagada4,1700000.0,2500000.0,2500000.0,3,37,7,2500000
2922, new garage gbagada lagos,5,3,2,3,2 bedroom Flat / Apartment for rent New garage Gbagada Lagos ... New. Security. All Room Ensuit. Supermarket Nearby. Restaurants Nearby. Security Doors. Parking Space. Pop Ceiling. 24 Hours Security. Street Lights. Water Treatment. ...,gbagada,0,0,0,0,gbagada3,1000000.0,1300000.0,1200000.0,0,27,5,750000
2923, deeper life axis ifako gbagada gbagada lagos,2,1,1,1,1 bedroom mini flat Self Contain Flat / Apartment for rent Deeper life axis Ifako-gbagada Gbagada Lagos ... ...,gbagada,0,0,0,0,gbagada1,450000.0,500000.0,500000.0,0,8,2,350000
2924, millennium estate millenuim ups gbagada lagos,5,3,2,3,"Serviced and partly furnished 2 bed room flat all rooms ensuit plus guest toilet, , it comes with inverter and A/c in a the rooms location; millennium estate gbagada , Lagos . Rent 1.8m ... Serviced. Renovated. Dry. All Room Ensuit. Big Compound. Security Doors. 24 Hours Electricity. 24 Hours Security. Street Lights. ...",gbagada,1,1,1,1,gbagada3,1000000.0,1300000.0,1200000.0,4,27,5,1800000
2925, .. atunrase medina gbagada lagos,6,3,3,3,2 bedroom Flat / Apartment for rent Atunrase Medina Gbagada Lagos ... New. Renovated. Security. Supermarket Nearby. Restaurants Nearby. Security Doors. Parking Space. Pop Ceiling. 24 Hours Security. Street Lights. Water Treatment. ...,gbagada,0,0,0,1,gbagada3,1000000.0,1300000.0,1200000.0,1,27,5,1000000
2926, okealo millennium estate ifako gbagada gbagada lagos,6,3,3,3,New built 4nos of 3bedroom flat at Okealo millennium estate Gbagada Rent: Down 2.5million up 2.7million Nb: prefers a corporate tenant that can take all four or individuals that have a good corporate job. ... New. All Room Ensuit. Big Compound. 24 Hours Electricity. Pop Ceiling. 24 Hours Security. ...,gbagada,1,1,1,1,gbagada3,1000000.0,1300000.0,1200000.0,4,27,5,1800000
2927," millennium estate, oke-alo, gbagada lagos",8,4,4,4,"A Brand new 6 units of 3 bedroom luxury flats, tastefully finished with high quality building material. All rooms are en-suite with visitors toilet. Its at Millennium Estate, Oke- Alo, Gbagada (behind UPS, on Anthony ... ...",gbagada,1,1,0,1,gbagada4,1700000.0,2500000.0,2500000.0,3,37,7,2500000
2928, soluyi gbagada lagos,7,4,3,4,Decent 3 bedrooms ground flat all rooms ensuite with guest toilet in a decent close by Chevron Sholuyi Gbagada 1.2m 1 yr ... ...,gbagada,0,0,0,0,gbagada4,1700000.0,2500000.0,2500000.0,0,37,7,1200000
2929, gbagada oworoshoki junction oworonshoki gbagada lagos,5,3,2,3,"For lease: Newly built 2 bedroom flat with all rooms ensuit, visitors toilet, prepaid meter at community street,odo-eran,iyana oworo, gbagada, Lagos. Rent:N550k SC;N30K Caution: N20K ... Serviced. New. Furnished. Cheap. Dry. Security. All Room Ensuit. Security Doors. Parking Space. 24 Hours Security. Drainage System. Survey. Water Treatment. ...",gbagada,0,0,0,0,gbagada3,1000000.0,1300000.0,1200000.0,0,27,5,700000
2930, medina estate medina gbagada lagos,7,4,3,4,a 3 bedroom flat all rooms ensuite in gbagada in a nice location in medina estate with pop and water heater and all tiles and security ... Furnished. Old. Renovated. ...,gbagada,0,0,0,0,gbagada4,1700000.0,2500000.0,2500000.0,0,37,7,1500000
2931, millenuim ups gbagada lagos,7,4,3,4,"*TO LET* Newly built tastefully finished very spacious all rooms en-suite 3Bedroom flat , fitted with wardrobe, kitchen cabinet, water heater.spacious rooms ... New. Security. All Room Ensuit. Big Compound. Supermarket Nearby. Restaurants Nearby. Security Doors. Parking Space. Pop Ceiling. 24 Hours Security. Drainage System. Street Lights. ...",gbagada,1,1,0,1,gbagada4,1700000.0,2500000.0,2500000.0,3,37,7,2500000
2932, phase 2 gbagada lagos,10,5,5,5,"Newly built 2 nos 4 bedrooms terraced duplex all ensuite with guest toilet, wardrobes n kitchen cabinets, water heater n cubicle shower @ Gbagada phase 2 estate 3M PA Residential or commercial ... ...",gbagada,1,1,0,1,gbagada5,3000000.0,3000000.0,3000000.0,3,43,8,3000000
2933, gbagada lagos,5,3,2,3,2 bedroom flat with 3 toilet for rent in Gbagada ... ...,gbagada,0,0,0,0,gbagada3,1000000.0,1300000.0,1200000.0,0,27,5,700000
2934, soluyi gbagada lagos,5,3,2,3,2 bedroom Flat / Apartment for rent Soluyi Gbagada Lagos ... New. Renovated. Security. All Room Ensuit. Supermarket Nearby. Restaurants Nearby. Security Doors. Parking Space. Pop Ceiling. 24 Hours Security. Street Lights. Water Treatment. ...,gbagada,0,0,0,0,gbagada3,1000000.0,1300000.0,1200000.0,0,27,5,750000
2935, odo eran iyana oworo gbagada oworonshoki gbagada lagos,5,3,2,3,"For lease: Newly built two bedroom flat with all rooms ensuit, visitors toilet, prepaid meter at community street, odo-eran,iyana oworo, gbagada, Lagos. Rent:N500k SC:N30K Caution: N20K ... Serviced. New. Furnished. Cheap. Dry. Security. All Room Ensuit. Big Compound. Supermarket Nearby. Restaurants Nearby. Security Doors. Parking Space. 24 Hours Electricity. Street Lights. Survey. Water Treatment. ...",gbagada,0,0,0,0,gbagada3,1000000.0,1300000.0,1200000.0,0,27,5,700000
2936, ... millenuim ups gbagada lagos,7,4,3,4," Newly built tastefully finished very spacious all rooms en-suite 3Bedroom flat located at Millennium Estate, Gbadaga has car park space. * Rent 2.5M P.A* ... New. Security. All Room Ensuit. Big Compound. Supermarket Nearby. Restaurants Nearby. Security Doors. Parking Space. Pop Ceiling. 24 Hours Security. Street Lights. ...",gbagada,1,1,0,1,gbagada4,1700000.0,2500000.0,2500000.0,3,37,7,2500000
2937, hu medina gbagada lagos,5,3,2,3,Just out To Let 2bedroom flat at medina estate gbagada all rooms ensuite with visitors toilet 800k ... Furnished. Old. Cheap. All Room Ensuit. Security. Security Doors. Big Compound. Parking Space. 24 Hours Security. ...,gbagada,0,0,0,0,gbagada3,1000000.0,1300000.0,1200000.0,0,27,5,800000
2938, hu phase 2 gbagada lagos,6,3,3,3,Lovely 3bed at gbagada phr 2 900k ... Cheap. Furnished. Security. 24 Hours Security. Big Compound. Security Doors. Parking Space. Pop Ceiling. ...,gbagada,0,0,0,0,gbagada3,1000000.0,1300000.0,1200000.0,0,27,5,900000
2939, oworonshoki gbagada lagos,2,1,1,1,Pay and pack in spacious room selfcon at akerele estate oworosoki for 220k . Good water and almost 24/7 power supply ... ...,gbagada,0,0,0,0,gbagada1,450000.0,500000.0,500000.0,0,8,2,300000
2940, millenuim ups gbagada lagos,6,3,3,3,within a well secured Estate ... New. ...,gbagada,0,0,0,1,gbagada3,1000000.0,1300000.0,1200000.0,1,27,5,1000000
2941, glory estate ifako gbagada gbagada lagos,7,4,3,4,"Newly built 3Bedroom Duplex with A Room Bq in Newly built 3bedrooms terrace duplex in glory estate gbagada in a secured and serene environment, 2living room & guest toilet. All rooms Ensuites, Furnished kitchen, ... New. Parking Space. Big Compound. Water Treatment. Security Doors. Pop Ceiling. All Room Ensuit. Security. 24 Hours Security. ...",gbagada,0,0,0,1,gbagada4,1700000.0,2500000.0,2500000.0,1,37,7,2000000
2942, lagos ifako gbagada gbagada lagos,6,3,3,3,"Renovated 2 bedrooms ground flat 3t 2b with dinning area, water heater n prepaid meter @ OnÃ sanya Ifako Gbagada 1M 1yr *Pics available* ... ...",gbagada,0,0,0,1,gbagada3,1000000.0,1300000.0,1200000.0,1,27,5,1000000
2943, estate atunrase medina gbagada lagos,6,3,3,3,"*FRESH* Relatively new 2 bedrooms ground flat 3t 2b, 4 tenants to share compound with, kitchen cabs, wardrobes n prepaid meter @ Atunrase estate Gbagada 1m PA ... ...",gbagada,0,0,0,1,gbagada3,1000000.0,1300000.0,1200000.0,1,27,5,1000000
2944, soluyi gbagada lagos,2,1,1,1,"Spacious mini flat at sholuyi peace estate gbagada,pay and pack in. (NOTE) no parking space in the compound,u have to pack in the estate. For more info chat me on Whatsapp,. (pls don't CALL) ... ...",gbagada,0,0,0,0,gbagada1,450000.0,500000.0,500000.0,0,8,2,350000
2945, peace estate soluyi gbagada lagos,2,1,1,1,Single self contain at soluyi peace estate pay and pack in just for 150 a year ... ...,gbagada,0,0,0,0,gbagada1,450000.0,500000.0,500000.0,0,8,2,300000
2946, peace estate soluyi gbagada lagos,2,1,1,1,Spacious miniflat at peace estate soluyi gbagada 400 a year payment ... Renovated. ...,gbagada,0,0,0,0,gbagada1,450000.0,500000.0,500000.0,0,8,2,300000
2947, off miyaki street oworonshoki gbagada lagos,3,2,1,2,"Agreement is 50, agent is 50 and caution is 20. Please call: 08125953430 or Whatsapp 07030220490 ... Renovated. Dry. Big Compound. All Room Ensuit. ...",gbagada,0,0,0,0,gbagada2,725000.0,1000000.0,829999.9999999998,0,18,3,500000
2948, soluyi gbagada lagos,2,1,1,1,"Portable room selfcon in a serene estate of sholuyi for 150k,the current occupant want to move to a bigger room. Pay and pack in. For more info chat me on Whatsapp. Pls don't CALL. Send ... ...",gbagada,0,0,0,0,gbagada1,450000.0,500000.0,500000.0,0,8,2,300000
2949, jimoh oladenhinde gbagada lagos,3,2,1,2,"Newly built 2 bedrooms *up* flat 2t 1b with POP, wardrobes n kitchen cabinets, 3 tenants to share compound @ Jimoh Oladehinde Ifako Gbagada 1.1m x a yr n half ... ...",gbagada,1,1,1,1,gbagada2,725000.0,1000000.0,829999.9999999998,4,18,3,1100000
2950, peace estate sholuyi gbagada ifako gbagada gbagada lagos,7,4,3,4,Executive 3bedroom flat all rooms ensuit with guest toilet fitted kitchen pop wardrobe all tiles spacious rooms prepaid meter treated water fenced with car park ... Renovated. Furnished. Big Compound. Free Wifi. Parking Space. Church Nearby. Water Treatment. Security Doors. All Room Ensuit. Street Lights. Pop Ceiling. Security. ...,gbagada,0,0,0,0,gbagada4,1700000.0,2500000.0,2500000.0,0,37,7,1500000
2951, adeyeye street millenuim ups gbagada lagos,6,3,3,3,Nice 3bed apartment with modern finished ... New. Furnished. 24 Hours Security. 24 Hours Electricity. ...,gbagada,1,1,1,1,gbagada3,1000000.0,1300000.0,1200000.0,4,27,5,1800000
2952, oworonshoki gbagada lagos,2,1,1,1,1 bedroom mini flat Mini flat Flat / Apartment for rent Oworonshoki Gbagada Lagos ... Cheap. New. Big Compound. Security Doors. Parking Space. Fast Internet. Security. Drainage System. ...,gbagada,0,0,0,0,gbagada1,450000.0,500000.0,500000.0,0,8,2,350000
2953,  beach road ebute ikorodu lagos,7,4,3,4,"Its a tastefully finished spacious 3 bedrooms flat, apartment tiled round, all rooms en-suit, spacious sitting room with a dining section also with a visitors toilet, master bedroom with walk in closet water heater, all ... Renovated. Furnished. Security. Pop Ceiling. All Room Ensuit. Parking Space. 24 Hours Security. ...",ikorodu,1,1,1,1,ikorodu4,600000.0,740000.0000000001,669999.9999999999,4,14,3,750000
2954,  lowa estate jumofak ikorodu lagos,5,3,2,3,"Its a newly renovated 3 bedroom ground floor flat, apartment tiled round all rooms en-suit,spacious sitting room with pop ceiling, fitted kitchen with cabinet and a store also with an emergency exit. apartment also has ... Furnished. Security Doors. Security. Big Compound. All Room Ensuit. Parking Space. 24 Hours Security. ...",ikorodu,0,0,0,1,ikorodu3,325000.0,500000.0,400000.0,1,5,1,350000
2955,  alogba estate ebute ikorodu lagos,7,4,3,4,"Its a newly renovated 4 bedrooms detached bungalow on a full plot of land fenced gated located in a gated estate with ample parking space, property suitable for both commercial and residential purpose, apartment tiled ... Renovated. Furnished. Security Doors. Security. Big Compound. Parking Space. ...",ikorodu,0,0,0,1,ikorodu4,600000.0,740000.0000000001,669999.9999999999,1,14,3,600000
2956,"  kingsway estate, isawo agric ikorodu lagos",4,2,2,2,Exclusively finished mini flat with separate toilet and bath and a large kitchen. Painted already. â€¢ Wall Hanger â€¢ Carbinet â€¢ Tiles all round â€¢ Large Kitchen â€¢ Large Laundry â€¢ Lobby â€¢ Fenced compound with interlock ... Children Play Ground. Parking Space. Security Doors. All Room Ensuit. Child Care. ...,ikorodu,0,0,0,0,ikorodu2,250000.0,390000.00000000006,306000.0,0,3,1,170000
2957,"  nasfat, isawo ikorodu ikorodu lagos",4,2,2,2,"Exclusively Finished 2 Bedroom flat with 2 toilet and bath and a large kitchen. Painted already. â€¢ Tiles all round â€¢ Large Kitchen â€¢ Lobby â€¢ Fenced compound Contact us: [redacted], [redacted] ... Renovated. Parking Space. Security Doors. ...",ikorodu,0,0,0,0,ikorodu2,250000.0,390000.00000000006,306000.0,0,3,1,230000
2958,"  odunlami, isawo agric ikorodu lagos",2,1,1,1,"mini flat with toilet and bath and a large kitchen. Painted already. â€¢ Tiles all round â€¢ Large Kitchen â€¢ Lobby â€¢ Fenced compound with interlock Contact us: 08062552955, 08183039595 ... Security Doors. ...",ikorodu,1,1,0,1,ikorodu1,120000.0,150000.0,150000.0,3,1,1,150000
2959,"  kingsway estate, isawo agric agric ikorodu lagos",4,2,2,2,"Mini Flat Rent - Room & Parlour Self Contained at Kingsway Estate, Isawo, Agric Ikorodu, Lagos with nice lobby, kitchen cabinet, 2 toilets & bathroom. Rent: N180,000 Commission: N25,000 Agreement: N25,000 Caution: N10,000 Security: N300 * 12 = N3,600 Cleaning: N500 ... New. Parking Space. Security Doors. Pop Ceiling. ...",ikorodu,0,0,0,0,ikorodu2,250000.0,390000.00000000006,306000.0,0,3,1,180000
2960, isawo isawo ikorodu lagos,7,4,3,4,Newly built 3 bedroom flat apartment all ensuit at ikorodu ... Cheap. Dry. Furnished. New. Water Treatment. Children Play Ground. Security. Big Compound. All Room Ensuit. Supermarket Nearby. Fast Internet. 24 Hours Electricity. Restaurants Nearby. ...,ikorodu,0,0,0,0,ikorodu4,600000.0,740000.0000000001,669999.9999999999,0,14,3,400000
2961, ikorodu road(ilupeju) ilupeju lagos,2,1,1,1,Just out for let Clean mini flat in obanikoro estate for 500k ... ...,ikorodu,1,1,1,1,ikorodu1,120000.0,150000.0,150000.0,4,1,1,300000
2962, ibeshe ibeshe ikorodu lagos,7,4,3,4,"Its a newly built spacious 3 bedrooms flat, up and downstairs available for rent, apartment tiled round with pop ceilings, spacious en-suit rooms with fitted wardrobe, spacious sitting room with a dining section also with ... Furnished. New. Security Doors. Security. Pop Ceiling. Big Compound. All Room Ensuit. Supermarket Nearby. Parking Space. 24 Hours Security. ...",ikorodu,1,0,0,1,ikorodu4,600000.0,740000.0000000001,669999.9999999999,2,14,3,700000
2963, valley view estate ebute ikorodu lagos,7,4,3,4," Its a newly renovated 3bedrooms terrace duplex, apartment tiled round, self entrance, self parking space, all rooms ensuit and spacious, semi fitted kitchen spacious sitting room with a dining section and a visitors toilet, few ... Renovated. Security Doors. 24 Hours Security. ...",ikorodu,0,0,0,1,ikorodu4,600000.0,740000.0000000001,669999.9999999999,1,14,3,600000
2964, grammar school ota ona ikorodu ikorodu lagos,5,3,2,3,"Its a newly built 2 nos of 2bedrooms flat in a mini estate around grammar school ota ona ikorodu, this property is painted inside and outside, well ventilated compound, ample parking space, playing ground, apartment ... Furnished. New. Security. All Room Ensuit. Parking Space. 24 Hours Security. ...",ikorodu,0,0,0,0,ikorodu3,325000.0,500000.0,400000.0,0,5,1,200000
2965, valley view estate ebute ikorodu lagos,4,2,2,2," Its a newly built 2bedrooms up and ground floor flat available for rent in valley view estate oluodo, apartment tiled round, master bedroom ensuit with fitted wardrobe, separate toilet and bathroom to be shared by ... Furnished. New. 24 Hours Security. ...",ikorodu,1,1,1,1,ikorodu2,250000.0,390000.00000000006,306000.0,4,3,1,400000
2966, ebute ebute ikorodu lagos,3,2,1,2,"Its a newly renovated room and parlour miniflat ground floor flat available for rent, apartment tiled round, two toilet spacious sitting room and bedroom ample parking space facing a tarred few minutes walk and drive ... Renovated. All Room Ensuit. 24 Hours Security. ...",ikorodu,0,0,0,1,ikorodu2,250000.0,390000.00000000006,306000.0,1,3,1,250000
2967, isawo isawo ikorodu lagos,5,3,2,3,Newly built 3 bedroom flat apartment all ensuit at ikorodu ... Cheap. Dry. Furnished. New. Water Treatment. Children Play Ground. Security. Street Lights. Big Compound. All Room Ensuit. 24 Hours Electricity. ...,ikorodu,0,0,0,0,ikorodu3,325000.0,500000.0,400000.0,0,5,1,200000
2968, oba olaide estate ibeshe ikorodu lagos,4,2,2,2,"Its a newly renovated 2 bedroom ground floor flat in ibeshe ikorodu,apartment tiled round,spacious sitting room,master bedroom en-suit with a fitted wardrobe, and a separate toilet and bathroom to be shared by the other room ... Renovated. Furnished. Security Doors. Security. Street Lights. Big Compound. Parking Space. 24 Hours Security. ...",ikorodu,1,0,1,1,ikorodu2,250000.0,390000.00000000006,306000.0,3,3,1,350000
2969, elepe royal estate aga ebute ikorodu lagos,5,3,2,3," Its a newly built 2 bedrooms ground floor flat in elepe estate aga ikorodu, apartment tiled round, all rooms en-suit, pop ceiling, sitting room with a visitors toilet, spacious fitted kitchen with an emergency exit, ... New. Big Compound. All Room Ensuit. Parking Space. 24 Hours Security. ...",ikorodu,1,1,1,1,ikorodu3,325000.0,500000.0,400000.0,4,5,1,600000
2970, alogba estate ebute ikorodu lagos,4,2,2,2,"Its a spacious newly renovated 2bedrooms ground floor flat, just four tenants in the compound, apartment tiled round spacious sitting room with a dining section, master bedroom ensuit with wardrobe, and a separate toilet and ... Renovated. Furnished. Security Doors. Security. Big Compound. Parking Space. 24 Hours Security. ...",ikorodu,1,0,1,1,ikorodu2,250000.0,390000.00000000006,306000.0,3,3,1,350000
2971, ibeshe road ebute ikorodu lagos,5,3,2,3,"Its a newly built 2 bedrooms terrace duplex in an estate in ebute, apartment tiled round painted inside and outside, pop ceiling,all rooms en-suit with inbuilt wardrobe, fitted spacious kitchen with an emergency exit, spacious ... New. Security. Pop Ceiling. All Room Ensuit. Parking Space. 24 Hours Security. ...",ikorodu,1,1,1,1,ikorodu3,325000.0,500000.0,400000.0,4,5,1,650000
2972, isawo isawo ikorodu lagos,3,2,1,2,Newly built mini flat apartment at ikorodu Lagos state ... Cheap. Furnished. New. Water Treatment. Security Doors. Children Play Ground. Security. Street Lights. Big Compound. Supermarket Nearby. Parking Space. Fast Internet. 24 Hours Electricity. ...,ikorodu,0,0,0,0,ikorodu2,250000.0,390000.00000000006,306000.0,0,3,1,100000
2973, mowo kekere road ijede ikorodu lagos,2,1,1,1,"Newly built 1 bedroom flat @ Mowo Kekere Road Lagos. Rent: #150,000 p.a ... New. Drainage System. Water Treatment. Security Doors. Security. Street Lights. Big Compound. Church Nearby. Parking Space. 24 Hours Security. ...",ikorodu,1,1,0,1,ikorodu1,120000.0,150000.0,150000.0,3,1,1,150000
2974, lowa estate jumofak ikorodu lagos,5,3,2,3,"Its a newly built 3 bedrooms up and ground floor flat available for rent, apartment tiled round, with pop ceilings round, master bedroom en-suit and spacious no wardrobe, fitted kitchen with cabinet ample parking space, ... New. Drainage System. Security Doors. Security. Big Compound. Parking Space. 24 Hours Security. ...",ikorodu,1,0,0,1,ikorodu3,325000.0,500000.0,400000.0,2,5,1,400000
2975, dele kuti ebute ikorodu lagos,4,2,2,2,"Its a newly renovated ground floor and upstairs flat available for rent, pop ceilings, terrazzo floor, master bedroom en-suit with a toilet and bathroom also with wardrobe and a separate toilet and bathroom to be ... Renovated. Furnished. Security. Pop Ceiling. Big Compound. Parking Space. 24 Hours Security. ...",ikorodu,1,1,1,1,ikorodu2,250000.0,390000.00000000006,306000.0,4,3,1,400000
2976, alogba estate ebute ikorodu lagos,5,3,2,3,"its a newly built 2bedrooms flat ground floor and upflat available for rent, apartment tiled round, all rooms ensuit spacious sitting room with a dining section, fitted spacious kitchen with a balcony, ample parking space, ... Furnished. New. Security Doors. Big Compound. All Room Ensuit. Parking Space. 24 Hours Electricity. 24 Hours Security. ...",ikorodu,1,1,1,1,ikorodu3,325000.0,500000.0,400000.0,4,5,1,500000
2977, beach road ebute ikorodu lagos,5,3,2,3,"its a newly renovated 3bedrooms up and ground floor flat available for rent, apartment spacious painted inside and outside, all rooms with fitted wardrobe, spacious fitted kitchen with a store and an emergenvy exit, terrazo ... ...",ikorodu,1,1,1,1,ikorodu3,325000.0,500000.0,400000.0,4,5,1,600000
2978, ibeshe road ebute ikorodu lagos,4,2,2,2,"Its a spacious 3 bedrooms flat, currently undergoing renovated , spacious tiled sitting room with a dining section, tiled kitchen with small cabinet, untiled rooms with fitted wardrobe, master bedroom en-suit, separate toilet and bathroom ... Renovated. ...",ikorodu,0,0,0,1,ikorodu2,250000.0,390000.00000000006,306000.0,1,3,1,250000
2979, elepe royal estate aga ebute ikorodu lagos,5,3,2,3,"Its a decent spacious well finished 2 bedroom ground floor flat, all rooms ensuit with water heater also with fitted wardrobe, spacious sitting room with a visitors toilet, a dining section, spacious fitted kitchen with ... Renovated. Furnished. Pop Ceiling. Big Compound. Parking Space. 24 Hours Security. ...",ikorodu,1,1,1,1,ikorodu3,325000.0,500000.0,400000.0,4,5,1,650000
2980, olayinka jumbo ebute ikorodu lagos,9,5,4,5,"Its a Newly renovated 4 bedrooms semi detached bungalow just two tenants in the compound, apartment spacious tiled round, spacious sitting room with a dining section, also with a visitors toilet, pop ceiling, master bedroom ... Renovated. Furnished. Security Doors. Security. Pop Ceiling. All Room Ensuit. Parking Space. 24 Hours Electricity. 24 Hours Security. ...",ikorodu,1,1,0,1,ikorodu5,800000.0,800000.0,800000.0,3,21,4,800000
2981," 12 japheth omojuwa street, rabaka bus stop off. ibeshe ikorodu lagos",6,3,3,3,"A 3 bedroom bungalow is for rent at Rabaka Bus stop in Ikorodu. You are your own boss, in the house. NO LANDLORD DRAMA. The tenant has the following 1 Own gate. 2 Own Water tank, 3 Own Pumping ... ...",ikorodu,0,0,0,0,ikorodu3,325000.0,500000.0,400000.0,0,5,1,270000
2982, ijede road ijede ikorodu lagos,2,1,1,1,"RENT ALERT ? A room self contain N85,000 off Ijede road, Ikorodu, Lagos. Be fast, it won't last long. DETAILS Tiled toilet, nice kitchen, plastered wall and floor, water, light, security serene environment etc. BREAKDOWN ???? Rent ... ...",ikorodu,0,0,0,0,ikorodu1,120000.0,150000.0,150000.0,0,1,1,85000
2983, teachers quarters igbogbo ikorodu lagos,6,3,3,3,3 bedroom Shared Apartment Flat / Apartment for rent Teachers Quarters Igbogbo Ikorodu Lagos ... New. All Room Ensuit. Pop Ceiling. Restaurants Nearby. Big Compound. ...,ikorodu,0,0,0,1,ikorodu3,325000.0,500000.0,400000.0,1,5,1,350000
2984," cele-gbaga area, itamaga ikorodu lagos",4,2,2,2,"Neatly built 2bed flat in a calm, peaceful and secured neighborhood. Features: POP Ceiling Spacious sitting room Dinning Cross ventilation Constant light Drinkable borehole water Wardrobe Big kitchen with cabinet Spacious parking lot Paved compound Price: 250k per annum ... Big Compound. Drainage System. Security. Parking Space. 24 Hours Electricity. Street Lights. Security Doors. 24 Hours Security. Pop Ceiling. Supermarket Nearby. ...",ikorodu,0,0,0,1,ikorodu2,250000.0,390000.00000000006,306000.0,1,3,1,250000
2985, awesu bus stop igbogbo ikorodu lagos,7,4,3,4,"Annual rent:300,000 A&C:100,000 Total:400,000 ... ...",ikorodu,0,0,0,0,ikorodu4,600000.0,740000.0000000001,669999.9999999999,0,14,3,400000
2986, by abuja bus stop off ibeshe road immediately after lagoon view estate agbowa ibeshe ikorodu lagos,5,3,2,3,"astefully and brand new 2units of 3bedroom flat with all Rooms en suit with a Guest toilet,,Beautiful P.O.P Decorate everywhere,,Standard Rooms with wardrobe n water heater,,Fully Fitted Kitchen with full Cabinet,, Interlocked Compound etc... You need ... Renovated. Pop Ceiling. All Room Ensuit. Big Compound. Parking Space. Security. Street Lights. Security Doors. ...",ikorodu,1,0,1,1,ikorodu3,325000.0,500000.0,400000.0,3,5,1,450000
2987, oba laide estate off ibeshe road ibeshe ikorodu lagos,4,2,2,2,"A Brand New And Standard 3bedroom flat Bungalow with 2 Rooms en suit + 3 rooms sharing Toilet and Bathroom with a Visitors,,well Painted,,Spacious Kitchen,, very Big Toilet and Bathrooms 2 people can bath at ... New. All Room Ensuit. Big Compound. Parking Space. Security. Street Lights. Security Doors. ...",ikorodu,1,1,1,1,ikorodu2,250000.0,390000.00000000006,306000.0,4,3,1,450000
2988, igbogbo ikorodu lagos,4,2,2,2,"New and lovely mini flat located in a secured and peaceful environment, it's made with pop ceiling, kitchen cabinet,wardrobes , tiled, well ventilated rooms and living room etc ... ...",ikorodu,0,0,0,1,ikorodu2,250000.0,390000.00000000006,306000.0,1,3,1,300000
2989, ikorodu lagos,5,3,2,3,"Newly built 2bedroom flat at Grammar school axis ikorodu The house as the following features kitchen cabinet, pained, tiled , guest toilet, fenced with gate etc. ... ...",ikorodu,0,0,0,1,ikorodu3,325000.0,500000.0,400000.0,1,5,1,350000
2990, erunwe/radio area ikorodu ikorodu lagos,8,4,4,4,"Beautiful finished 3 bedroom apartment, ready to move in. ... New. Supermarket Nearby. Parking Space. All Room Ensuit. Big Compound. Church Nearby. Mosques Nearby. Pop Ceiling. Drainage System. 24 Hours Security. ...",ikorodu,0,0,0,1,ikorodu4,600000.0,740000.0000000001,669999.9999999999,1,14,3,600000
2991, ikorodu lagos,5,3,2,3,"Newly built 2bedroom flat located at laaga- eleshin ikorodu, it's sited in a peaceful environment with good power suplly, the house can boast of pop ceilings, kitchen cabinet, tiles, fenced with gate, borehole etc ... ...",ikorodu,0,0,0,0,ikorodu3,325000.0,500000.0,400000.0,0,5,1,250000
2992, ikorodu lagos,6,3,3,3,Hot 3 bedroom for rent at ikorodu lagos for 400k ... ...,ikorodu,1,0,0,1,ikorodu3,325000.0,500000.0,400000.0,2,5,1,400000
2993, ikorodu lagos,2,1,1,1,A decent self contain available for rent in Ikorodu The house is located in a clean and secured environment. Its also very close to the main road. ... ...,ikorodu,0,0,0,1,ikorodu1,120000.0,150000.0,150000.0,1,1,1,120000
2994, ikorodu lagos,2,1,1,1,A decent mini flat available for rent in Ikorodu The house is located in a clean and secured environment. Its also very close to the main road. ... ...,ikorodu,1,1,1,1,ikorodu1,120000.0,150000.0,150000.0,4,1,1,200000
2995, ikorodu lagos,4,2,2,2,A decent 2 bedroom flat available for rent in Ikorodu The house is located in a clean and secured environment. Its also very close to the main road. ... ...,ikorodu,0,0,0,0,ikorodu2,250000.0,390000.00000000006,306000.0,0,3,1,220000
2996, ikorodu lagos,4,2,2,2,A newly built 2 bedroom apartment for rent in ikorodu lagos ... ...,ikorodu,0,0,0,1,ikorodu2,250000.0,390000.00000000006,306000.0,1,3,1,250000
2997, ikorodu lagos,6,3,3,3,A decent 3 bedroom flat available for rent in Ikorodu The house is located in a clean and secured environment. Its also very close to the main road. ... ...,ikorodu,0,0,0,0,ikorodu3,325000.0,500000.0,400000.0,0,5,1,300000
2998, ikorodu lagos,4,2,2,2,A decent 2 bedroom flat available for rent in Ikorodu The house is located in a clean and secured environment. Its also very close to the main road. ... ...,ikorodu,0,0,0,1,ikorodu2,250000.0,390000.00000000006,306000.0,1,3,1,250000
2999, chris kpapovwe street igbogbo ikorodu lagos,2,1,1,1,"Annual rent:200,000 A&C:-80,000 Total:-280,000 ... ...",ikorodu,1,1,1,1,ikorodu1,120000.0,150000.0,150000.0,4,1,1,200000
3000, ikorodu garage ikorodu ikorodu lagos,2,1,1,1,"Annual rent:-110,000 A&C:-60,000 ... ...",ikorodu,0,0,0,0,ikorodu1,120000.0,150000.0,150000.0,0,1,1,110000
3001, unity bus stop igbogbo ikorodu lagos,5,3,2,3,"Annual rent:250,000 A&C:60,000 Total:350,000 ... ...",ikorodu,0,0,0,0,ikorodu3,325000.0,500000.0,400000.0,0,5,1,250000
3002, ikorodu lagos,4,2,2,2,"2 bedroom apartment for rent at ikorodu Lagos #330 yearly rent Fence and gate Fully tiled, Painted in and out of the house Wardrobe and kitchen cabinets ... ...",ikorodu,1,0,0,1,ikorodu2,250000.0,390000.00000000006,306000.0,2,3,1,330000
3003, unity first gate igbogbo ikorodu lagos,2,1,1,1,Annual rent:130k A&C:-40k Caution fee:10k Total:180k ... ...,ikorodu,0,0,0,1,ikorodu1,120000.0,150000.0,150000.0,1,1,1,130000
3004, ikorodu lagos,4,2,2,2,Well maintained 2 bedroom flat with 3 toilets and 2 bathroom to let in Ikorodu ... ...,ikorodu,1,1,1,1,ikorodu2,250000.0,390000.00000000006,306000.0,4,3,1,600000
3005, ikorodu lagos,2,1,1,1,A decent mini flat available for rent in Ikorodu The house is located in a clean and secured environment. Its also very close to the main road. ... ...,ikorodu,1,1,1,1,ikorodu1,120000.0,150000.0,150000.0,4,1,1,220000
3006, ikorodu lagos,2,1,1,1,"Miniflat for the rent at ikorodu Lagos. waldrop, kitchen cabinets for 220k ... ...",ikorodu,1,1,1,1,ikorodu1,120000.0,150000.0,150000.0,4,1,1,220000
3007, agunfoye last bus stop igbogbo ikorodu lagos,2,1,1,1,Annual rent:120k A/C:40k Total:160k ... ...,ikorodu,0,0,0,1,ikorodu1,120000.0,150000.0,150000.0,1,1,1,120000
3008, ikorodu lagos,4,2,2,2,"Exquisitely finished 2 bedroom flat in a serene environment, and safe neighbourhood. ... ...",ikorodu,0,0,0,1,ikorodu2,250000.0,390000.00000000006,306000.0,1,3,1,250000
3009," korperate,macaulay igbogbo ikorodu lagos",2,1,1,1,A single room self con in a fenced with gate compound. Annual rent:100k A&C:40k Total :140k ... ...,ikorodu,0,0,0,0,ikorodu1,120000.0,150000.0,150000.0,0,1,1,100000
3010, maternity area igbogbo ikorodu lagos,5,3,2,3,"Annual rent:-200,000 A&C:-80,000 ... ...",ikorodu,0,0,0,0,ikorodu3,325000.0,500000.0,400000.0,0,5,1,200000
3011, lfi igbogbo ikorodu lagos,4,2,2,2,"Annual rent:-200,000 A&C:-60,000 Total:260,000 ... ...",ikorodu,0,0,0,0,ikorodu2,250000.0,390000.00000000006,306000.0,0,3,1,200000
3012, ikorodu lagos,6,3,3,3,A decent 3 bedroom flat available for rent in Ikorodu The house is located in a clean and secured environment. Its also very close to the main road. ... ...,ikorodu,1,1,1,1,ikorodu3,325000.0,500000.0,400000.0,4,5,1,500000
3013," behind cluster bar, off ebute igbogbo road, ebute ikorodu lagos",2,1,1,1,"It's a well built detached bungalow of just two occupants in the compound, it's close to the road, after Waec office at Ebute Igbogbo road, it's called a mini 2bed cos it' has just 1toilet, ... ...",ikorodu,1,1,1,1,ikorodu1,120000.0,150000.0,150000.0,4,1,1,220000
3014, ikorodu lagos,4,2,2,2,Exquisitely finished two bedroom flat in a serene environment and safe neighbourhood. ... ...,ikorodu,0,0,0,0,ikorodu2,250000.0,390000.00000000006,306000.0,0,3,1,200000
3015, ikorodu road shomolu lagos,7,4,3,4,"Executive Newly Built very spacious 3bedroom flat with all rooms ensuite + guest toilet,pop finished, fitted with wardrobe and kitchen cabinet. down flat: 1.5m Up flat: 2m Located off Ikorodu road , palmgroove ... New. Security. All Room Ensuit. Big Compound. Supermarket Nearby. Restaurants Nearby. Security Doors. Parking Space. Pop Ceiling. 24 Hours Security. Drainage System. Street Lights. ...",ikorodu,1,1,1,1,ikorodu4,600000.0,740000.0000000001,669999.9999999999,4,14,3,1200000
3016, unity first gate(cole house) igbogbo ikorodu lagos,2,1,1,1,Annual rent:-84k A&C:-40k Total:-124k ... ...,ikorodu,0,0,0,0,ikorodu1,120000.0,150000.0,150000.0,0,1,1,84000
3017," renecon road,macaulay str igbogbo ikorodu lagos",2,1,1,1,Room and parlor self contain Annual rent: 100k A&C:-50k Total:-150k ... ...,ikorodu,0,0,0,0,ikorodu1,120000.0,150000.0,150000.0,0,1,1,100000
3018, sikiru jimoh str igbogbo ikorodu lagos,2,1,1,1,"Annual rent:150,000 A/C:60,000 Total:210,000 ... ...",ikorodu,1,1,0,1,ikorodu1,120000.0,150000.0,150000.0,3,1,1,150000
3019, chris kpakpovwe street igbogbo ikorodu lagos,5,3,2,3,"Annual rent:200,000 A&C:80,000 Total:280,000 ... ...",ikorodu,0,0,0,0,ikorodu3,325000.0,500000.0,400000.0,0,5,1,200000
3020," iya folake str,macaulay igbogbo ikorodu lagos",3,2,1,2,A newly built room and parlor self contain in a fenced with gate compound. Annual rent: 120k A&C:-50k Damages:-10k Total:-180k ... ...,ikorodu,0,0,0,0,ikorodu2,250000.0,390000.00000000006,306000.0,0,3,1,120000
3021, igbe laara ikorodu ikorodu lagos,2,1,1,1,"The Mini Flat is the Cheapest in Lagos state. 80k yearly, there is electricity and there is water in the compound. ... ...",ikorodu,0,0,0,0,ikorodu1,120000.0,150000.0,150000.0,0,1,1,80000
3022, emily avenue igbogbo ikorodu lagos,2,1,1,1,"A single room self con in a fenced with gate compound, trekable to the bus stop Annual rent:72k A&C:40k Total: 112,000 ... ...",ikorodu,0,0,0,0,ikorodu1,120000.0,150000.0,150000.0,0,1,1,80000
3023, orjih bus stop igbogbo ikorodu lagos,2,1,1,1,"Well furnished mini flat Annual rent:-100,000 A&C:-40,000 Total:-140,000 ... ...",ikorodu,0,0,0,0,ikorodu1,120000.0,150000.0,150000.0,0,1,1,100000
3024, ikorodu lagos,4,2,2,2,Brand new 2 bedroom flat for rent in Ikoyi. Close to the main road Good road network All round tiles ... ...,ikorodu,1,1,1,1,ikorodu2,250000.0,390000.00000000006,306000.0,4,3,1,450000
3025, emily avenue igbogbo ikorodu lagos,4,2,2,2,Annual rent:250k A&C:100k Total :350k ... ...,ikorodu,0,0,0,1,ikorodu2,250000.0,390000.00000000006,306000.0,1,3,1,250000
3026, unity b/s bayeku road igbogbo ikorodu lagos,2,1,1,1,"Very spacious and nice single room self contain, allroun tiles, toilet and bathroom, kitchen.. 72,000 is annual rent, but 6 month can be paid.. ... ...",ikorodu,0,0,0,0,ikorodu1,120000.0,150000.0,150000.0,0,1,1,80000
3027, ikorodu lagos,6,3,3,3,A decent 3 bedroom flat available for rent in Ikorodu The house is located in a clean and secured environment. Its also very close to the main road. ... ...,ikorodu,1,0,0,1,ikorodu3,325000.0,500000.0,400000.0,2,5,1,400000
3028, fawole street igbogbo ikorodu lagos,5,3,2,3,"Newly built 2 bedroom flat Annual rent :-200,000 A&C:-50,000 Total:-250,000 ... ...",ikorodu,0,0,0,0,ikorodu3,325000.0,500000.0,400000.0,0,5,1,200000
3029, selewu street igbogbo ikorodu lagos,2,1,1,1,"Executive room self-contain with large kitche, cabinet, large compound , interlocking compound, fence with gate ... Furnished. Cheap. Old. Dry. Boys Quater. Security. Big Compound. Security Doors. Parking Space. ...",ikorodu,0,0,0,0,ikorodu1,120000.0,150000.0,150000.0,0,1,1,84000
3030, teachers quarter selewu igbogbo igbogbo ikorodu lagos,2,1,1,1,Newly built 4 units mini flat on a fenced and gated compound. ... New. Cheap. Security. ...,ikorodu,0,0,0,1,ikorodu1,120000.0,150000.0,150000.0,1,1,1,120000
3031," owode-ibeshe, off ebute-ibeshe road ebute ikorodu lagos",3,2,1,2,"It's a standard detached bungalow in an enclosed estate with maximum security, and good supply of electricity with prepaid metre installed, just by the road side, tarred road all thru, pay n pack in ... ...",ikorodu,1,1,1,1,ikorodu2,250000.0,390000.00000000006,306000.0,4,3,1,400000
3032, ikorodu road shomolu lagos,7,4,3,4,"Executive Newly Built very spacious 3bedroom flat with all rooms ensuite + guest toilet,pop finished, fitted with wardrobe and kitchen cabinet. down flat: 1.5m Up flat: 2m Located off Ikorodu road , palmgroove Project is 98% ... New. Security. All Room Ensuit. Big Compound. Supermarket Nearby. Restaurants Nearby. Security Doors. Parking Space. Pop Ceiling. 24 Hours Security. Drainage System. Street Lights. ...",ikorodu,1,1,1,1,ikorodu4,600000.0,740000.0000000001,669999.9999999999,4,14,3,1200000
3033, macaulay igbogbo ikorodu lagos,5,3,2,3,"Newly built 2 bed Annual rent 200,000 A/C 60,000 Caution fee 10,000 Total:-270,000 ... ...",ikorodu,0,0,0,0,ikorodu3,325000.0,500000.0,400000.0,0,5,1,200000
3034, macaulay igbogbo ikorodu lagos,2,1,1,1,"Annual rent:140,000 A&C:60,000 Total package: 200,000 ... ...",ikorodu,0,0,0,1,ikorodu1,120000.0,150000.0,150000.0,1,1,1,140000
3035, ikorodu lagos,2,1,1,1,A decent mini flat available for rent in Ikorodu The house is located in a clean and secured environment. Its also very close to the main road. ... ...,ikorodu,0,0,0,0,ikorodu1,120000.0,150000.0,150000.0,0,1,1,100000
3036, emily avenue igbogbo ikorodu lagos,5,3,2,3,Annual rent:250k A&C:80k Caution fee:20k Total:350k ... ...,ikorodu,0,0,0,0,ikorodu3,325000.0,500000.0,400000.0,0,5,1,250000
3037, ekundayo street igbogbo ikorodu lagos,4,2,2,2,"2 bedroom flat Annual rent:-250,000 A&C:-80,000 Total:-330,000 ... ...",ikorodu,0,0,0,1,ikorodu2,250000.0,390000.00000000006,306000.0,1,3,1,250000
3038, ikorodu lagos,4,2,2,2,2 bedroom flat for rent in Ikorodu Decent Well tiled ... ...,ikorodu,1,1,1,1,ikorodu2,250000.0,390000.00000000006,306000.0,4,3,1,450000
3039, teacher's quarter igbogbo ikorodu lagos,2,1,1,1,Executive room and parlour ... New. Security. Security Doors. ...,ikorodu,0,0,0,1,ikorodu1,120000.0,150000.0,150000.0,1,1,1,120000
3040, macaulay inside igbogbo ikorodu lagos,2,1,1,1,Annual rent:120k A&C:50k Total: 170k ... ...,ikorodu,0,0,0,1,ikorodu1,120000.0,150000.0,150000.0,1,1,1,120000
3041, fawole bus stop igbogbo ikorodu lagos,2,1,1,1,"Annual rent:72,000 A&C:40,000 Total:112,000 ... ...",ikorodu,0,0,0,0,ikorodu1,120000.0,150000.0,150000.0,0,1,1,80000
3042, elepe royal estate ebute ikorodu lagos,5,3,2,3,"Annual rent:1,000,000 A&C:-200,000 Damages:-100,000 Total:-N1.3 million naira ... ...",ikorodu,1,1,1,1,ikorodu3,325000.0,500000.0,400000.0,4,5,1,900000
3043, ajakaye street igbogbo ikorodu lagos,5,3,2,3,"2 bedrooms Annual rent:-200,000 A&C:-60,000 ... New. ...",ikorodu,0,0,0,0,ikorodu3,325000.0,500000.0,400000.0,0,5,1,200000
3044, ogunlewe street igbogbo ikorodu lagos,2,1,1,1,"Neatly used 2 bedroom flat with fence, gate paved comound and kitchen exit, ... Cheap. Old. Dry. Security. Big Compound. Security Doors. Parking Space. ...",ikorodu,1,1,0,1,ikorodu1,120000.0,150000.0,150000.0,3,1,1,150000
3045, ikorodu lagos,6,3,3,3,Decent 3 bedroom flat for rent in Ikorodu ... ...,ikorodu,0,0,0,1,ikorodu3,325000.0,500000.0,400000.0,1,5,1,350000
3046," total light school,grammar school area ikorodu lagos",7,4,3,4,"Annual rent:350,000 A/C:100,000 Total: 450,000 ... ...",ikorodu,0,0,0,0,ikorodu4,600000.0,740000.0000000001,669999.9999999999,0,14,3,400000
3047, macaulay str igbogbo ikorodu lagos,2,1,1,1,Annual rent:-60k A&C:-40k Total: 100k ... ...,ikorodu,0,0,0,0,ikorodu1,120000.0,150000.0,150000.0,0,1,1,80000
3048, ekundayo street igbogbo ikorodu lagos,2,1,1,1,"A single room self con. Annual rent:80,000 A&C:40,000 Total:120,000 ... ...",ikorodu,0,0,0,0,ikorodu1,120000.0,150000.0,150000.0,0,1,1,80000
3049, ikorodu lagos,4,2,2,2,"Newly built 2 bedroom flat with 3 toilets and 2 bathroom in a decent , well accessible and gated estate in ebute, Ikorodu. 700k. ... ...",ikorodu,1,1,1,1,ikorodu2,250000.0,390000.00000000006,306000.0,4,3,1,600000
3050, ikorodu lagos,2,1,1,1,"Exquisitely finished mini flat flat with excellent features. All rooms tiled, serene environment, and safe neighbourhood. ... ...",ikorodu,1,1,1,1,ikorodu1,120000.0,150000.0,150000.0,4,1,1,200000
3051, lfi igbogbo ikorodu lagos,3,2,1,2,"Annual rent:150,000 A&C:-60,000 Total:210,000 ... ...",ikorodu,0,0,0,0,ikorodu2,250000.0,390000.00000000006,306000.0,0,3,1,150000
3052, selewu street igbogbo ikorodu lagos,2,1,1,1,"Executive room self contain with large kitchen, cabinet, larger interlocking compound, fence with gate ... Furnished. Cheap. Old. Dry. Boys Quater. Security. Big Compound. Security Doors. Parking Space. ...",ikorodu,0,0,0,0,ikorodu1,120000.0,150000.0,150000.0,0,1,1,84000
3053, teachers quarter selewu igbogbo igbogbo ikorodu lagos,2,1,1,1,"4unit of newly built mini flat with fence, gate and prepaid meter ... New. Cheap. Dry. Security. Street Lights. ...",ikorodu,0,0,0,1,ikorodu1,120000.0,150000.0,150000.0,1,1,1,120000
3054, ikorodu lagos,4,2,2,2,"Exquisitely finished 2 bedroom flat upstairs in a serene environment, and safe neighbourhood. ... ...",ikorodu,0,0,0,1,ikorodu2,250000.0,390000.00000000006,306000.0,1,3,1,250000
3055, ikorodu lagos,2,1,1,1,A decent mini flat available for rent in Ikorodu The house is located in a clean and secured environment. Its also very close to the main road. ... ...,ikorodu,1,1,0,1,ikorodu1,120000.0,150000.0,150000.0,3,1,1,150000
3056, maternity right side igbogbo ikorodu lagos,3,2,1,2,Newly built room and parlour self Annual rent:-130k A&C:60k Total:-180k ... ...,ikorodu,0,0,0,0,ikorodu2,250000.0,390000.00000000006,306000.0,0,3,1,130000
3057, maternity street igbogbo ikorodu lagos,5,3,2,3,"Well equipped 2 bedroom flat located at maternity area Annual rent: 180,000 A&C:60,000 Total:240,000 ... ...",ikorodu,0,0,0,0,ikorodu3,325000.0,500000.0,400000.0,0,5,1,200000
3058," korperate,macaulay igbogbo ikorodu lagos",2,1,1,1,A single room self con that's well furnished Annual rent:60k A&C:40k Total:100k ... ...,ikorodu,0,0,0,0,ikorodu1,120000.0,150000.0,150000.0,0,1,1,80000
3059, ikorodu express rd ojota ojota ojota lagos,12,6,6,6,"WAREHOUSE FOR LEASE: MORE THAN 3,000SQM OF WAREHOUSE ON A LAND SIZE OF 5,000 SQM WITH OFFICE SPACE ALONG IKORODU ROAD OJOTA FACING THE EXPRESSWAY . CAN BE ALONE IN A SELF COMPOUND. PRICE: ... Old. Furnished. Street Lights. Security. Security Doors. Big Compound. Water Treatment. Drainage System. Office Supplies. Parking Space. ...",ikorodu,1,1,0,1,ikorodu6,1500000.0,1500000.0,1500000.0,3,34,6,1500000
3060," offin, igbogbo igbogbo ikorodu lagos",4,2,2,2,"Newly renovated apartment, just like new, for N200,000 Generator house Fence & Gate with security wire Painted apartment Stamped flooring Posted on 10th of April, 2020 Call [redacted] WhatsApp. [redacted] ... Renovated. Church Nearby. Big Compound. Mosques Nearby. Security. Parking Space. Supermarket Nearby. ...",ikorodu,0,0,0,0,ikorodu2,250000.0,390000.00000000006,306000.0,0,3,1,200000
3061, harmony ebute ikorodu lagos,8,4,4,4,This property is built in a serene environment with comfort living. ... Cheap. Furnished. New. Parking Space. All Room Ensuit. Pop Ceiling. ...,ikorodu,0,0,0,0,ikorodu4,600000.0,740000.0000000001,669999.9999999999,0,14,3,400000
3062, oga- oloye street igbogbo ikorodu lagos,4,2,2,2,This a comfort at itâ€™s best. ... Cheap. Furnished. New. Security Doors. Parking Space. All Room Ensuit. Security. ...,ikorodu,0,0,0,0,ikorodu2,250000.0,390000.00000000006,306000.0,0,3,1,150000
3063," olarenwaju avenue, igbe laara, ikorodu. 08080763982 ikorodu ikorodu lagos",4,2,2,2,"A well furnish room and Parlour with 2toilets and bathrooms, Kitchen , with already installed pre paid metres, with functional borehole on a separate Pre paid metre ... Furnished. New. Pop Ceiling. ...",ikorodu,0,0,0,0,ikorodu2,250000.0,390000.00000000006,306000.0,0,3,1,150000
3064," eleshin area, itamaga, ikorodu lagos",6,3,3,3,Newly built 3bed flat in a calm and peaceful neighborhood. Features: POP Ceiling Spacious sitting room Dinning All rooms ensuite Cross ventilation Constant light Drinkable borehole water Water heater Wardrobe Big kitchen with cabinet Spacious parking lot Paved compound Proximity to the tarred road Price: 300k per annum ... New. Big Compound. Drainage System. Security. Water Treatment. Parking Space. 24 Hours Electricity. Street Lights. 24 Hours Security. All Room Ensuit. Pop Ceiling. ...,ikorodu,0,0,0,0,ikorodu3,325000.0,500000.0,400000.0,0,5,1,300000
3065, agunfoye beside lagos state model college igbogbo ikorodu lagos,7,4,3,4,Annual rent:250k A&C:-100k Total:350k ... ...,ikorodu,0,0,0,0,ikorodu4,600000.0,740000.0000000001,669999.9999999999,0,14,3,400000
3066," patrick uzor street, agura ikorodu ikorodu ikorodu lagos",5,3,2,3,A Block of 4 numbers ... ...,ikorodu,0,0,0,0,ikorodu3,325000.0,500000.0,400000.0,0,5,1,200000
3067," hilltop estate radio,itamaga ikorodu ikorodu lagos",2,1,1,1, It a room and parlour self contain with a mini lobby all tiles ... Renovated. Dry. Security. Water Treatment. Parking Space. ...,ikorodu,1,1,0,1,ikorodu1,120000.0,150000.0,150000.0,3,1,1,150000
3068," 3, lead way drive igbolomu agric agric ikorodu lagos",4,2,2,2,"Well tiles interior, fenced and gated building, well furnished kitchen and bathroom. ... Old. Cheap. Furnished. Big Compound. Water Treatment. Children Play Ground. Street Lights. Church Nearby. Security. 24 Hours Security. Mosques Nearby. 24 Hours Electricity. Parking Space. Drainage System. Child Care. ...",ikorodu,0,0,0,0,ikorodu2,250000.0,390000.00000000006,306000.0,0,3,1,150000
3069, 1 keyolu street erunwen ikorodu lagos ikorodu ikorodu lagos,2,1,1,1,It a room and parlour self containe with a mini lobby all tiles ... Renovated. Dry. Water Treatment. Parking Space. Security. Big Compound. ...,ikorodu,1,1,0,1,ikorodu1,120000.0,150000.0,150000.0,3,1,1,150000
3070, ebute road ikorodu lagos,4,2,2,2,"Newly built of Mini Flat To Let at Ebute Ikorodu axis with all tiles price: N300,000 ... ...",ikorodu,0,0,0,1,ikorodu2,250000.0,390000.00000000006,306000.0,1,3,1,300000
3071, ebute road ebute ikorodu lagos,6,3,3,3,Newly built of 2bedroom flat all room en-suite at Ebute Ikorodu Lagos. Price: N600k per annum ... ...,ikorodu,1,1,1,1,ikorodu3,325000.0,500000.0,400000.0,4,5,1,600000
3072, alago off radio ikorodu ikorodu lagos,2,1,1,1,"One room self contain Very spacious with fenced , floored and gated compound ... Dry. Serviced. ...",ikorodu,0,0,0,1,ikorodu1,120000.0,150000.0,150000.0,1,1,1,120000
3073," 2, oladogba street, opposite federal low cost housing estate. akasoleri. ikorodu -old ijebu ode road, after ile episode bus stop. ikorodu ikorodu lagos",3,2,1,2,"Well finished, tiled Room and Parlour self contained with visitors toilet. Neatly built in a neat compound. ... New. Parking Space. All Room Ensuit. ...",ikorodu,0,0,0,0,ikorodu2,250000.0,390000.00000000006,306000.0,0,3,1,180000
3074," nurudeen oyebola street,yusuf bus stop, selewu igbogbo ikorodu lagos",6,3,3,3,Two bedroom flat All room en-suit Parking space Visitors toilet ... Security. Big Compound. Parking Space. ...,ikorodu,0,0,0,0,ikorodu3,325000.0,500000.0,400000.0,0,5,1,200000
3075,  masha surulere lagos,5,3,2,3,The Property is a newly built two bedrooms semi-detached terrace duplex in a serene environment with good access roads. The premises can only accommodate two cars. The duplex has a guest toilet with both rooms ... New. Street Lights. Supermarket Nearby. All Room Ensuit. Church Nearby. Security Doors. Restaurants Nearby. Security. ...,surulere,1,1,1,1,surulere3,1000000.0,1500000.0,1500000.0,4,27,5,1700000
3076,  off adeniran ogunsanya adeniran ogunsanya surulere lagos,6,3,3,3,Nice And Well Shaped 3Bedroom Bungalow Office Space Just Requires Painting. 1.5m per annum 2years. ... Renovated. Cheap. Street Lights. Pop Ceiling. Security. All Room Ensuit. Parking Space. 24 Hours Electricity. Water Treatment. Security Doors. 24 Hours Security. ...,surulere,1,1,0,1,surulere3,1000000.0,1500000.0,1500000.0,3,27,5,1500000
3077,  raufu williams off adisa bashua street adelabu surulere lagos,8,4,4,4,"Renovated 4bedroom Semi Detached Duplex Plus bq 4t4b all round tiles, PVC Ceiling Finishing, Wardrobes in all rooms, fitted kitchen Cabinet, ample parking space for like 5cars at Raufu Williams Street off Adelabu Street, Surulere. ... Renovated. ...",surulere,1,1,1,1,surulere4,1300000.0,2680000.0000000005,2199999.999999999,4,31,6,3000000
3078,  johnson street bode thomas surulere lagos,5,3,2,3,"Serviced Newly Built and Tastefully Finished 2bedroom flat all rooms ensuite with guest toilet Downstairs pop ceiling finishing, wardrobes, fitted kitchen cabinet at Johnson Street off Bode Thomas Street. Rent: #1,500,000 a year rent Legal fees/agreements ... New. ...",surulere,1,1,0,1,surulere3,1000000.0,1500000.0,1500000.0,3,27,5,1500000
3079,  bethel estate iponri iponri surulere lagos,9,5,4,5,"Serviced Newly Built and Tastefully Finished Spacious 4bedroom Terrace Duplex plus a room bq, all rooms en suite with guest toilet, all round tiles, all round tiles, pop ceiling finishing, wardrobes, fitted kitchen cabinets Serene ... Serviced. Cheap. Dry. New. Street Lights. Parking Space. Ocean View. Jacuzzi. Fast Internet. Water Treatment. Boys Quater. Child Care. Drainage System. 24 Hours Security. Big Compound. Pop Ceiling. Security. All Room Ensuit. 24 Hours Electricity. Supermarket Nearby. Security Doors. ...",surulere,0,0,0,0,surulere5,3200000.0,3500000.0,3440000.0,0,47,8,3000000
3080,  seriki street idi araba surulere lagos,5,3,2,3,"Lovely And Spacious 2bedroom flat Upstairs double balcony, all rooms ensuite with guest toilet, all round tiles, pop ceiling finishing, fitted kitchen Cabinet at Seriki Street off Ishaga Road, Idi Araba After Luth. #700k a ... Renovated. Street Lights. Big Compound. Restaurants Nearby. Security. All Room Ensuit. Parking Space. Supermarket Nearby. Water Treatment. Security Doors. Drainage System. 24 Hours Security. ...",surulere,0,0,0,0,surulere3,1000000.0,1500000.0,1500000.0,0,27,5,700000
3081,  benson street off akerele street ogunlana surulere lagos,6,3,3,3,"Very spacious and Lovely 3bedroom flat upstairs first floor with 3t3b, all round tiles, pop ceiling in the sitting room, wardrobes, fitted kitchen cabinet at Benson Street off Akerele Street, Surulere. #1.5m last ... ...",surulere,1,1,0,1,surulere3,1000000.0,1500000.0,1500000.0,3,27,5,1500000
3082,  off cole street by olufemi street via ogunlana surulere lagos,7,4,3,4,"Lovely 3bedroom flat upstairs all rooms ensuite with guest toilet, all round tiles, wardrobes, fitted kitchen cabinet 3tenant in the compound with prepaid metre at Zamba Street off Cole Street by Olufemi Street Via Ogunlana ... Renovated. ...",surulere,0,0,0,0,surulere4,1300000.0,2680000.0000000005,2199999.999999999,0,31,6,1000000
3083,  anjorin street off cole street via olufemi street ogunlana surulere lagos,6,3,3,3,"Newly Built and Tastefully Finished 3bedroom flat Upstairs 3toilet 3bathrooms all round tiles, pop ceiling finishing, wardrobes, prepaid metre at Anjorin Street off Cole Street Via Olufemi Street Ogunlana. #1.5m a year rent. ... ...",surulere,1,1,0,1,surulere3,1000000.0,1500000.0,1500000.0,3,27,5,1500000
3084,  a serene environment off oyekan street ogunlana surulere lagos,9,5,4,5,"Newly Built and Tastefully Finished 4bedroom Semi Detached Duplex all round Marble tiles, pop ceiling finishing, wardrobes, fitted kitchen cabinet ample parking space at Awoyemi Close off Oyekan Street, Ogunlana Drive Surulere. #3.5m asking ... New. ...",surulere,1,1,0,1,surulere5,3200000.0,3500000.0,3440000.0,3,47,8,3500000
3085,  games village bode thomas surulere lagos,2,1,1,1,"Lovely 2bedroom flat upstairs 3rd floor with 1toilet & 1bathroom at Games Village, Bode Thomas, Surulere. #900k one year ... ...",surulere,1,1,1,1,surulere1,500000.0,700000.0,609999.9999999998,4,11,2,700000
3086,  rasaq balogun street adeniran ogunsanya surulere lagos,4,2,2,2,"A 4bedroom fully detached bungalow at Rasaq Balogun Street off Adebola Street, Adeniran Ogunsanya. #2.5m x2yrs rent or 2m x3yrs ... ...",surulere,1,1,1,1,surulere2,850000.0,1420000.0000000002,1119999.9999999995,4,23,4,1500000
3087,"  eric manuel crescent, off bode thomas street, surulere lagos bode thomas surulere lagos",8,4,4,4,"Four (4) Bedroom Duplex at Eric Manuel Crescent, Off Bode Thomas Street, Surulere Lagos. The property has an ample parking space, security/driver's quarters and it is in a very serene and secured neighborhood which makes it ... Old. Cheap. Boys Quater. Security. Pop Ceiling. Big Compound. Parking Space. ...",surulere,1,0,1,1,surulere4,1300000.0,2680000.0000000005,2199999.999999999,3,31,6,2500000
3088,  obele surulere lagos,2,1,1,1,"Lovely clean mini flat for rent at obele area,upstairs Surulere Lagos Rent: N500,000 Kindly call the phone numbers below for more info; APRO GLOBAL REAL ESTATES Web:info@aproglobalestate. com.ng. Tel: 01-7620139 Mobile: 080-51-595-336,080-29-481-639 070-63-822-217, 070-82-974-088 ... Security. Supermarket Nearby. Restaurants Nearby. ...",surulere,0,0,0,1,surulere1,500000.0,700000.0,609999.9999999998,1,11,2,500000
3089, kilo marsha surulere lagos,8,4,4,4,This is a house that is demolishable measuring 360 square metres in the heart of kilo aguda .The property is in a close and it is old so any one that buys would ... ...,surulere,1,1,1,1,surulere4,1300000.0,2680000.0000000005,2199999.999999999,4,31,6,3000000
3090,  lawanson surulere lagos,5,3,2,3," For lease: Newly built two bedroom flat with all rooms ensuit, visitors toilet, water heater, wardrobe, fitted kitchen cabinet,100kva generating set, parking lot off Cole street, lawanson,surulere,Lagos. Rent:N950k a year and half SC:N168k Caution:N70k Service charge covers; Sec, cleaning, ... ...",surulere,0,0,0,0,surulere3,1000000.0,1500000.0,1500000.0,0,27,5,950000
3091,  lawanson surulere lagos,7,4,3,4,"FOR LEASE: Newly built 3 bedroom serviced flat with all room ensuit, visitors toilet, wardrobe,fitted kitchen cabinets, parking lot for two cars, standby 100kva generating set,prepaid meter at anjorin,off Cole street, lawanson, surulere,Lagos Rent:N1.3m a year ... ...",surulere,0,0,0,1,surulere4,1300000.0,2680000.0000000005,2199999.999999999,1,31,6,1300000
3092,  off cole street. lawanson surulere lagos,5,3,2,3,2 bedroom Flat / Apartment for rent Off Cole street. Lawanson Surulere Lagos ... Serviced. Dry. New. Survey. Water Treatment. Street Lights. Security. Security Doors. All Room Ensuit. 24 Hours Security. Pop Ceiling. ...,surulere,0,0,0,0,surulere3,1000000.0,1500000.0,1500000.0,0,27,5,950000
3093,  akinhanmi western avenue surulere lagos,2,1,1,1,Office space for rent @akinhanmi street off Western avenue ... Renovated. ...,surulere,1,1,1,1,surulere1,500000.0,700000.0,609999.9999999998,4,11,2,700000
3094,  bashiru agusto street bode thomas surulere lagos,4,2,2,2,Very standard 2bedroom flat ground floor @ Bashir agusto. #1.3m. 1yr. ... Old. Big Compound. All Room Ensuit. Water Treatment. ...,surulere,1,0,1,1,surulere2,850000.0,1420000.0000000002,1119999.9999999995,3,23,4,1300000
3095, bamk olemoh ogunlana surulere lagos,4,2,2,2,Mini flat at bank olemoh Surulere ... New. ...,surulere,0,0,0,0,surulere2,850000.0,1420000.0000000002,1119999.9999999995,0,23,4,700000
3096,  simisola street ogunlana surulere lagos,2,1,1,1,"Mini flat in a serene environment with prepaid meter, upstairs, separate toilet and bath @ Simisola str, off Olufemi by Ogunlana drive. Surulere. 700k 1year ... Old. Parking Space. ...",surulere,1,1,1,1,surulere1,500000.0,700000.0,609999.9999999998,4,11,2,700000
3097,  ketu close aguda surulere lagos,5,3,2,3,"2 bedrm flat,all Rooms ensuites,3toilet 2baths at No 6, Ketu close, Aguda, Surulere. *Rent 1 year - N750,000 *Agency fee - N150,000 *Legal fee - ... New. ...",surulere,0,0,0,0,surulere3,1000000.0,1500000.0,1500000.0,0,27,5,750000
3098,  - bode thomas surulere lagos,9,5,4,5," SURULERE. ( now *VACANT* ) LETTING Vacant 4 bedrooms Maisonette Flat with 1 room bq (consist of) 3 *bedrooms* up 1 guest rooms, sitting rm. and Sitting down down & 1 *room boys quarter* In WILLIAMS ... Boys Quater. Security. All Room Ensuit. Big Compound. Parking Space. Pop Ceiling. ...",surulere,0,0,0,0,surulere5,3200000.0,3500000.0,3440000.0,0,47,8,2500000
3099,  back of luth idi araba surulere lagos,2,1,1,1,New standard miniflats (1bedroom Apartment) LOCATION: at the back of LUTH Just roofed Plastering Tiling & painting completed Mini upstairs 350k 1yrs NOTE - Only one miniflats remaining ... New. Security. Big Compound. Parking Space. ...,surulere,0,0,0,0,surulere1,500000.0,700000.0,609999.9999999998,0,11,2,350000
3100,  adekunle kuye street adelabu surulere lagos,5,3,2,3, Very nice and spacious 3 bedroom ground floor flat 3 toilets/2 baths LOCATION; Adekunle Kuye Street Surulere N1M pa. ... ...,surulere,0,0,0,1,surulere3,1000000.0,1500000.0,1500000.0,1,27,5,1000000
3101, masha surulere lagos,6,3,3,3,"Pictures for- 2bedroom flat, all room en-suite upstairs, kitchen cabinet, interlock compound in a serene environment @ Mba-onu ojike street, off Ayinde giwa, Masha. Surulere. #1.250, 1year. ... ...",surulere,0,0,0,1,surulere3,1000000.0,1500000.0,1500000.0,1,27,5,1250000
3102, jalupon adeniran ogunsanya surulere lagos,9,5,4,5,"Lovely And Well Maintained 4bedroom Detached Duplex,All Room Ensuite, Guest Toilet, Pop,Fitted Wardrobes, A Room Bq,Security House,Serene And Secure Estate Jalopon Off Adeniran Ogunsanya Surulere ... Renovated. Cheap. Big Compound. Pop Ceiling. Security. All Room Ensuit. 24 Hours Electricity. Security Doors. Boys Quater. Drainage System. 24 Hours Security. ...",surulere,0,0,0,1,surulere5,3200000.0,3500000.0,3440000.0,1,47,8,3200000
3103, folawiyo bankole street masha surulere lagos,7,4,3,4,"Lovely Serviced 3bedroom flat upstairs all rooms ensuite with guest toilet all round tiles, pop ceiling finishing, wardrobes, fitted kitchen cabinet at Folawiyo bankole street Off Masha Road Surulere. #1.5m a year rent Service Charge: #400k ... Renovated. ...",surulere,0,0,0,1,surulere4,1300000.0,2680000.0000000005,2199999.999999999,1,31,6,1500000
3104, off eloseh street adelabu surulere lagos,7,4,3,4,"Superb and Executive Semi Detached 3bedroom Duplex all rooms emsuite with guest toilet, wardrobes, kitchen cabinet at Olaseni Diyaolu off Eloseh Street via Agboyin Street by Adelabu Street, Surulere. Rent: 2m not negotiable. All tied P.o.p. Chandelier Screeded ... ...",surulere,0,0,0,1,surulere4,1300000.0,2680000.0000000005,2199999.999999999,1,31,6,2000000
3105, ladipo labinjo bode thomas surulere lagos,12,6,6,6,"Very Clean And Well Maintained 4Bedroom Detached Bungalow With 2Bedroom Bq , Big Compund, Serene And Well Secure Neighbourhood Off Bode Thomas Surulere. 2years Required. ... Renovated. Old. Dry. Street Lights. Big Compound. Pop Ceiling. Security. All Room Ensuit. 24 Hours Electricity. Supermarket Nearby. Security Doors. 24 Hours Security. ...",surulere,1,1,0,1,surulere6,3000000.0,3000000.0,3000000.0,3,43,8,3000000
3106, olayemi street off nnobi street by agboyin street adelabu surulere lagos,6,3,3,3,"Newly Built and Tastefully Finished Spacious 2bedroom flat all rooms ensuite with guest toilet, upstairs and downstairs, all round tiles, pop ceiling finishing, wardrobes, fitted kitchen cabinet at Olayemi Street off Nnobi Street by by ... New. ...",surulere,1,1,0,1,surulere3,1000000.0,1500000.0,1500000.0,3,27,5,1500000
3107, cole street lawanson surulere lagos,6,3,3,3,A clean 2bedrm flat at Cole street lawanson wit all tiles and water running in a gate compound wit tiles and kitchen cabinets ... Renovated. Supermarket Nearby. Parking Space. Street Lights. Security Doors. ...,surulere,0,0,0,0,surulere3,1000000.0,1500000.0,1500000.0,0,27,5,700000
3108, kilo marsha surulere lagos,6,3,3,3,"Renovated 3bedroom flat upstair with master bedroom ,all round tiles , Waldrop, carpark, borehole water,@ olayemi close very close to Adelabu street surulere Lagos State Price_#1.2m 1y ... ...",surulere,0,0,0,1,surulere3,1000000.0,1500000.0,1500000.0,1,27,5,1200000
3109, adeniran ogunsanya surulere lagos,6,3,3,3,Good 4 bedroom bungalow alone in the compound at Rasaq Balogun off adeniran ogunsanya surulere for commercial or residential Price_#2.5m ... ...,surulere,1,1,1,1,surulere3,1000000.0,1500000.0,1500000.0,4,27,5,2000000
3110, ... adeniran ogunsanya surulere lagos,4,2,2,2,Decent 3bedroom bongalow office space with ample car park @ rasak balogun street off adeniran ogunsanya surulere Lagos Price_ #2.5m ... ...,surulere,1,1,1,1,surulere2,850000.0,1420000.0000000002,1119999.9999999995,4,23,4,1500000
3111, - western avenue surulere lagos,2,1,1,1,"???? ???? TO ???? LET ???? VERY BIG ROOM IN A FLAT, AT BISHOP SURULERE LAGOS, WITH WATER CARPARK CLEAN COMPAND, A YEAR RENT BUDGET .. #150K. ... ...",surulere,0,0,0,0,surulere1,500000.0,700000.0,609999.9999999998,0,11,2,300000
3112, - masha surulere lagos,4,2,2,2, 2bedroom BUNGALOW @ olukole close off ajao rd SURULERE N850k peranum. for both RESIDENT/COMMERCIAL USE. ... ...,surulere,0,0,0,1,surulere2,850000.0,1420000.0000000002,1119999.9999999995,1,23,4,850000
3113, ogunlana surulere lagos,7,4,3,4,Clean 3bedroom flat all ensuit at Falolu off ogunlana drive surulere lagos ... ...,surulere,0,0,0,1,surulere4,1300000.0,2680000.0000000005,2199999.999999999,1,31,6,1300000
3114, off lawonson road lawanson surulere lagos,6,3,3,3,"A Newly renovated apartment Car park, water, wardrobe, kitchen cabinets and clean. Rent:650,000 per annum For Inspection please call; Sunday The Property Concession Company ... Cheap. Renovated. Water Treatment. Security. Pop Ceiling. Street Lights. Big Compound. All Room Ensuit. Supermarket Nearby. Parking Space. 24 Hours Security. Restaurants Nearby. ...",surulere,0,0,0,0,surulere3,1000000.0,1500000.0,1500000.0,0,27,5,700000
3115, .. ogunlana surulere lagos,4,2,2,2,Just out Decent 3 bedroom flat with car park at James Robertson close to ogunlana drive surulere #1m ... ...,surulere,0,0,0,1,surulere2,850000.0,1420000.0000000002,1119999.9999999995,1,23,4,1000000
3116, obele ogunlana surulere lagos,4,2,2,2,"A Lovely Spacious 3 Bedroom Flat in a good area of Surulere. Spacious, neat, water, secured environment. For inspection please call Sunday; The Property Concession Company ... Cheap. Serviced. Furnished. New. Security Doors. Security. Pop Ceiling. Street Lights. Big Compound. All Room Ensuit. Supermarket Nearby. Parking Space. 24 Hours Security. Restaurants Nearby. ...",surulere,0,0,0,0,surulere2,850000.0,1420000.0000000002,1119999.9999999995,0,23,4,800000
3117, ogunlana surulere lagos,2,1,1,1,Newly renovated Roomself on Ogunlana drive for 350k ... ...,surulere,0,0,0,0,surulere1,500000.0,700000.0,609999.9999999998,0,11,2,350000
3118, western avenue surulere lagos,2,1,1,1,Newly built mini flat with p.o.p & car park bore water @ akinomi street off Western avenue surulere #400k ... ...,surulere,0,0,0,0,surulere1,500000.0,700000.0,609999.9999999998,0,11,2,400000
3119, - western avenue surulere lagos,13,5,8,5,"LEASE!!!! 8 bedroom house with bq behind on Adisa Bashua, can be used for hospital or office @5m a yr ... ...",surulere,1,1,0,1,surulere5,3200000.0,3500000.0,3440000.0,3,47,8,3500000
3120, .. adelabu surulere lagos,4,2,2,2,Lovely good 3bedroom flat with 2T+2B on Agbonyin off adelabu street surulere lagos #1m ... ...,surulere,0,0,0,1,surulere2,850000.0,1420000.0000000002,1119999.9999999995,1,23,4,1000000
3121, ogunlana surulere lagos,2,1,1,1,"Lovely clean mini flat(lsdpc building)at obele area,upstairs surulere Lagos,#500t*1yr ... ...",surulere,0,0,0,1,surulere1,500000.0,700000.0,609999.9999999998,1,11,2,500000
3122, ogunlana surulere lagos,6,3,3,3,Newly built 2bedroom flat @ subuola street by olufemi off ogunlana drive surulere Lagos #1m ... ...,surulere,0,0,0,1,surulere3,1000000.0,1500000.0,1500000.0,1,27,5,1000000
3123, off ojuelegba road ojuelegba surulere lagos,2,1,1,1,"A Spacious Clean Standard Miniflat 1 toilet 1 bathroom, water, kitchen Fenced round with gates, secure environment Rent: 400,000 per annum For inspection please call; Sunday, The Property Concession Company ... Renovated. Security Doors. Security. Pop Ceiling. Street Lights. Big Compound. All Room Ensuit. Supermarket Nearby. Parking Space. 24 Hours Security. Restaurants Nearby. ...",surulere,0,0,0,0,surulere1,500000.0,700000.0,609999.9999999998,0,11,2,400000
3124, adelabu surulere lagos,2,1,1,1,"*JUST IN!* Very lovely 2Bedroom flat on Illorin street, off Adelabu, Surulere. Ground floor, 1 toilet 1 Bath, POP ceiling. 900k asking. Call for viewing. ... ...",surulere,1,1,1,1,surulere1,500000.0,700000.0,609999.9999999998,4,11,2,700000
3125, close to ojuelegba ojuelegba surulere lagos,2,1,1,1,"A Newly Built Spacious Neat Miniflat Spacious, Neat, well finished, water Kitchen etc. Rent: 500,000 For inspection please call Sunday, The Property Concession Company ... Serviced. New. Security Doors. Security. Pop Ceiling. Street Lights. Big Compound. All Room Ensuit. Supermarket Nearby. Parking Space. 24 Hours Security. Restaurants Nearby. ...",surulere,0,0,0,1,surulere1,500000.0,700000.0,609999.9999999998,1,11,2,500000
3126, off lawonson lawanson surulere lagos,2,1,1,1,"A Lovely Miniflat at Lawanson environment. 1 toilet and bathrooms, kitchen cabinets, prepaid meter, Car park, water,. Rent: 400,000 a year rent. For inspection please call; Sunday, The Property Concession Company ... Serviced. Renovated. Boys Quater. Security. Pop Ceiling. Street Lights. Big Compound. All Room Ensuit. Parking Space. 24 Hours Security. Restaurants Nearby. ...",surulere,0,0,0,0,surulere1,500000.0,700000.0,609999.9999999998,0,11,2,400000
3127, kilo marsha surulere lagos,6,3,3,3, 2 wings of magnificent and superb 5 years old duplex. 3bedroom duplex. All tied P.o.p. Chandelier Screeded walls Water heater All rooms ensuite with guest toilet. Kitchen cabinet Wardrobes Store Dining section. Pay and parkin. Modern finishing. Heat extractor. Price : 2m. Location: ... ...,surulere,1,1,1,1,surulere3,1000000.0,1500000.0,1500000.0,4,27,5,2000000
3128, ogunlana surulere lagos,2,1,1,1,Nice 3bed room flat upstairs with prepaid meter @ Samshonibare str off Ogunlana drive Surulere Price _ #1.3m per Ann ... ...,surulere,1,1,1,1,surulere1,500000.0,700000.0,609999.9999999998,4,11,2,700000
3129, akerele randle avenue surulere lagos,4,2,2,2,A clean 2bedrm flat off akerele wit water and car park all tiles in a gate compound surulere ... Renovated. Parking Space. Security. Street Lights. Security Doors. ...,surulere,0,0,0,0,surulere2,850000.0,1420000.0000000002,1119999.9999999995,0,23,4,500000
3130, airways ijesha surulere lagos,2,1,1,1,A clean mini flat at ijesha surulere wit water and car park all tiles in a gate compound ... Renovated. Street Lights. Security. Security Doors. Supermarket Nearby. Parking Space. ...,surulere,0,0,0,0,surulere1,500000.0,700000.0,609999.9999999998,0,11,2,350000
3131, airways ijesha surulere lagos,2,1,1,1,A clean mini flat at ijesha surulere wit car park and water all tiles in a gate compound.serene environment ... Renovated. Security Doors. Supermarket Nearby. Street Lights. Parking Space. Security. ...,surulere,0,0,0,0,surulere1,500000.0,700000.0,609999.9999999998,0,11,2,350000
3132," akinyele streeta off adekunle kuye,by adelabu surulere aguda surulere lagos",6,3,3,3,"Super and out executive 2 flat, all rooms ensuit, treated bore hole ample parking space, up stairs, kitchen Cabinets and war drop, well tiled floors and fenced compound,massive balcony and cross ventilated room s ... ...",surulere,0,0,0,0,surulere3,1000000.0,1500000.0,1500000.0,0,27,5,800000
3133, airways ijesha surulere lagos,2,1,1,1,A clean mini flat at ijesha surulere wit water and car park all tiles wit gate compound ... Dry. Renovated. Big Compound. Supermarket Nearby. Security Doors. Water Treatment. Security. Street Lights. ...,surulere,0,0,0,0,surulere1,500000.0,700000.0,609999.9999999998,0,11,2,350000
3134, off ogunlana drive ogunlana surulere lagos,6,3,3,3,New house 2bedroom duplex off ogunlana drive #1.6m one year ... Renovated. Children Play Ground. Parking Space. All Room Ensuit. Pop Ceiling. Big Compound. ...,surulere,1,1,0,1,surulere3,1000000.0,1500000.0,1500000.0,3,27,5,1600000
3135, ishaga road itire surulere lagos,6,3,3,3,Brand new house 2 bedroom flat all rooms en-suite with a guest toilet surulere 750k one year rent only. ... ...,surulere,0,0,0,0,surulere3,1000000.0,1500000.0,1500000.0,0,27,5,750000
3136, ishaga road itire surulere lagos,4,2,2,2,"Brand new house 2 bedroom flat all rooms en-suite with a guest toilet off ishaga road. Rent: #700k one year rent only (No legal fees,No caution fees ,agency fees 70k). ... ...",surulere,0,0,0,0,surulere2,850000.0,1420000.0000000002,1119999.9999999995,0,23,4,700000
3137," by akanbi crescent off aturashe , surulere lagos ojuelegba surulere lagos",7,4,3,4,"Property Description A Super and Executive 3 bedroom flat, 3 yrs old House,.. with 4 toilet and 3 bath ,All rooms- En-suit War-drops,Ample parking space, Water Heater,Italian Tiled floor,Kitchen Cabinets, War-drops .. All master bedroom, ... ...",surulere,0,0,0,0,surulere4,1300000.0,2680000.0000000005,2199999.999999999,0,31,6,1000000
3138, off cole street lawanson surulere lagos,6,3,3,3,"Newly built 2bedroom flat all rooms ensuit with a guest toilet, water heater, Pop finishing all round tiles at coal street off lawanson surulere 950k per annum one year six months required ... New. ...",surulere,0,0,0,0,surulere3,1000000.0,1500000.0,1500000.0,0,27,5,950000
3139," ishaga road, via luth ojuelegba surulere lagos",2,1,1,1,"A super and Executive miniflat to be shared by a female medical Doctor just about 5/8 minute's walk , with treated bore hole water and ample parking space, kitchen cabinet and war drop, well tiled ... ...",surulere,0,0,0,0,surulere1,500000.0,700000.0,609999.9999999998,0,11,2,300000
3140, idita bode thomas surulere lagos,2,1,1,1,"An executive mini flat with a toilet and bath, floor finished with ceramic tiles, kitchen fitted with cabinet, room with wardrobes. It is very spacious, ample parking space and it is located in a serene ... ...",surulere,1,1,1,1,surulere1,500000.0,700000.0,609999.9999999998,4,11,2,700000
3141, off bode thomas bode thomas surulere lagos,2,1,1,1,"Brand new 2 units Mini flat for letting at off bode thomas,surulere.The rent is 900,000 naira for each unit.minimum rent of 1 year.The property is suitable for 100% Residential Purpose ... New. Parking Space. Mosques Nearby. Church Nearby. Street Lights. Supermarket Nearby. Security. Security Doors. Pop Ceiling. Restaurants Nearby. Big Compound. ...",surulere,1,1,1,1,surulere1,500000.0,700000.0,609999.9999999998,4,11,2,700000
3142, karowi off oduduwa kilo kilo marsha surulere lagos,4,2,2,2," What a Super and Exquisite Outstanding Mini-flat with 2 toilet and 2 bath,up and Downstairs,Balconies in Front and back, Colorfully Painted,With all modern facilities in place, such as Fenced and inter-Lock Compound, Separate pre-paid Meter ... ...",surulere,0,0,0,0,surulere2,850000.0,1420000.0000000002,1119999.9999999995,0,23,4,500000
3143, off ishaga road idi araba surulere lagos,6,3,3,3,New house 2 bedroom flat all rooms en-suite with a guest toilet off ishaga road after luth hospital 700k one year rent only ... ...,surulere,0,0,0,0,surulere3,1000000.0,1500000.0,1500000.0,0,27,5,700000
3144, lawanson surulere lawanson surulere lagos,7,4,3,4,"FOR LEASE: Newly built 3 bedroom serviced flat with all room ensuit, visitors toilet, wardrobe,fitted kitchen cabinets, parking lot for two cars, standby 100kva generating set,prepaid meter at anjorin,off Cole street, lawanson, surulere,Lagos Rent:N1.3m a year ... Serviced. Parking Space. Street Lights. Supermarket Nearby. Security. Security Doors. All Room Ensuit. Big Compound. Drainage System. ...",surulere,0,0,0,1,surulere4,1300000.0,2680000.0000000005,2199999.999999999,1,31,6,1300000
3145, off cole street lawanson surulere lagos,6,3,3,3,"Newly built 2bedroom flat all rooms ensuit with a guest toilet, water heater, Pop finishing all round tiles at coal street off lawanson surulere 950k per annum one year six months required ... New. ...",surulere,0,0,0,0,surulere3,1000000.0,1500000.0,1500000.0,0,27,5,950000
3146," off lawanson road, by zenith bank lawanson surulere lagos",4,2,2,2,"Property Description What a Super and Exquisite Outstanding Mini-flat with 2 toilet and 2 bath,up and Downstairs,Balconies in Front and back, Colorfully Painted,With all modern facilities in place, such as Fenced and inter-Lock Compound, Separate pre-paid ... ...",surulere,0,0,0,0,surulere2,850000.0,1420000.0000000002,1119999.9999999995,0,23,4,500000
3147," by akanbi crescent off aturashe , surulere lagos ojuelegba surulere lagos",6,3,3,3,"Property Description A Super and Executive 4 bedroom Duplex with a room BQ,.. with 3 toilet and 2 bath ,Ample parking space, Water Heater,Italian Tiled floor,Kitchen Cabinets, Wardrops .. master bedroom, Ample parking space, treated bore ... ...",surulere,1,1,0,1,surulere3,1000000.0,1500000.0,1500000.0,3,27,5,1500000
3148, adeniran ogunsanya adeniran ogunsanya surulere lagos,16,8,8,8,Newly built storey building on Adeniran Ogunsanya for office use #400 per annum asking price ... New. Parking Space. Big Compound. ...,surulere,1,1,0,1,surulere8,4000000.0,4000000.0,4000000.0,3,50,9,4000000
3149, sam-shonibare estate by olufemi off ogunlauna drive ogunlana surulere lagos,6,3,3,3,"A Super and Executive 3 bedrooms with 3toilets and bath, treated bore hole water and ample parking space, up stairs fromt with 2 balconies, block of 4 flats, well tiled floors, very spacious kitchen, located ... ...",surulere,0,0,0,1,surulere3,1000000.0,1500000.0,1500000.0,1,27,5,1000000
3150, - lawanson surulere lagos,7,4,3,4,"Lovely 3bd all ensuit with wardrobes, up floor with prepaid meter, dining area, gated compound for #900k a yr at Lawanson, Surulere Lagos ... Parking Space. Supermarket Nearby. Security. Security Doors. All Room Ensuit. Big Compound. Drainage System. ...",surulere,0,0,0,0,surulere4,1300000.0,2680000.0000000005,2199999.999999999,0,31,6,1000000
3151, lawanson surulere lagos,6,3,3,3,A Clean 3bd with 3t/b at Lawanson for #650k ... Parking Space. Street Lights. Supermarket Nearby. Security. Security Doors. Big Compound. Drainage System. ...,surulere,0,0,0,0,surulere3,1000000.0,1500000.0,1500000.0,0,27,5,700000
3152, off ishaga rd via (luth) surulere ojuelegba surulere lagos,4,2,2,2,"Property Description MODERN AND LUXURY 4 NUMBERS OF MINIFLAT, ON ABOUT 300SQM ,NEWLY BUILT WITH 2 TOILET AND 2 BATH, WITH KITCHEN CABINETS,AMPLE PARKING SPACE, TREATED BORE-HOLE WATER, WELL TILED, FENCED COMPOUND, HAS A VERY GOOD ... ...",surulere,1,1,1,1,surulere2,850000.0,1420000.0000000002,1119999.9999999995,4,23,4,1500000
3153, michael ogun street by ogunlauna junction by itere ogunlana surulere lagos,2,1,1,1,"Super and Executive Mini flat, up stairs with treated bore hole water and ample parking, kitchens cabinet and prepaid meter, we'll tiled floor, different rooms room for toilet and bathroom.....located off Michael Ogun street ... ...",surulere,0,0,0,1,surulere1,500000.0,700000.0,609999.9999999998,1,11,2,500000
3154, off masha masha surulere lagos,2,1,1,1,"Mini flat for letting in a secure close at off masha,surulere.The rent is 600,000 naira.minimum rent of 1 year.The property is suitable for 100% Residential Purpose ... Parking Space. Mosques Nearby. Church Nearby. Street Lights. Supermarket Nearby. Security. 24 Hours Security. Restaurants Nearby. Big Compound. ...",surulere,0,0,0,1,surulere1,500000.0,700000.0,609999.9999999998,1,11,2,600000
3155," 119 ogunlana drive surulere, lagos ogunlana surulere lagos",5,3,2,3,Newly built 2 bedroom on a 2 storey building in the very heart of Surulere (Ogunlana Drive) for office use or residential. ... New. Street Lights. Parking Space. ...,surulere,0,0,0,1,surulere3,1000000.0,1500000.0,1500000.0,1,27,5,1000000
3156, off aguda aguda surulere lagos,6,3,3,3,"Lovely newly renovated 3br flat at Aguda area Surulere Lagos, Amount:#1m*1yr up & down ... New. Big Compound. Parking Space. Pop Ceiling. All Room Ensuit. Security. Water Treatment. ...",surulere,0,0,0,1,surulere3,1000000.0,1500000.0,1500000.0,1,27,5,1000000
3157, anjorin street lawanson lawanson surulere lagos,6,3,3,3,3 bedroom flat all rooms ensuit @Anjorin Surulere Lawanson ... New. Serviced. Furnished. Big Compound. Parking Space. Pop Ceiling. All Room Ensuit. Water Treatment. ...,surulere,0,0,0,1,surulere3,1000000.0,1500000.0,1500000.0,1,27,5,1300000
3158, obele street lawanson surulere lagos,2,1,1,1,"Lovely clean mini flat(lsdpc building)at obele area,upstairs surulere Lagos,#500t*1yr ... Old. ...",surulere,0,0,0,1,surulere1,500000.0,700000.0,609999.9999999998,1,11,2,500000
3159, off ogunsanya bode thomas surulere lagos,7,4,3,4,"TASTEFULLY Finished 2units of 3bedroom flat SERVICED APARTMENT up and donwstairs all rooms ensuite and all round tiled floor , pop , water and parking space ( just 3 in compound) off Adeniran ogunsanya rd ... New. ...",surulere,1,1,1,1,surulere4,1300000.0,2680000.0000000005,2199999.999999999,4,31,6,2800000
3160, off ogunsanya bode thomas surulere lagos,5,3,2,3,"TASTEFULLY Finished 2units of 3bedroom flat SERVICED APARTMENT up and donwstairs all rooms ensuite and all round tiled floor , pop , water and parking space ( just 3 in compound) off Adeniran ogunsanya rd ... New. ...",surulere,1,1,1,1,surulere3,1000000.0,1500000.0,1500000.0,4,27,5,2000000
3161, iseyin off adeshina ijesha surulere lagos,8,4,4,4,"Luvly and spacious 3bed @ iseyin street off adeshina ijesha Surulere upstairs all rooms ensuite with p.o.p, wardrobes, kitchen cabinet and water heater. ... New. Water Treatment. ...",surulere,0,0,0,0,surulere4,1300000.0,2680000.0000000005,2199999.999999999,0,31,6,1000000
3162, ibudun western avenue surulere lagos,2,1,1,1,"Mini flat for rent @ibidun Surulere off Western Avenue, one and half years rent ... New. Dry. Water Treatment. Mosques Nearby. ...",surulere,0,0,0,0,surulere1,500000.0,700000.0,609999.9999999998,0,11,2,450000
3163, olufemi ogunlana surulere lagos,5,3,2,3,Newly renovated 3bedroom flat all rooms ensuit Features : Prepaid Meter 4 water heater 1.3M per annum ... New. Renovated. Big Compound. Parking Space. Security Doors. All Room Ensuit. Security. Water Treatment. ...,surulere,0,0,0,1,surulere3,1000000.0,1500000.0,1500000.0,1,27,5,1300000
